yes,no,missing,total,pct_yes,pct_reporting,roll_avg,roll_reporting
5,15,2,22,0.25,0.9090909090909091,0.46606314387791414,0.9200860939764864
40,50,24,114,0.4444444444444444,0.7894736842105263,0.3866980645128347,0.8900109060065616
20,73,2,95,0.21505376344086022,0.9789473684210527,0.3192057450043862,0.895406748554107
1,0,0,1,1.0,1.0,0.43066571360721195,0.8999660190708243
13,65,21,99,0.16666666666666666,0.7878787878787878,0.4025271854686839,0.8899264132865377
135,202,38,375,0.40059347181008903,0.8986666666666666,0.38953690662315177,0.8845205175949277
19,55,20,94,0.25675675675675674,0.7872340425531915,0.3905021575884026,0.8787559226887334
2,23,8,33,0.08,0.7575757575757576,0.36621644330268843,0.8571109010437116
0,13,1,14,0.0,0.9285714285714286,0.3027243798106249,0.8769820073809834
4,6,1,11,0.4,0.9090909090909091,0.3291452707476449,0.8670025131909629
38,143,61,242,0.20994475138121546,0.7479338842975206,0.21628023523067566,0.8309930680906087
46,89,20,155,0.34074074074074073,0.8709677419354839,0.24114796009840053,0.8428629186701366
3,17,4,24,0.15,0.8333333333333334,0.20534889269695925,0.8335295853368034
6,24,92,122,0.2,0.2459016393442623,0.19724078458885114,0.7561963848783849
6,38,4,48,0.13636363636363635,0.9166666666666666,0.2052927326407992,0.7789236576056577
17,139,25,181,0.10897435897435898,0.861878453038674,0.22086049820856476,0.769396089672407
29,101,3,133,0.2230769230769231,0.9774436090225563,0.1955857729338395,0.7791607610912138
37,95,7,139,0.2803030303030303,0.9496402877697842,0.2056369556369559,0.8079759615872515
35,67,4,106,0.3431372549019608,0.9622641509433962,0.20597931480284445,0.8210183057312389
47,174,6,227,0.21266968325791855,0.973568281938326,0.21493212669683284,0.8410518698176663
24,58,1,83,0.2926829268292683,0.9879518072289156,0.22817254481529972,0.9470590366583311
11,25,17,53,0.3055555555555556,0.6792452830188679,0.2523428189855739,0.913141696137217
3,19,13,35,0.13636363636363635,0.6285714285714286,0.2562555728983278,0.8798121212133249
40,114,4,158,0.2597402597402597,0.9746835443037974,0.2614931924216616,0.8794178262535022
22,78,30,130,0.22,0.7692307692307693,0.252878473806943,0.8536450378907857
36,64,25,125,0.36,0.8,0.25528743739237714,0.830464444898872
17,81,3,101,0.17346938775510204,0.9702970297029703,0.2496873951776891,0.829997123150964
10,50,4,64,0.16666666666666666,0.9375,0.23168507229731744,0.8227897221182617
10,62,47,119,0.1388888888888889,0.6050420168067226,0.20787554848779363,0.8121892555165269
14,29,4,47,0.32558139534883723,0.9148936170212766,0.23490665691425092,0.8530924252950765
26,67,2,95,0.27956989247311825,0.9789473684210527,0.23773946159037354,0.8537015430261129
4,7,18,29,0.36363636363636365,0.3793103448275862,0.25825894210985406,0.7979986252542296
11,57,11,79,0.16176470588235295,0.8607594936708861,0.22993961437876162,0.8066785529214991
23,28,1,52,0.45098039215686275,0.9807692307692307,0.26958404357901317,0.8081745816452506
2,11,36,49,0.15384615384615385,0.2653061224489796,0.26775254174751134,0.7121468848522478
11,156,11,178,0.0658682634730539,0.9382022471910112,0.2573210238309635,0.7597412034785745
4,71,124,199,0.05333333333333334,0.3768844221105528,0.21842844354303434,0.682882747062757
45,78,8,131,0.36585365853658536,0.9389312977099237,0.2307546958378154,0.6771661655325956
9,47,7,63,0.16071428571428573,0.8888888888888888,0.2017658275632328,0.749963100398496
48,154,6,208,0.2376237623762376,0.9711538461538461,0.21260283563378773,0.7657337221817759
3,30,33,66,0.09090909090909091,0.5,0.1611640783126775,0.6970524035004573
6,6,2,14,0.5,0.8571428571428571,0.21061462776322695,0.7816005084567256
21,50,5,76,0.29577464788732394,0.9342105263157895,0.24345839696526553,0.7810302626174083
4,50,10,64,0.07407407407407407,0.84375,0.24642135992822847,0.8477253451730435
22,96,3,121,0.1864406779661017,0.9752066115702479,0.22079093413244513,0.8529075328673755
12,54,438,504,0.18181818181818182,0.13095238095238096,0.22380577643300167,0.7446308888764458
3,40,9,52,0.06976744186046512,0.8269230769230769,0.1998263020736056,0.7240264932720503
21,60,20,101,0.25925925925925924,0.801980198019802,0.22387632612362968,0.7671665215605934
1,0,0,1,1.0,1.0,0.29530489755220113,0.7875746848258994
11,5,1,17,0.6875,0.9411764705882353,0.35126566213972626,0.7885698197219632
20,70,3,93,0.2222222222222222,0.967741935483871,0.3724296833037474,0.8062829533625161
44,77,20,141,0.36363636363636365,0.8581560283687943,0.3977433526852134,0.7895614414765941
29,30,4,63,0.4915254237288136,0.9365079365079365,0.4419872443867322,0.9046408065559594
6,18,5,29,0.25,0.8275862068965517,0.46773475269238013,0.904735539409313
5,15,2,22,0.25,0.9090909090909091,0.46482247391613474,0.9200860939764864
40,50,24,114,0.4444444444444444,0.7894736842105263,0.38545739455105543,0.8900109060065615
20,73,2,95,0.21505376344086022,0.9789473684210527,0.31796507504260685,0.895406748554107
1,0,0,1,1.0,1.0,0.4294250436454326,0.8999660190708242
13,65,21,99,0.16666666666666666,0.7878787878787878,0.40010587796263053,0.8899264132865377
135,202,38,375,0.40059347181008903,0.8986666666666666,0.38953690662315177,0.8845205175949277
19,55,20,94,0.25675675675675674,0.7872340425531915,0.39050215758840273,0.8787559226887334
2,23,8,33,0.08,0.7575757575757576,0.36621644330268843,0.8571109010437118
0,13,1,14,0.0,0.9285714285714286,0.3027243798106249,0.8769820073809834
4,6,1,11,0.4,0.9090909090909091,0.3291452707476449,0.8670025131909629
38,144,61,243,0.2087912087912088,0.7489711934156379,0.2161154434321033,0.8311412551074826
46,89,20,155,0.34074074074074073,0.8709677419354839,0.2409831682998282,0.8430111056870107
3,17,4,24,0.15,0.8333333333333334,0.20518410089838687,0.8336777723536773
6,23,93,122,0.20689655172413793,0.23770491803278687,0.19806121446515565,0.7551736117079051
6,38,4,48,0.13636363636363635,0.9166666666666666,0.20611316251710368,0.7779008844351779
18,140,25,183,0.11392405063291139,0.8633879781420765,0.22238802689323386,0.7685889629452705
29,102,3,134,0.22137404580152673,0.9776119402985075,0.1968700334363091,0.7783776816892132
37,95,7,139,0.2803030303030303,0.9496402877697842,0.2070860079379979,0.8070446951683768
35,67,4,106,0.3431372549019608,0.9622641509433962,0.2074283671038865,0.8200870393123643
48,173,6,227,0.2171945701357466,0.973568281938326,0.21702759140899314,0.8401206033987919
24,58,1,83,0.2926829268292683,0.9879518072289156,0.2292827878525832,0.9472987304268103
11,25,17,53,0.3055555555555556,0.6792452830188679,0.25345306202285733,0.9133813899056962
3,19,13,35,0.13636363636363635,0.6285714285714286,0.25665871712724664,0.8798361685384608
40,114,4,158,0.2597402597402597,0.9746835443037974,0.2621396048327799,0.8794178262535022
22,78,30,130,0.22,0.7692307692307693,0.25352488621806135,0.8536450378907857
36,64,25,125,0.36,0.8,0.2559338498034955,0.830464444898872
17,82,3,102,0.1717171717171717,0.9705882352941176,0.24943707860084194,0.8300387239496994
10,50,4,64,0.16666666666666666,0.9375,0.2314347557204703,0.8228313229169971
10,62,47,119,0.1388888888888889,0.6050420168067226,0.20762523191094645,0.812230856315262
14,29,4,47,0.32558139534883723,0.9148936170212766,0.23465634033740373,0.853134026093812
26,67,2,95,0.27956989247311825,0.9789473684210527,0.2374891450135264,0.8537431438248483
4,7,18,29,0.36363636363636365,0.3793103448275862,0.2580086255330069,0.798040226052965
11,57,11,79,0.16176470588235295,0.8607594936708861,0.22968929780191447,0.8067201537202344
23,29,1,53,0.4423076923076923,0.9811320754716981,0.2683450864577031,0.8082264166027459
2,11,36,49,0.15384615384615385,0.2653061224489796,0.2665135846262013,0.712198719809743
11,156,11,178,0.0658682634730539,0.9382022471910112,0.25608206670965344,0.7597930384360699
4,71,124,199,0.05333333333333334,0.3768844221105528,0.21718948642172428,0.6829345820202523
45,81,8,134,0.35714285714285715,0.9402985074626866,0.2282713385174013,0.6774133161690571
9,47,7,63,0.16071428571428573,0.8888888888888888,0.19928247024281873,0.7502102510349574
48,154,6,208,0.2376237623762376,0.9711538461538461,0.2101194783133737,0.7659808728182375
3,30,33,66,0.09090909090909091,0.5,0.15991967811357347,0.6972477191794235
6,6,2,14,0.5,0.8571428571428571,0.20937022756412293,0.7817958241356917
21,50,5,76,0.29577464788732394,0.9342105263157895,0.24221399676616154,0.7812255782963743
4,50,10,64,0.07407407407407407,0.84375,0.24517695972912446,0.8479206608520096
22,96,3,121,0.1864406779661017,0.9752066115702479,0.22079093413244508,0.8529075328673754
12,54,438,504,0.18181818181818182,0.13095238095238096,0.2238057764330017,0.7446308888764459
3,40,9,52,0.06976744186046512,0.8269230769230769,0.19982630207360566,0.7240264932720502
21,60,20,101,0.25925925925925924,0.801980198019802,0.22387632612362968,0.7671665215605933
2,0,0,2,1.0,1.0,0.29530489755220113,0.7875746848258994
11,5,1,17,0.6875,0.9411764705882353,0.35126566213972626,0.7885698197219632
20,71,3,94,0.21978021978021978,0.9680851063829787,0.37208082581203283,0.8063319777766745
44,77,20,141,0.36363636363636365,0.8581560283687943,0.3973944951934988,0.7896104658907525
29,30,4,63,0.4915254237288136,0.9365079365079365,0.44163838689501755,0.9046898309701176
6,18,5,29,0.25,0.8275862068965517,0.46738589520066537,0.904784563823471
5,15,2,22,0.25,0.9090909090909091,0.46311535089464057,0.9224884098899473
40,51,23,114,0.43956043956043955,0.7982456140350878,0.38305255654613196,0.8936663547521027
20,73,2,95,0.21505376344086022,0.9789473684210527,0.3155602370376834,0.8990621972996479
1,0,0,1,1.0,1.0,0.4287144095977965,0.9018361224036701
13,68,21,102,0.16049382716049382,0.7941176470588235,0.40062169102888745,0.893659878933309
136,203,38,377,0.40117994100294985,0.8992042440318302,0.385293885990568,0.888330780008151
19,55,20,94,0.25675675675675674,0.7872340425531915,0.3890063897030717,0.8809771178844132
2,23,8,33,0.08,0.7575757575757576,0.3647206754173574,0.8593320962393918
0,13,1,14,0.0,0.9285714285714286,0.3019263269087232,0.8779500697445833
4,6,1,11,0.4,0.9090909090909091,0.32834721784574317,0.8679705755545628
39,142,61,242,0.2154696132596685,0.7479338842975206,0.21627144831141007,0.8319611304542086
41,89,27,157,0.3153846153846154,0.8280254777070064,0.23839870377199887,0.8368051062610918
3,17,4,24,0.15,0.8333333333333334,0.20251585505729178,0.8273949761613065
7,21,94,122,0.25,0.22950819672131148,0.2015506040920408,0.7477198553281809
6,38,4,48,0.13636363636363635,0.9166666666666666,0.20960255214398885,0.7704471280554536
18,142,25,185,0.1125,0.8648648648648649,0.22567398071541742,0.7613461903830874
30,101,3,134,0.22900763358778625,0.9776119402985075,0.20124649979938686,0.77113490912703
38,96,7,141,0.2835820895522388,0.950354609929078,0.21097685355546833,0.800052155645824
35,68,3,106,0.33980582524271846,0.9716981132075472,0.21446559782091162,0.8205768178601869
48,173,6,227,0.2171945701357466,0.973568281938326,0.22406482212601833,0.8406103819466145
24,58,1,83,0.2926829268292683,0.9879518072289156,0.23016238310162804,0.9489594691619864
10,26,17,53,0.2777777777777778,0.6792452830188679,0.2503644033036483,0.9150421286408724
3,20,12,35,0.13043478260869565,0.6571428571428571,0.2529265151048905,0.8853675561091569
29,125,4,158,0.18831168831168832,0.9746835443037974,0.24711280863687654,0.8849492138241983
22,79,30,131,0.21782178217821782,0.7709923664122137,0.23771847901201637,0.859326036178932
37,63,25,125,0.37,0.8,0.24203193254877092,0.8347977342921394
17,83,3,103,0.17,0.970873786407767,0.23528985110080708,0.8344128063592026
11,50,4,65,0.18032786885245902,0.9384615384615385,0.21923912853269148,0.827342767963863
10,62,47,119,0.1388888888888889,0.6050420168067226,0.19939785869142163,0.8167423013621279
14,29,4,47,0.32558139534883723,0.9148936170212766,0.22727594622572758,0.8535638384876164
26,67,2,95,0.27956989247311825,0.9789473684210527,0.24031283253450328,0.8541729562186529
4,7,18,29,0.36363636363636365,0.3793103448275862,0.26114348702852413,0.7982183817065633
11,57,11,79,0.16176470588235295,0.8607594936708861,0.23139558786886025,0.8068983093738327
24,28,1,53,0.46153846153846156,0.9811320754716981,0.2730439395172119,0.8083637792401086
0,5,45,50,0.0,0.1,0.24728281539543204,0.6885835594598887
8,161,11,180,0.047337278106508875,0.9388888888888889,0.23420401385509204,0.7362759697573411
4,72,124,200,0.05263157894736842,0.38,0.1952111829405965,0.6598625958971587
45,82,8,135,0.3543307086614173,0.9407407407407408,0.2058912995389249,0.6544045062285427
9,47,7,63,0.16071428571428573,0.8888888888888888,0.17690243126434235,0.7272014410944431
51,152,6,209,0.2512315270935961,0.9712918660287081,0.1896834057230914,0.7429917800027034
2,9,55,66,0.18181818181818182,0.16666666666666666,0.14972336576305142,0.6266395787448417
6,6,2,14,0.5,0.8571428571428571,0.22115193719162285,0.7348028440509643
21,50,5,76,0.29577464788732394,0.9342105263157895,0.25664299001745355,0.7341345065405215
4,50,10,64,0.07407407407407407,0.84375,0.25970620360698293,0.8003845065405215
22,97,3,122,0.18487394957983194,0.9754098360655737,0.23549809516675646,0.805337234444069
15,70,419,504,0.17647058823529413,0.16865079365079366,0.23774899552690051,0.702446077981484
2,41,9,52,0.046511627906976744,0.8269230769230769,0.20850329564309775,0.681821965252108
20,62,20,102,0.24390243902439024,0.803921568627451,0.2173724752439847,0.7728583798179345
2,0,0,2,1.0,1.0,0.2888010466725562,0.7932665430832405
11,5,1,17,0.6875,0.9411764705882353,0.3447618112600813,0.7942616779793042
20,71,3,94,0.21978021978021978,0.9680851063829787,0.3655769749323878,0.8120238360340155
45,76,20,141,0.371900826446281,0.8581560283687943,0.3922951001990234,0.7952732920773327
28,31,4,63,0.4745762711864407,0.9365079365079365,0.43488162633490146,0.9049671696283531
6,18,5,29,0.25,0.8275862068965517,0.4639513937767619,0.9050619024817067
5,17,2,24,0.22727272727272727,0.9166666666666666,0.46088875124608497,0.9231489493854382
42,52,23,117,0.44680851063829785,0.8034188034188035,0.3818613956229847,0.8950659213024101
18,90,2,110,0.16666666666666666,0.9818181818181818,0.3074566337182228,0.9008718800495453
1,0,0,1,1.0,1.0,0.4203137765753656,0.9050327677055786
14,83,21,118,0.14432989690721648,0.8220338983050848,0.3891888012179039,0.8998793091622896
132,245,35,412,0.35013262599469497,0.9150485436893204,0.36656852260697653,0.896813681616773
20,67,20,107,0.22988505747126436,0.8130841121495327,0.36644221213583844,0.8931528865782269
2,30,8,40,0.0625,0.8,0.34290325109687736,0.8764862199115603
0,13,1,14,0.0,0.9285714285714286,0.2790734638628348,0.8943651663619353
3,12,1,16,0.2,0.9375,0.2838353686247396,0.8880339975307665
40,170,61,271,0.19047619047619047,0.7749077490774908,0.16818911012133825,0.8558779616846939
43,102,27,172,0.296551724137931,0.8430232558139535,0.18993508544001175,0.858876441328818
3,18,4,25,0.14285714285714285,0.84,0.16032430213464718,0.8481552208017721
6,19,101,126,0.24,0.1984126984126984,0.16176929392446657,0.7603450188393673
6,43,4,53,0.12244897959183673,0.9245283018867925,0.1703334338661575,0.778134776251766
18,160,26,204,0.10112359550561797,0.8725490196078431,0.1847796617955315,0.770131574971254
32,133,3,168,0.19393939393939394,0.9821428571428571,0.18391386092973064,0.7765091259916621
33,107,7,147,0.2357142857142857,0.9523809523809523,0.19037644596374426,0.8018624407492994
37,76,3,116,0.3274336283185841,0.9741379310344828,0.19478814656098042,0.8205931086379464
48,173,6,227,0.2171945701357466,0.973568281938326,0.2054077790293524,0.8396742917719929
25,76,1,102,0.24752475247524752,0.9901960784313726,0.20648274366867345,0.9527862032032323
11,32,17,60,0.2558139534883721,0.7166666666666667,0.2255348827967499,0.9230916838860714
2,24,13,39,0.07692307692307693,0.6666666666666666,0.22207766585638694,0.8936799191801891
36,123,4,163,0.22641509433962265,0.9754601226993865,0.2267170516278482,0.8927252428311219
23,87,30,140,0.20909090909090908,0.7857142857142857,0.22291371211022293,0.868915719021598
36,80,25,141,0.3103448275862069,0.8226950354609929,0.2204724548627405,0.8472810196539565
21,86,3,110,0.19626168224299065,0.9727272727272728,0.21748204230663246,0.847160875480949
10,52,4,66,0.16129032258064516,0.9393939393939394,0.20516283803597496,0.83990342704703
12,75,44,131,0.13793103448275862,0.6641221374045801,0.18832242103517305,0.8323970657238747
14,32,4,50,0.30434782608695654,0.92,0.2208116709157273,0.8685875419143508
22,75,2,99,0.2268041237113402,0.9797979797979798,0.22086724654025838,0.8692072357855786
7,6,17,30,0.5384615384615384,0.43333333333333335,0.26792019359320546,0.8188670997311568
12,73,11,96,0.1411764705882353,0.8854166666666666,0.2437532854506381,0.8278273327605389
23,31,1,55,0.42592592592592593,0.9818181818181818,0.2765624631196288,0.8291260340592401
0,7,55,62,0.0,0.11290322580645161,0.25352098846525095,0.7110559321181703
10,186,11,207,0.05102040816326531,0.9468599033816425,0.24110518470532336,0.7514470415434651
4,107,124,235,0.036036036036036036,0.4723404255319149,0.20277492898376326,0.6874956737623099
38,94,15,147,0.2878787878787879,0.8979591836734694,0.21149988100768433,0.6758044171730943
9,50,6,65,0.15254237288135594,0.9076923076923077,0.15636857163908685,0.743569984938662
45,178,6,229,0.20179372197309417,0.9737991266375546,0.16502817897978098,0.7561960506487889
2,10,55,67,0.16666666666666666,0.1791044776119403,0.12799114194274394,0.6415226643336114
6,7,2,15,0.46153846153846156,0.8666666666666667,0.19392520787680986,0.7492031558850708
23,60,5,88,0.27710843373493976,0.9431818181818182,0.22622349724419194,0.7486777151422387
6,49,10,65,0.10909090909090909,0.8461538461538461,0.23665990768060238,0.8020796323739432
22,118,3,143,0.15714285714285714,0.9790209790209791,0.217983346146898,0.8136598888521588
15,97,483,595,0.13392857142857142,0.18823529411764706,0.21532423165364303,0.7108803154843502
2,48,9,59,0.04,0.847457627118644,0.1922108428003439,0.6928315298387915
22,65,20,107,0.25287356321839083,0.8130841121495327,0.2045261137363045,0.7834000490584476
2,0,0,2,1.0,1.0,0.2814491906593814,0.8024476681060666
11,5,1,17,0.6875,0.9411764705882353,0.34007655726867575,0.8021611898784118
21,80,2,103,0.2079207920792079,0.9805825242718447,0.35419511198128983,0.8213652867524116
45,81,22,148,0.35714285714285715,0.8513513513513513,0.3827665405527184,0.8031267685138934
30,29,4,63,0.5084745762711864,0.9365079365079365,0.43627311267309205,0.9100228602839348
6,20,5,31,0.23076923076923078,0.8387096774193549,0.4635258599258393,0.9087731531840364
5,17,2,24,0.22727272727272727,0.9166666666666666,0.47050912540849005,0.9241142003506891
45,50,22,117,0.47368421052631576,0.811965811965812,0.39532115548367797,0.8972521734886624
18,91,2,111,0.1651376146788991,0.9819819819819819,0.32069795758066366,0.9030815322591975
1,0,0,1,1.0,1.0,0.43498367186637793,0.9072424199152308
13,86,21,120,0.13131313131313133,0.825,0.4012873334825395,0.9015474392202502
130,246,36,412,0.34574468085106386,0.912621359223301,0.3731975905532726,0.8981350710367307
19,68,20,107,0.21839080459770116,0.8130841121495327,0.36593473846283425,0.8944742759981847
2,30,8,40,0.0625,0.8,0.3423957774238732,0.8778076093315181
0,13,1,14,0.0,0.9285714285714286,0.2747266044915424,0.8944655545608919
5,10,1,16,0.3333333333333333,0.9375,0.29875456429931874,0.8881109857063231
40,170,61,271,0.19047619047619047,0.7749077490774908,0.18310830579591736,0.8559549498602503
45,99,28,172,0.3125,0.8372093023255814,0.20899214417975578,0.857699135906762
3,18,4,25,0.14285714285714285,0.84,0.1800082101806242,0.847324656017719
6,20,100,126,0.23076923076923078,0.20634920634920634,0.18177655677655702,0.7606482409033867
5,44,4,53,0.10204081632653061,0.9245283018867925,0.18742524482320425,0.7784379983157856
15,163,26,204,0.08426966292134831,0.8725490196078431,0.19946376809768257,0.7704347970352733
34,131,3,168,0.20606060606060606,0.9821428571428571,0.18128194991586438,0.7768123480556816
38,102,7,147,0.2714285714285714,0.9523809523809523,0.19284657576620454,0.8021656628133188
38,76,2,116,0.3333333333333333,0.9827586206896551,0.195822766242395,0.822958422579615
48,173,6,227,0.2171945701357466,0.973568281938326,0.20644239871076694,0.8420396057136615
22,79,1,102,0.21782178217821782,0.9901960784313726,0.2045927631977651,0.9540177302968283
11,31,18,60,0.2619047619047619,0.7,0.227430469708941,0.921942258598715
2,24,13,39,0.07692307692307693,0.6666666666666666,0.22638095742347364,0.8925304938928328
37,122,4,163,0.23270440251572327,0.9754601226993865,0.230187214059919,0.8915758175437655
23,87,30,140,0.20909090909090908,0.7857142857142857,0.22128183372596721,0.8677662937342417
36,79,26,141,0.3130434782608696,0.8156028368794326,0.21838328300132953,0.843886896047067
21,86,3,110,0.19626168224299065,0.9727272727272728,0.21539287044522154,0.8437667518740594
9,53,4,66,0.14516129032258066,0.9393939393939394,0.20501280018013052,0.8365093034401403
12,77,42,131,0.1348314606741573,0.6793893129770993,0.18685947143290127,0.833564919579726
12,34,4,50,0.2608695652173913,0.92,0.21313754118923192,0.8697553957702022
21,76,2,99,0.21649484536082475,0.9797979797979798,0.21082189016710354,0.8703750896414297
7,5,18,30,0.5833333333333334,0.4,0.264285093630307,0.8152730488251033
12,74,10,96,0.13953488372093023,0.8958333333333334,0.23949815155317283,0.8267345483185177
23,31,1,55,0.42592592592592593,0.9818181818181818,0.27230732922216355,0.8280332496172189
0,7,55,62,0.0,0.11290322580645161,0.2515700020332235,0.7099631476761493
9,188,11,208,0.04568527918781726,0.9471153846153846,0.23883483324946062,0.7482097293387616
4,107,124,235,0.036036036036036036,0.4723404255319149,0.20671575765212416,0.6842583615576066
35,95,19,149,0.2692307692307692,0.87248322147651,0.2142494610621162,0.6689276817973965
9,50,6,65,0.15254237288135594,0.9076923076923077,0.1527078952832623,0.741455154324869
43,180,6,229,0.19282511210762332,0.9737991266375546,0.1603207850527899,0.7525931247969007
2,7,58,67,0.2222222222222222,0.13432835820895522,0.13122025595226078,0.6315231499955825
6,7,2,15,0.46153846153846156,0.8666666666666667,0.19715432188632673,0.7392036415470419
24,59,5,88,0.2891566265060241,0.9431818181818182,0.23193594293178485,0.7386417034851037
6,49,10,65,0.10909090909090909,0.8461538461538461,0.24237235336819526,0.7920436207168082
22,118,3,143,0.15714285714285714,0.9790209790209791,0.22635979449849356,0.8072633003660181
14,99,482,595,0.12389380530973451,0.1899159663865546,0.2222671419882619,0.7047238230366248
3,47,9,59,0.06,0.847457627118644,0.20329212597288718,0.6866750373910662
22,65,20,107,0.25287356321839083,0.8130841121495327,0.2076708889723398,0.783640145096863
2,0,0,2,1.0,1.0,0.28459396589541675,0.802687764144482
11,5,1,17,0.6875,0.9411764705882353,0.3415001621088418,0.8024012859168274
21,79,3,103,0.21,0.970873786407767,0.3559157465244263,0.820218420238816
46,81,21,148,0.36220472440944884,0.8581081081081081,0.3852102989910822,0.8029451529655487
30,29,4,63,0.5084745762711864,0.9365079365079365,0.4401504091284325,0.9096011486971747
6,20,5,31,0.23076923076923078,0.8387096774193549,0.4645460135240369,0.9083514415972763
5,17,2,24,0.22727272727272727,0.9166666666666666,0.4639902148781762,0.9255278352594697
44,52,21,117,0.4583333333333333,0.8205128205128205,0.3866092624972239,0.899886809618444
22,87,2,111,0.2018348623853211,0.9819819819819819,0.3172285285522697,0.9057161683889793
1,0,0,1,1.0,1.0,0.4320744669276198,0.908463421136232
13,86,21,120,0.13131313131313133,0.825,0.39949419997235286,0.9027684404412514
144,236,32,412,0.37894736842105264,0.9223300970873787,0.38099031313661946,0.900743034809743
22,65,20,107,0.25287356321839083,0.8130841121495327,0.37865356942056544,0.8970822397711969
2,30,8,40,0.0625,0.8,0.3551146083816044,0.8804155731045304
0,13,1,14,0.0,0.9285714285714286,0.28963841790541395,0.895852517112903
3,12,1,16,0.2,0.9375,0.28937629470751086,0.8894979482583342
40,170,61,271,0.19047619047619047,0.7749077490774908,0.17373003620410957,0.8573419124122614
45,91,36,172,0.33088235294117646,0.7906976744186046,0.202239925008116,0.8524415801863477
3,18,4,25,0.14285714285714285,0.84,0.16851274992755744,0.8406801377452936
6,18,102,126,0.25,0.19047619047619047,0.16810224089635878,0.7517361489348163
7,42,4,53,0.14285714285714285,0.9245283018867925,0.17958183273309344,0.7695259063472151
19,159,26,204,0.10674157303370786,0.8725490196078431,0.194830628880766,0.7615227050667029
36,129,3,168,0.21818181818181817,0.9821428571428571,0.19742803147816862,0.7679002560871112
38,104,7,149,0.2676056338028169,0.9530201342281879,0.2084465233819724,0.7933448825372107
37,76,3,116,0.3274336283185841,0.9741379310344828,0.20795384843588774,0.8195506334823361
49,172,6,227,0.22171945701357465,0.973568281938326,0.219219893315378,0.8386318166163828
30,71,1,102,0.297029702970297,0.9901960784313726,0.2259384223111347,0.9528775148956944
11,31,18,60,0.2619047619047619,0.7,0.24294522503222318,0.9208020431975813
4,21,14,39,0.16,0.6410256410256411,0.25055357174169346,0.8877272748286952
37,122,4,163,0.23270440251572327,0.9754601226993865,0.25262822664653706,0.886772598479628
23,87,30,140,0.20909090909090908,0.7857142857142857,0.24426898025912164,0.862871762977642
39,77,25,141,0.33620689655172414,0.8226950354609929,0.24552230429242736,0.8412370636100005
19,88,3,110,0.17757009345794392,0.9727272727272728,0.2392152523559087,0.8411169194369928
12,50,4,66,0.1935483870967742,0.9393939393939394,0.22443220723111973,0.8338594710030739
12,78,41,131,0.13333333333333333,0.6870229007633588,0.20606486029234422,0.8320055996835537
16,30,4,50,0.34782608695652173,0.92,0.2328971584289902,0.8718590795370337
26,71,2,99,0.26804123711340205,0.9797979797979798,0.23794527765723,0.8724787734082612
6,6,18,30,0.5,0.4,0.2795037192156716,0.8173767325919348
12,73,11,96,0.1411764705882353,0.8854166666666666,0.25164222979231604,0.8263369656213168
23,31,1,55,0.42592592592592593,0.9818181818181818,0.2871216344305991,0.827635666920018
0,7,55,62,0.0,0.11290322580645161,0.2594718648453457,0.7095655649789482
11,186,11,208,0.05583756345177665,0.9471153846153846,0.2484010405765519,0.7467216341006662
3,108,124,235,0.02702702702702703,0.4723404255319149,0.20257260344376693,0.6827702663195111
47,93,9,149,0.3357142857142857,0.9395973154362416,0.21224018181532173,0.6770273142678344
9,50,6,65,0.15254237288135594,0.9076923076923077,0.16260337794122973,0.7495547867953068
44,179,6,229,0.19730941704035873,0.9737991266375546,0.17062237029153307,0.7621808525054338
11,49,7,67,0.18333333333333332,0.8955223880597015,0.1359662856354484,0.749852881968508
6,7,2,15,0.46153846153846156,0.8666666666666667,0.20190035156951433,0.8575333735199673
24,59,5,88,0.2891566265060241,0.9431818181818182,0.23523164629154966,0.8569714354580292
7,48,10,65,0.12727272727272726,0.8461538461538461,0.249552460612364,0.9103733526897336
22,118,3,143,0.15714285714285714,0.9790209790209791,0.22404225653073137,0.9160053046304105
16,100,480,596,0.13793103448275862,0.19463087248322147,0.2219549224737889,0.8141393853148268
2,48,9,59,0.04,0.847457627118644,0.1994821486108805,0.7960905996692681
22,65,20,107,0.25287356321839083,0.8130841121495327,0.20941646716588871,0.7843137031106725
2,0,0,2,1.0,1.0,0.28633954408896567,0.8033613221582916
11,5,1,17,0.6875,0.9411764705882353,0.3432457403023908,0.8030748439306369
20,80,3,103,0.2,0.970873786407767,0.3536353506920012,0.8208919782526255
47,81,20,148,0.3671875,0.8648648648648649,0.3836417282430216,0.8045839619446092
32,27,4,63,0.5423728813559322,0.9365079365079365,0.4414191349391893,0.9105663996624257
7,19,5,31,0.2692307692307692,0.8387096774193549,0.474166387686442,0.9093166925625272
5,17,2,24,0.22727272727272727,0.9166666666666666,0.4627116488598924,0.9245359119374493
44,52,21,117,0.4583333333333333,0.8205128205128205,0.38533069647894,0.8988948862964238
23,86,2,111,0.21100917431192662,0.9819819819819819,0.3172605785235009,0.9047242450669588
1,0,0,1,1.0,1.0,0.4304147510836141,0.907498170170981
12,87,21,120,0.12121212121212122,0.825,0.3993618145188665,0.9027684404412514
146,230,36,412,0.3882978723404255,0.912621359223301,0.38219371395732926,0.899356072257732
23,64,20,107,0.26436781609195403,0.8130841121495327,0.38149900636607,0.895695277219186
2,30,8,40,0.0625,0.8,0.3579600453271089,0.8790286105525194
0,13,1,14,0.0,0.9285714285714286,0.29248385485091843,0.8944655545608919
5,10,1,16,0.3333333333333333,0.9375,0.3099587347111194,0.8881109857063231
39,171,61,271,0.18571428571428572,0.7749077490774908,0.19363220409887447,0.8559549498602503
44,93,35,172,0.32116788321167883,0.7965116279069767,0.22219731295595416,0.8518851824183898
3,18,4,25,0.14285714285714285,0.84,0.18713435160119948,0.8415107025293468
7,22,97,126,0.2413793103448276,0.23015873015873015,0.18385027935160997,0.7582356479592322
7,42,4,53,0.14285714285714285,0.9245283018867925,0.1953298711883447,0.7760254053716311
19,158,26,203,0.10734463276836158,0.8719211822660099,0.21066481872668205,0.7679325130422855
34,131,3,168,0.20606060606060606,0.9821428571428571,0.1924830005448639,0.7743100640626938
38,104,7,149,0.2676056338028169,0.9530201342281879,0.20418176455751116,0.7997546905127935
40,73,3,116,0.35398230088495575,0.9741379310344828,0.20886953851083648,0.8251298766738656
49,172,6,227,0.22171945701357465,0.973568281938326,0.2201355833903267,0.8442110598079122
30,71,1,102,0.297029702970297,0.9901960784313726,0.2280856394796795,0.9527878238468611
11,32,17,60,0.2558139534883721,0.7166666666666667,0.2442223267127122,0.9230933045297004
3,22,14,39,0.12,0.6410256410256411,0.24603023631723198,0.8901082272096476
37,122,4,163,0.23270440251572327,0.9754601226993865,0.24983649295367735,0.8891535508605803
23,87,30,140,0.20909090909090908,0.7857142857142857,0.24147724656626193,0.8652527153585943
42,74,25,141,0.3620689655172414,0.8226950354609929,0.24263248437087412,0.8436180159909529
21,86,3,110,0.19626168224299065,0.9727272727272728,0.23899565940364784,0.8434978718179453
11,52,3,66,0.1746031746031746,0.9545454545454546,0.2215061553512018,0.8384049255485284
12,74,45,131,0.13953488372093023,0.6564885496183206,0.20489485967013868,0.829808051684479
16,30,4,50,0.34782608695652173,0.92,0.23744144352107036,0.869661531537959
25,72,2,99,0.25773195876288657,0.9797979797979798,0.24101680869923653,0.8702812254091865
5,7,18,30,0.4166666666666667,0.4,0.2706704883529162,0.81517918459286
13,73,10,96,0.1511627906976744,0.8958333333333334,0.24054103480726377,0.8256275128603372
24,29,1,54,0.4528301886792453,0.9814814814814815,0.2771936785838716,0.8268781141109384
0,7,55,62,0.0,0.11290322580645161,0.2522503679262752,0.7066435100053666
10,187,11,208,0.050761421319796954,0.9471153846153846,0.2395684447261133,0.7481616292906613
4,107,124,235,0.036036036036036036,0.4723404255319149,0.19502700888032964,0.6842102615095064
49,91,8,148,0.35,0.9459459459459459,0.20820815762848868,0.6793742566735015
9,50,6,65,0.15254237288135594,0.9076923076923077,0.17047611565915857,0.7519017292009741
47,176,6,229,0.21076233183856502,0.9737991266375546,0.17899033582214297,0.7630396996730057
3,9,55,67,0.25,0.1791044776119403,0.1500145945822508,0.6484144134059285
6,7,2,15,0.46153846153846156,0.8666666666666667,0.21594866051631673,0.7560949049573876
23,60,5,88,0.27710843373493976,0.9431818181818182,0.24828394800419426,0.7555329668954496
6,49,10,65,0.10909090909090909,0.8461538461538461,0.2587203584406047,0.8089348841271542
22,118,3,143,0.15714285714285714,0.9790209790209791,0.23116933803244147,0.8136598888521588
15,102,479,596,0.1282051282051282,0.19630872483221476,0.22769258879298035,0.7120336627292884
3,47,9,59,0.06,0.847457627118644,0.20615511281604246,0.6939848770837298
20,67,20,107,0.22988505747126436,0.8130841121495327,0.20328154959765166,0.7845533963033857
2,0,0,2,1.0,1.0,0.2802046265207286,0.8036010153510048
11,5,1,17,0.6875,0.9411764705882353,0.33883199313002293,0.8033145371233502
20,82,2,104,0.19607843137254902,0.9807692307692307,0.3512587820274001,0.8225453063541195
46,82,20,148,0.359375,0.8648648648648649,0.380149088149849,0.8062372900461031
30,29,4,63,0.5084745762711864,0.9365079365079365,0.43447329501642873,0.9119800345712062
7,19,5,31,0.2692307692307692,0.8387096774193549,0.46436340490653866,0.9107303274713077
6,16,2,24,0.2727272727272727,0.9166666666666666,0.48011580963865436,0.9208187296357028
45,54,18,117,0.45454545454545453,0.8461538461538461,0.4021937317165764,0.8988407076576809
22,87,2,111,0.2018348623853211,0.9819819819819819,0.3328129977716223,0.904670066428216
1,0,0,1,1.0,1.0,0.44461424000764715,0.9077095801060275
13,87,19,119,0.13,0.8403361344537815,0.4119951923885995,0.9070332532372519
155,222,33,410,0.41114058355437666,0.9195121951219513,0.4005116437922514,0.9046052901821111
23,64,20,107,0.26436781609195403,0.8130841121495327,0.39065942704348294,0.9025335623611085
2,31,7,40,0.06060606060606061,0.825,0.36035639674045256,0.8894383242658704
0,13,1,14,0.0,0.9285714285714286,0.29542133180538765,0.9012122646112394
5,10,1,16,0.3333333333333333,0.9375,0.3142068276551037,0.8948576957566706
41,170,60,271,0.1943127962085308,0.7785977859778598,0.19910865568489383,0.8632288080392219
45,91,35,171,0.33088235294117646,0.7953216374269005,0.22780613467649052,0.8567981656068103
3,22,0,25,0.12,1.0,0.18621462274015094,0.8682964234465315
9,39,78,126,0.1875,0.38095238095238093,0.1752335061555861,0.8065633189897955
7,42,4,53,0.14285714285714285,0.9245283018867925,0.18698366076288359,0.8207816478307659
25,153,24,202,0.1404494382022472,0.8811881188118812,0.20704786622034746,0.8140126035794021
35,130,3,168,0.21212121212121213,0.9821428571428571,0.18973184890433012,0.8203901545998102
42,100,7,149,0.29577464788732394,0.9530201342281879,0.20422639914415772,0.8453076329212855
39,74,3,116,0.34513274336283184,0.9741379310344828,0.20626216920439422,0.8708528177223688
49,172,6,227,0.22171945701357465,0.973568281938326,0.22079352020633344,0.8670768579992725
30,71,1,102,0.297029702970297,0.9901960784313726,0.2364406206306616,0.9541116719248428
10,37,13,60,0.2127659574468085,0.7833333333333333,0.24642759414347096,0.9339409621314915
3,23,13,39,0.11538461538461539,0.6666666666666666,0.2428469051695236,0.9032950403964607
37,122,4,163,0.23270440251572327,0.9754601226993865,0.245787360940168,0.9023403640473935
23,88,29,140,0.2072072072072072,0.7928571428571428,0.23313486941443706,0.879459936708673
52,74,15,141,0.4126984126984127,0.8936170212765957,0.24278710789094862,0.8679569496004033
21,86,3,110,0.19626168224299065,0.9727272727272728,0.23915028292372234,0.8678368054273956
12,50,4,66,0.1935483870967742,0.9393939393939394,0.22436723779893336,0.8605793569934767
12,107,12,131,0.10084033613445378,0.9083969465648855,0.20837786332573982,0.8784455874551268
16,30,4,50,0.34782608695652173,0.92,0.24158378783601214,0.9146360636456032
26,71,2,99,0.26804123711340205,0.9797979797979798,0.24663190706425198,0.9152557575168307
6,7,17,30,0.46153846153846156,0.43333333333333335,0.28296494339728834,0.8638952132991436
14,81,1,96,0.14736842105263157,0.9895833333333334,0.24506065887646247,0.8776046864501061
22,31,1,54,0.41509433962264153,0.9814814814814815,0.2763224670735554,0.8788552877007074
0,4,55,59,0.0,0.06779661016949153,0.24867269748830198,0.7543413835257863
12,185,11,208,0.06091370558375635,0.9471153846153846,0.24296889312391665,0.759872588961572
44,167,24,235,0.20853080568720378,0.8978723404255319,0.2230695672282998,0.7567114947366479
51,91,4,146,0.3591549295774648,0.9726027397260274,0.23608580900888015,0.7556836032977976
10,48,7,65,0.1724137931034483,0.8923076923076924,0.1947822849467354,0.8212513688655632
47,176,6,229,0.21076233183856502,0.9737991266375546,0.2038385579161545,0.8189964821947376
7,48,12,67,0.12727272727272726,0.8208955223880597,0.1627211847233096,0.7960556308956773
6,7,2,15,0.46153846153846156,0.8666666666666667,0.22865525065737552,0.9101799246809881
25,58,5,88,0.30120481927710846,0.9431818181818182,0.2629825526135687,0.90961798661905
7,48,10,65,0.12727272727272726,0.8461538461538461,0.2513742556972149,0.9022296302945234
22,117,3,142,0.15827338129496402,0.9788732394366197,0.22267689165685764,0.9031254159674652
15,102,479,596,0.1282051282051282,0.19630872483221476,0.21636136809995477,0.803696992042397
2,48,9,59,0.04,0.847457627118644,0.19196674926587404,0.7856482063968383
21,66,20,107,0.2413793103448276,0.8130841121495327,0.20826768970474552,0.7845322906484773
2,0,0,2,1.0,1.0,0.28519076662782245,0.8035799096960964
11,5,1,17,0.6875,0.9411764705882353,0.3403757924453784,0.8032934314684417
21,80,2,103,0.2079207920792079,0.9805825242718447,0.35189694456058984,0.8224975283424415
43,84,21,148,0.33858267716535434,0.8581081081081081,0.3776554153992171,0.8052453667240826
30,29,4,63,0.5084745762711864,0.9365079365079365,0.43197962226579684,0.9109881112491858
7,19,5,31,0.2692307692307692,0.8387096774193549,0.4647268750130496,0.9097384041492874
6,14,2,22,0.3,0.9090909090909091,0.48709225831411346,0.9207745096515747
42,49,23,114,0.46153846153846156,0.7982456140350878,0.4101691813910366,0.89195245451373
20,74,2,96,0.2127659574468085,0.9791666666666666,0.3423500324548664,0.8973796253820774
1,0,0,1,1.0,1.0,0.4529491107958802,0.9003871441790698
13,66,27,106,0.16455696202531644,0.7452830188679245,0.4209672836471946,0.885125764580725
150,190,35,375,0.4411764705882353,0.9066666666666666,0.41619588356173665,0.8808627260319721
18,57,20,95,0.24,0.7894736842105263,0.4028625502284033,0.8754180799339686
2,23,8,33,0.08,0.7575757575757576,0.3714339787998319,0.8537730582889468
0,13,1,14,0.0,0.9285714285714286,0.30549991286576594,0.8723910317941385
4,6,1,11,0.4,0.9090909090909091,0.3322476332305076,0.8623802092833159
40,141,61,242,0.22099447513812154,0.7479338842975206,0.22096112967881068,0.8263707641829617
44,79,34,157,0.35772357723577236,0.7834394904458599,0.2485563604231615,0.8318216886940953
3,18,4,25,0.14285714285714285,0.84,0.20593931360443404,0.8222978791702859
8,17,97,122,0.32,0.20491803278688525,0.21736788503300547,0.7387899289669085
6,38,4,48,0.13636363636363635,0.9166666666666666,0.2254198330849535,0.7615172016941815
22,138,25,185,0.1375,0.8648648648648649,0.24506269022781063,0.7524162640218152
31,100,3,134,0.2366412213740458,0.9776119402985075,0.22172572185267433,0.7622049827657577
43,95,7,145,0.3115942028985507,0.9517241379310345,0.2346685401041642,0.791317876141974
37,66,3,106,0.3592233009708738,0.9716981132075472,0.23488278635203588,0.8182119651079293
49,172,6,227,0.22171945701357465,0.973568281938326,0.24614883123152612,0.8372931482419759
25,57,1,83,0.3048780487804878,0.9879518072289156,0.24398855248588153,0.9491551160194087
9,30,14,53,0.23076923076923078,0.7358490566037735,0.257475065972395,0.923324028867567
2,22,13,37,0.08333333333333333,0.6486486486486487,0.24973697073429976,0.8924359979795361
37,117,4,158,0.24025974025974026,0.9746835443037974,0.25025390200368464,0.8920176556945775
23,80,28,131,0.22330097087378642,0.7862595419847328,0.2376405831430041,0.8683798562736772
41,60,25,126,0.40594059405940597,0.8015873015873016,0.24431448215565152,0.8440783117564993
20,80,3,103,0.2,0.970873786407767,0.24121170258228375,0.8436933838235623
8,53,4,65,0.13114754098360656,0.9384615384615385,0.2163930586113007,0.8366233454282226
11,68,41,120,0.13924050632911392,0.6583333333333333,0.20331752654842683,0.8255496706753026
14,29,4,47,0.32558139534883723,0.9148936170212766,0.2379243925506417,0.8635846661571066
25,69,1,95,0.26595744680851063,0.9894736842105263,0.2415954934861803,0.8656975432866394
5,7,17,29,0.4166666666666667,0.41379310344827586,0.26921916431373466,0.8124880520671455
12,59,9,80,0.16901408450704225,0.8875,0.23537252009196838,0.8247612946975309
22,29,1,52,0.43137254901960786,0.9807692307692307,0.2684257413804838,0.8261749296063113
0,2,55,57,0.0,0.03508771929824561,0.24969037838282573,0.6971215268686981
10,159,11,180,0.05917159763313609,0.9388888888888889,0.23825196285482889,0.7372008919480633
4,70,125,199,0.05405405405405406,0.37185929648241206,0.19946234266985985,0.6596245604425112
48,79,9,136,0.3779527559055118,0.9338235294117647,0.21546167254086002,0.6516745383284024
11,46,7,64,0.19298245614035087,0.890625,0.18350678532281492,0.7197933806929344
46,158,6,210,0.22549019607843138,0.9714285714285714,0.1915748012615848,0.7317831766113019
3,15,49,67,0.16666666666666666,0.26865671641791045,0.1537596752111646,0.630052817418256
6,6,2,14,0.5,0.8571428571428571,0.22518824663973605,0.7474892656817721
23,48,5,76,0.323943661971831,0.9342105263157895,0.2630128272595496,0.7468209281713293
5,49,10,64,0.09259259259259259,0.84375,0.26851833276505516,0.814233885816699
22,96,3,121,0.1864406779661017,0.9752066115702479,0.2411594644879965,0.8201457546964822
14,79,412,505,0.15053763440860216,0.18415841584158416,0.23509591852631814,0.7192219569595657
2,42,9,53,0.045454545454545456,0.8301886792452831,0.20937653986576302,0.6990448295048102
23,58,20,101,0.2839506172839506,0.801980198019802,0.2261313899539464,0.7752338983050804
2,0,0,2,1.0,1.0,0.29755996138251783,0.7956420615703864
11,5,1,17,0.6875,0.9411764705882353,0.3494965811008277,0.7966371964664501
20,72,2,94,0.21739130434782608,0.9787234042553191,0.3673249684944325,0.8159191113600672
43,77,22,142,0.35833333333333334,0.8450704225352113,0.39188106211832274,0.7973282272122049
29,30,4,63,0.4915254237288136,0.9365079365079365,0.44059360344978155,0.9048067301645409
8,16,5,29,0.3333333333333333,0.8275862068965517,0.48171914457532256,0.9044349484004365
5,15,2,22,0.25,0.9090909090909091,0.4649736050904106,0.9237767677941165
42,49,23,114,0.46153846153846156,0.7982456140350878,0.38805052816733365,0.894954712656272
20,74,2,96,0.2127659574468085,0.9791666666666666,0.3202313792311634,0.9003818835246192
1,0,0,1,1.0,1.0,0.4367362336000955,0.9031029719599933
13,65,27,105,0.16666666666666666,0.7428571428571429,0.4073896112302173,0.8863682780824425
148,193,35,376,0.4340175953079179,0.9069148936170213,0.39917420717008933,0.8821407005265974
19,56,20,95,0.25333333333333335,0.7894736842105263,0.39690314489902706,0.8751069872110504
1,24,8,33,0.04,0.7575757575757576,0.3669031448990271,0.8534619655660288
0,13,1,14,0.0,0.9285714285714286,0.3009690789649611,0.8720799390712204
4,6,1,11,0.4,0.9090909090909091,0.3277167993297027,0.8620691165603979
41,140,61,242,0.2265193370165746,0.7479338842975206,0.217219561760642,0.8260596714600437
46,78,35,159,0.3709677419354839,0.779874213836478,0.24640542965618728,0.8313478244570914
3,18,4,25,0.14285714285714285,0.84,0.20481107930607653,0.8217885539403742
7,17,98,122,0.2916666666666667,0.19672131147540983,0.21028726978226706,0.7371096435496433
5,40,4,49,0.1111111111111111,0.9183673469387755,0.2204459999409972,0.760079870601503
21,140,25,186,0.13043478260869565,0.8655913978494624,0.23907954031366802,0.7510827233555079
34,97,3,134,0.2595419847328244,0.9776119402985075,0.21901410956121434,0.7608714420994503
41,97,7,145,0.2971014492753623,0.9517241379310345,0.22909726845532688,0.7899843354756667
36,67,3,106,0.34951456310679613,0.9716981132075472,0.22603252862265721,0.8173877496715337
50,171,6,227,0.22624434389140272,0.973568281938326,0.23794498591326577,0.8364689328055803
25,57,1,83,0.3048780487804878,0.9879518072289156,0.2398323262152402,0.9495018607703668
10,29,14,53,0.2564102564102564,0.7358490566037735,0.26058934697226094,0.923427819293938
3,21,13,37,0.125,0.6486486486486487,0.259812949456733,0.892435997979536
46,108,4,158,0.2987012987012987,0.9746835443037974,0.26540713716651504,0.8920176556945775
23,80,28,131,0.22330097087378642,0.7862595419847328,0.25486421168057566,0.8683798562736772
40,61,25,126,0.39603960396039606,0.8015873015873016,0.26151064608823277,0.8440783117564993
23,77,3,103,0.23,0.970873786407767,0.26204716838946096,0.8436933838235623
10,51,4,65,0.16393442622950818,0.9384615384615385,0.24191236516789244,0.8366233454282227
11,74,35,120,0.12941176470588237,0.7083333333333334,0.22376972349583898,0.8326925278181597
14,29,4,47,0.32558139534883723,0.9148936170212766,0.2524242085456729,0.8707275232999638
24,70,1,95,0.2553191489361702,0.9894736842105263,0.24622675857922596,0.8728404004294965
5,7,17,29,0.4166666666666667,0.41379310344827586,0.27385042940678034,0.8196309092100026
14,57,9,80,0.19718309859154928,0.8875,0.24544235721123075,0.8319041518403881
23,28,1,52,0.45098039215686275,0.9807692307692307,0.27701098466221113,0.8333177867491687
0,2,55,57,0.0,0.03508771929824561,0.25359178091513856,0.7042643840115553
12,157,11,180,0.07100591715976332,0.9388888888888889,0.24524808840855014,0.7372008919480633
3,74,123,200,0.03896103896103896,0.385,0.2043023232102932,0.6615018038021666
48,79,8,135,0.3779527559055118,0.9407407407407408,0.22182140992019916,0.6545399547350544
10,48,6,64,0.1724137931034483,0.90625,0.18692814226831084,0.7248909399567294
50,157,6,213,0.24154589371980675,0.971830985915493,0.19326568442949046,0.7369382236589426
10,48,9,67,0.1724137931034483,0.8656716417910447,0.1534704559932884,0.7204957109477732
6,6,2,14,0.5,0.8571428571428571,0.22489902742185983,0.837932159211289
23,49,5,77,0.3194444444444444,0.935064935064935,0.2603902456053857,0.8373858800935814
5,49,10,64,0.09259259259259259,0.84375,0.26805189612417907,0.9029215943792958
22,96,3,121,0.1864406779661017,0.9752066115702479,0.24069302784712046,0.9078452902120825
15,78,413,506,0.16129032258064516,0.18379446640316205,0.2391039606295772,0.8046373568411056
2,41,9,52,0.046511627906976744,0.8269230769230769,0.21124192265631578,0.7839362269850462
22,59,20,101,0.2716049382716049,0.801980198019802,0.2254120862517667,0.7748374493034399
2,0,0,2,1.0,1.0,0.2968406576803381,0.7952456125687462
11,5,1,17,0.6875,0.9411764705882353,0.34942002275970324,0.7961186890720747
21,72,2,95,0.22580645161290322,0.9789473684210527,0.368450574048319,0.8154325988465108
47,74,21,142,0.3884297520661157,0.852112676056338,0.3973061560626067,0.7978477509159523
28,31,4,63,0.4745762711864407,0.9365079365079365,0.44206129157772034,0.9053782466452057
8,16,5,29,0.3333333333333333,0.8275862068965517,0.4830358209243428,0.9054729794985593
6,16,2,24,0.2727272727272727,0.9166666666666666,0.4755554991318126,0.9248590188763677
45,50,22,117,0.47368421052631576,0.811965811965812,0.4003675292070006,0.8979969920143407
23,86,2,111,0.21100917431192662,0.9819819819819819,0.3233688398229901,0.903826350784876
1,0,0,1,1.0,1.0,0.4412606567439332,0.9065474392202502
13,81,27,121,0.13829787234042554,0.7768595041322314,0.40564651004616453,0.8946702255248545
148,231,35,414,0.39050131926121373,0.9154589371980676,0.393635802628275,0.8916632256234447
21,66,20,107,0.2413793103448276,0.8130841121495327,0.3896570227874262,0.8880024305848988
1,31,8,40,0.03125,0.8,0.3551602695406729,0.8713357639182321
0,13,1,14,0.0,0.9285714285714286,0.2874910966083421,0.887993709147606
5,10,1,16,0.3333333333333333,0.9375,0.30496597646854307,0.8816391402930371
40,170,61,271,0.19047619047619047,0.7749077490774908,0.18931971796514166,0.8494831044469643
43,95,34,172,0.3115942028985507,0.8023255813953488,0.21407633661630246,0.8531211154845525
3,19,4,26,0.13636363636363635,0.8461538461538461,0.17777095334521995,0.843220388192521
6,18,102,126,0.25,0.19047619047619047,0.17900248043881603,0.7542763993820435
5,44,4,53,0.10204081632653061,0.9245283018867925,0.18911545419974898,0.7720661567944423
23,154,26,203,0.12994350282485875,0.8719211822660099,0.20767881174615738,0.7639732644650968
38,127,3,168,0.23030303030303031,0.9821428571428571,0.19296019702754266,0.7703508154855049
40,104,7,151,0.2777777777777778,0.9536423841059603,0.20543185235634084,0.7958843347752864
44,70,3,117,0.38596491228070173,0.9743589743589743,0.21605623941093383,0.8204605337700901
51,170,6,227,0.23076923076923078,0.973568281938326,0.22954275289744733,0.8386625960250156
22,80,1,103,0.21568627450980393,0.9902912621359223,0.22464079211313362,0.9529218919764059
11,35,14,60,0.2391304347826087,0.7666666666666667,0.24422502332114476,0.9303702298021023
4,21,14,39,0.16,0.6410256410256411,0.24851880863187922,0.8973851524820494
45,114,4,163,0.2830188679245283,0.9754601226993865,0.2560496425778075,0.8964304761329823
24,88,28,140,0.21428571428571427,0.8,0.246979347793227,0.8744815641178452
41,75,25,141,0.35344827586206895,0.8226950354609929,0.2423341140191366,0.8528152871324192
19,88,3,110,0.17757009345794392,0.9727272727272728,0.23473423726038134,0.8526951429594117
10,52,4,66,0.16129032258064516,0.9393939393939394,0.2269633869847872,0.845424096853414
13,73,46,132,0.1511627906976744,0.6515151515151515,0.21439658068693948,0.8289738804031976
14,32,4,50,0.30434782608695654,0.92,0.23501769869936187,0.8688273602566774
23,74,2,99,0.23711340206185566,0.9797979797979798,0.22845977500469436,0.8694470541279051
5,8,17,30,0.38461538461538464,0.43333333333333335,0.2527925850517901,0.8170661017469527
14,72,10,96,0.16279069767441862,0.8958333333333334,0.22555578816784003,0.8275144300144299
24,30,2,56,0.4444444444444444,0.9642857142857143,0.26368069545162587,0.8263084930942073
0,9,44,53,0.0,0.16981132075471697,0.24063922079724792,0.7163681190028898
9,188,11,208,0.04568527918781726,0.9471153846153846,0.22557100486726833,0.7585967237314944
4,108,123,235,0.03571428571428571,0.4765957446808511,0.18719478481402965,0.6952532586859018
37,95,19,151,0.2803030303030303,0.8741721854304636,0.19336473170562604,0.6801638594905423
10,49,6,65,0.1694915254237288,0.9076923076923077,0.16263275182110376,0.74792942725611
47,176,6,229,0.21076233183856502,0.9737991266375546,0.16948584241598183,0.7590673977281417
2,6,59,67,0.25,0.11940298507462686,0.14170806463820407,0.6383698649837006
6,7,2,15,0.46153846153846156,0.8666666666666667,0.20764213057227,0.7379206286854076
25,58,5,88,0.30120481927710846,0.9431818181818182,0.24414492201359733,0.7373586906234697
7,48,10,65,0.12727272727272726,0.8461538461538461,0.257224699379089,0.7901527051196119
23,117,3,143,0.16428571428571428,0.9790209790209791,0.24065079709090093,0.8051311042039713
17,104,474,595,0.14049586776859505,0.20336134453781513,0.23650856028302472,0.7045123951819008
3,47,9,59,0.06,0.847457627118644,0.21497108430608683,0.6864636095363422
23,64,20,107,0.26436781609195403,0.8130841121495327,0.21702362946208026,0.7855609134041858
2,0,0,2,1.0,1.0,0.2939467063851572,0.804608532451805
11,5,1,17,0.6875,0.9411764705882353,0.3491317322027131,0.8043220542241503
19,84,2,105,0.18446601941747573,0.9809523809523809,0.35730220250910577,0.8235789877667979
48,81,21,150,0.37209302325581395,0.86,0.38698896093340573,0.8065759907638009
29,30,4,63,0.4915254237288136,0.9365079365079365,0.4371360403562941,0.9113112181881041
7,19,5,31,0.2692307692307692,0.8387096774193549,0.467026150246404,0.9100615110882055
6,16,2,24,0.2727272727272727,0.9166666666666666,0.48755912503037596,0.9248590188763677
44,50,23,117,0.46808510638297873,0.8034188034188035,0.4115712830850872,0.8967759907933395
24,85,2,111,0.22018348623853212,0.9819819819819819,0.3358832096905918,0.9026053495638748
1,0,0,1,1.0,1.0,0.45100110150751277,0.905326437999249
14,80,27,121,0.14893617021276595,0.7768595041322314,0.41801413136072074,0.8934492243038533
147,230,37,414,0.38992042440318303,0.9106280193236715,0.40107782395100594,0.8897520932775297
24,63,20,107,0.27586206896551724,0.8130841121495327,0.39653064699003593,0.8860912982389839
1,31,8,40,0.03125,0.8,0.36203389374328265,0.8694246315723172
0,13,1,14,0.0,0.9285714285714286,0.29516459283142854,0.8873035780226922
4,11,1,16,0.26666666666666666,0.9375,0.30180504717830486,0.8809490091681234
40,170,61,271,0.19047619047619047,0.7749077490774908,0.18615878867490349,0.8487929733220506
44,94,34,172,0.3188405797101449,0.8023255813953488,0.2104308471745291,0.8524309843596389
3,19,4,26,0.13636363636363635,0.8461538461538461,0.17420844888316525,0.843220388192521
6,20,100,126,0.23076923076923078,0.20634920634920634,0.16776661485512437,0.7565439730781885
6,43,4,53,0.12244897959183673,0.9245283018867925,0.18079504051110104,0.7743337304905875
23,154,26,203,0.12994350282485875,0.8719211822660099,0.19935839805750946,0.7662408381612419
39,126,3,168,0.23636363636363636,0.9821428571428571,0.1950293937285051,0.77261838918165
43,101,7,151,0.2986111111111111,0.9536423841059603,0.21047723953349376,0.7981519084714315
41,73,3,117,0.35964912280701755,0.9743589743589743,0.21630703140447555,0.822728107466235
51,170,6,227,0.23076923076923078,0.973568281938326,0.22979354489098908,0.8409301697211607
22,80,1,103,0.21568627450980393,0.9902912621359223,0.2276388368539281,0.9529218919764059
11,35,14,60,0.2391304347826087,0.7666666666666667,0.2443076161668955,0.9303702298021023
3,22,14,39,0.12,0.6410256410256411,0.24288711576334426,0.8973851524820496
47,112,4,163,0.29559748427672955,0.9754601226993865,0.2513490940366433,0.8964304761329824
24,88,28,140,0.21428571428571427,0.8,0.2393026087758723,0.8744815641178452
41,75,25,141,0.35344827586206895,0.8226950354609929,0.23841677349802248,0.8528152871324192
19,88,3,110,0.17757009345794392,0.9727272727272728,0.23081689673926722,0.8526951429594117
10,52,4,66,0.16129032258064516,0.9393939393939394,0.22304604646367313,0.845424096853414
13,72,47,132,0.15294117647058825,0.6439393939393939,0.21073329527624166,0.8278916293209465
13,33,4,50,0.2826086956521739,0.92,0.23396310894083788,0.8677451091744263
24,73,2,99,0.24742268041237114,0.9797979797979798,0.22708099410307242,0.8683648030456539
5,7,18,30,0.4166666666666667,0.4,0.25599255872892274,0.8112219459027968
13,73,10,96,0.1511627906976744,0.8958333333333334,0.22709463227686638,0.821670274170274
25,30,1,56,0.45454545454545453,0.9821428571428571,0.26666254100365366,0.8230153576582148
0,9,50,59,0.0,0.15254237288135594,0.24362106634927574,0.7106079910135599
12,185,11,208,0.06091370558375635,0.9471153846153846,0.23047428479401405,0.7539188468244158
4,109,122,235,0.035398230088495575,0.4808510638297872,0.19515850399920284,0.6911832845143854
37,95,19,151,0.2803030303030303,0.8741721854304636,0.1998556968407256,0.6760938853190258
11,48,6,65,0.1864406779661017,0.9076923076923077,0.16696626988350202,0.7486213578464983
44,179,6,229,0.19730941704035873,0.9737991266375546,0.17355864507531407,0.7597593283185299
9,56,2,67,0.13846153846153847,0.9701492537313433,0.12840379992046894,0.7580459564025993
6,7,2,15,0.46153846153846156,0.8666666666666667,0.19433786585453486,0.8600637126576439
24,59,5,88,0.2891566265060241,0.9431818181818182,0.22694399741485882,0.8595017745957058
7,48,10,65,0.12727272727272726,0.8461538461538461,0.24006892558403475,0.9116878863562856
23,117,3,143,0.16428571428571428,0.9790209790209791,0.22349502329584678,0.9266662854406451
17,104,475,596,0.14049586776859505,0.20302013422818793,0.21693147898191725,0.8259988320886279
3,47,9,59,0.06,0.847457627118644,0.1973158479761517,0.8079500464430692
23,64,20,107,0.26436781609195403,0.8130841121495327,0.2153024590662111,0.7855121690742392
2,0,0,2,1.0,1.0,0.29222553598928797,0.8045597881218581
12,4,1,17,0.75,0.9411764705882353,0.3580603036312846,0.8042733098942033
18,85,2,105,0.17475728155339806,0.9809523809523809,0.36484381138566613,0.8235302434368512
50,79,21,150,0.3875968992248062,0.86,0.3967454092341078,0.8065272464338543
28,31,4,63,0.4745762711864407,0.9365079365079365,0.44447118115094286,0.9113112181881041
7,19,5,31,0.2692307692307692,0.8387096774193549,0.47436129104105274,0.9100615110882055
6,16,2,24,0.2727272727272727,0.9166666666666666,0.4869182076768058,0.9258113998287485
47,50,20,117,0.4845360824742268,0.8290598290598291,0.413280505173124,0.9013913754087242
24,85,2,111,0.22018348623853212,0.9819819819819819,0.3375924317786286,0.9072207341792594
1,0,0,1,1.0,1.0,0.4527103235955495,0.9099418226146335
13,81,27,121,0.13829787234042554,0.7768595041322314,0.4164232064573685,0.897112227966857
150,229,35,414,0.39577836411609496,0.9154589371980676,0.402745055084123,0.8941052280654472
24,63,20,107,0.27586206896551724,0.8130841121495327,0.398197878123153,0.8904444330269012
1,31,8,40,0.03125,0.8,0.3637011248763997,0.8737777663602345
0,13,1,14,0.0,0.9285714285714286,0.2944816845229387,0.887993709147606
5,10,1,16,0.3333333333333333,0.9375,0.31064594839362464,0.8816391402930371
42,168,61,271,0.2,0.7749077490774908,0.19636023410791031,0.8494831044469643
46,91,35,172,0.3357664233576642,0.7965116279069767,0.224570027110373,0.8522905507004994
3,19,4,26,0.13636363636363635,0.8461538461538461,0.1875107802885932,0.8423898234084677
8,22,96,126,0.26666666666666666,0.23809523809523808,0.18619715138875742,0.7602485556864256
6,43,4,53,0.12244897959183673,0.9245283018867925,0.19922557704473406,0.7780383130988245
24,153,26,203,0.13559322033898305,0.8719211822660099,0.21859603709316025,0.7699454207694789
41,124,3,168,0.24848484848484848,0.9821428571428571,0.20647482497194813,0.7763229717898872
45,99,7,151,0.3125,0.9536423841059603,0.22254625354337668,0.8018564910796685
40,74,3,117,0.3508771929824561,0.9743589743589743,0.22470493491834698,0.8272632548585254
50,171,6,227,0.22624434389140272,0.973568281938326,0.23754503599374213,0.8454653171134511
32,70,1,103,0.3137254901960784,0.9902912621359223,0.2442677250693724,0.9529218919764059
12,30,18,60,0.2857142857142857,0.7,0.26759134022972225,0.9208464202782928
2,23,14,39,0.08,0.6410256410256411,0.2596494516098676,0.8878613429582402
47,112,4,163,0.29559748427672955,0.9754601226993865,0.26637982815156486,0.8869066666091728
24,86,30,140,0.21818181818181817,0.7857142857142857,0.2529058021775389,0.862916938267505
44,72,25,141,0.3793103448275862,0.8226950354609929,0.25696768101255746,0.8412506612820791
21,86,3,110,0.19626168224299065,0.9727272727272728,0.2526844436342129,0.8411305171090715
9,53,4,66,0.14516129032258066,0.9393939393939394,0.22860384365228462,0.833859471003074
13,74,45,132,0.14942528735632185,0.6590909090909091,0.20913398674400405,0.8280153151589181
15,31,4,50,0.32608695652173914,0.92,0.24428926624710964,0.8678687950123979
29,68,2,99,0.29896907216494845,0.9797979797979798,0.24477092165971234,0.8684884888836255
4,8,18,30,0.3333333333333333,0.4,0.2612211381099288,0.813386448067299
13,72,11,96,0.15294117647058825,0.8854166666666666,0.22888268548750051,0.822346681096681
24,32,1,57,0.42857142857142855,0.9824561403508771,0.2620697921058488,0.8237365193286245
0,9,50,59,0.0,0.15254237288135594,0.24133246491690868,0.7113291526839697
14,183,11,208,0.07106598984771574,0.9471153846153846,0.2301382795585364,0.7524755063303232
4,108,123,235,0.03571428571428571,0.4765957446808511,0.1886564694431859,0.6891320412847307
50,91,10,151,0.3546099290780142,0.9337748344370861,0.19660516328790958,0.6825573062331743
12,46,7,65,0.20689655172413793,0.8923076923076924,0.1785427659151674,0.7528869765628448
48,176,6,230,0.21428571428571427,0.9739130434782609,0.18730627131732822,0.7655293161073582
3,10,54,67,0.23076923076923078,0.19402985074626866,0.15904881448844285,0.6528969890209855
7,6,2,15,0.5384615384615384,0.8666666666666667,0.23597189141151978,0.75491474527603
24,59,5,88,0.2891566265060241,0.9431818181818182,0.26712769664842095,0.7543528072140919
5,50,10,65,0.09090909090909091,0.8461538461538461,0.2750126688191074,0.8071468217102341
23,117,3,143,0.16428571428571428,0.9790209790209791,0.24782349527735031,0.8136105566507902
17,108,471,596,0.136,0.20973154362416108,0.23769541645961628,0.7160996782674285
2,48,9,59,0.04,0.847457627118644,0.21279745727594282,0.6980346187874833
23,64,20,107,0.26436781609195403,0.8130841121495327,0.217597255179189,0.7864709418450924
2,0,0,2,1.0,1.0,0.28353132111325496,0.8055185608927113
12,4,1,17,0.75,0.9411764705882353,0.3493660887552515,0.8052320826650566
20,83,2,105,0.1941747572815534,0.9809523809523809,0.3641183268084604,0.8244890162077045
49,80,21,150,0.3798449612403101,0.86,0.3949125049448313,0.8074860192047076
30,29,4,63,0.5084745762711864,0.9365079365079365,0.4481231586978579,0.9113112181881041
8,18,5,31,0.3076923076923077,0.8387096774193549,0.48636491693961614,0.9100615110882055
6,16,2,24,0.2727272727272727,0.9166666666666666,0.48778659965210686,0.9248590188763676
46,50,21,117,0.4791666666666667,0.8205128205128205,0.413381837747345,0.899217993235342
24,85,2,111,0.22018348623853212,0.9819819819819819,0.32876519292427814,0.9050473520058772
1,0,0,1,1.0,1.0,0.44249612218918793,0.9077684404412513
15,78,27,120,0.16129032258064516,0.775,0.4079517718158803,0.8956255832983943
153,226,35,414,0.40369393139841686,0.9154589371980676,0.3954044157686808,0.8926185833969844
22,65,20,107,0.25287356321839083,0.8130841121495327,0.39856217754713225,0.8889577883584384
2,30,8,40,0.0625,0.8,0.3685297100146648,0.8722911216917718
0,13,1,14,0.0,0.9285714285714286,0.30007732906228374,0.8877280657001442
5,10,1,16,0.3333333333333333,0.9375,0.3162415929329696,0.8813734968455754
40,170,61,271,0.19047619047619047,0.7749077490774908,0.20059533442956828,0.8492174609995028
45,92,35,172,0.3284671532846715,0.7965116279069767,0.22447773881585778,0.8522905507004994
3,19,4,26,0.13636363636363635,0.8461538461538461,0.186287696668032,0.8423898234084677
7,17,102,126,0.2916666666666667,0.19047619047619047,0.19182956858921424,0.7534458345979903
7,42,4,53,0.14285714285714285,0.9245283018867925,0.20330916042594893,0.7712355920103892
19,158,26,203,0.10734463276836158,0.8719211822660099,0.2186441079642863,0.7631426996810436
37,128,3,168,0.22424242424242424,0.9821428571428571,0.2030596923798707,0.7695202507014518
46,98,7,151,0.3194444444444444,0.9536423841059603,0.22148372866104984,0.7950537699912331
42,72,3,117,0.3684210526315789,0.9743589743589743,0.22719142856775093,0.82046053377009
49,172,6,227,0.22171945701357465,0.973568281938326,0.23938511723202782,0.8386625960250156
32,70,1,103,0.3137254901960784,0.9902912621359223,0.2425363777362295,0.9529218919764059
11,32,17,60,0.2558139534883721,0.7166666666666667,0.25867306496926223,0.9232273726592451
3,22,14,39,0.12,0.6410256410256411,0.26048097457378205,0.8902422953391925
47,112,4,163,0.29559748427672955,0.9754601226993865,0.2706745545786828,0.8892876189901252
26,72,42,140,0.2653061224489796,0.7,0.26294050857933066,0.8530529926892737
46,70,25,141,0.39655172413793105,0.8226950354609929,0.26695917593738094,0.8313867157038477
20,87,3,110,0.18691588785046728,0.9727272727272728,0.2619872374855085,0.83126657153084
9,53,4,66,0.14516129032258066,0.9393939393939394,0.23790663750358024,0.8239955254248426
13,90,29,132,0.1262135922330097,0.7803030303030303,0.2193923001813856,0.8330864345157517
15,31,4,50,0.32608695652173914,0.92,0.24883329397020545,0.8729399143692316
29,68,2,99,0.29896907216494845,0.9797979797979798,0.24931494938280818,0.8735596082404592
6,20,4,30,0.23076923076923078,0.8666666666666667,0.2443811077142726,0.897369132049983
14,72,10,96,0.16279069767441862,0.8958333333333334,0.21098667536234225,0.9078174603174602
25,31,1,57,0.44642857142857145,0.9824561403508771,0.2480599158735,0.9092072985494036
0,9,50,59,0.0,0.15254237288135594,0.22732258868455993,0.796799931904749
14,183,11,208,0.07106598984771574,0.9471153846153846,0.2194443597723751,0.8206302682350852
3,109,123,235,0.026785714285714284,0.4765957446808511,0.17668703945294295,0.7572868031894926
52,90,9,151,0.36619718309859156,0.9403973509933775,0.18629105530060625,0.7516581419316922
9,50,6,65,0.15254237288135594,0.9076923076923077,0.1751157898880527,0.757518947792498
53,171,6,230,0.23660714285714285,0.9739130434782609,0.1856609963427276,0.7686731920989163
3,11,52,66,0.21428571428571427,0.21212121212121213,0.15249773103660513,0.6586253452089642
7,6,2,15,0.5384615384615384,0.8666666666666667,0.22942080795968206,0.7606431014640086
25,58,5,88,0.30120481927710846,0.9431818181818182,0.2622977835924524,0.7600811634020707
6,49,10,65,0.10909090909090909,0.8461538461538461,0.27405566856462316,0.8128751778982126
23,117,3,143,0.16428571428571428,0.9790209790209791,0.2452111730199264,0.8183928390450129
16,105,475,596,0.1322314049586777,0.20302013422818793,0.2423096061738295,0.7177253856929957
2,48,9,59,0.04,0.847457627118644,0.21422287147995195,0.6996603262130504
23,64,20,107,0.26436781609195403,0.8130841121495327,0.22137745745227194,0.7855121690742392
2,0,0,2,1.0,1.0,0.2873115233863378,0.8045597881218581
12,4,1,17,0.75,0.9411764705882353,0.3514251206324652,0.8042733098942033
20,83,2,105,0.1941747572815534,0.9809523809523809,0.3635799560882715,0.8235302434368512
51,79,20,150,0.3923076923076923,0.8666666666666667,0.3961545243771255,0.8074796273862352
29,30,4,63,0.4915254237288136,0.9365079365079365,0.44748224134428777,0.9122635991404849
8,18,5,31,0.3076923076923077,0.8387096774193549,0.48572399958604606,0.9110138920405866
6,16,2,24,0.2727272727272727,0.9166666666666666,0.5047562947432475,0.9226777787962231
48,52,17,117,0.48,0.8547008547008547,0.4304705804575332,0.9019207580392024
26,83,2,111,0.23853211009174313,0.9819819819819819,0.3484751676134966,0.9077501168097376
1,0,0,1,1.0,1.0,0.4606103442648023,0.9107576356067301
14,85,21,120,0.1414141414141414,0.825,0.42059984970885317,0.9068843961701104
160,224,30,414,0.4166666666666667,0.927536231884058,0.40990574155711784,0.9056027240809847
21,66,20,107,0.2413793103448276,0.8130841121495327,0.3986742144635218,0.9027099781975848
2,31,7,40,0.06060606060606061,0.825,0.3683711841604915,0.8896147401023465
0,13,1,14,0.0,0.9285714285714286,0.29979975558906297,0.9001676792267144
5,10,1,16,0.3333333333333333,0.9375,0.3133427874807187,0.8938131103721455
40,171,60,271,0.1895734597156398,0.7785977859778598,0.19756756744009582,0.8621842226546969
47,90,34,171,0.34306569343065696,0.8011695906432749,0.22637493201388376,0.858779878460879
3,23,0,26,0.11538461538461539,1.0,0.18333463897359073,0.869131845334585
9,29,88,126,0.23684210526315788,0.30158730158730157,0.18268646681906647,0.7960608723971233
7,41,4,52,0.14583333333333334,0.9230769230769231,0.19486179149439112,0.8100718614081125
29,147,26,202,0.16477272727272727,0.8712871287128713,0.21840075253335217,0.8018883899997471
37,128,3,168,0.22424242424242424,0.9821428571428571,0.2028163369489366,0.8082659410201553
47,97,7,151,0.3263888888888889,0.9536423841059603,0.22236139825940077,0.8332723121813125
42,72,3,117,0.3684210526315789,0.9743589743589743,0.22598359243096103,0.8580136527121267
48,173,6,227,0.2171945701357466,0.973568281938326,0.24052787168112263,0.8542376929890304
32,70,1,103,0.3137254901960784,0.9902912621359223,0.2515112123858256,0.9526239730674048
12,36,12,60,0.25,0.8,0.26639216476677796,0.9350415554849871
4,21,14,39,0.16,0.6410256410256411,0.2657103465849598,0.9021470572439544
47,112,4,163,0.29559748427672955,0.9754601226993865,0.2759039265898605,0.9011923808948872
26,110,4,140,0.19117647058823528,0.9714285714285714,0.2565878668326243,0.9037332647981173
44,72,25,141,0.3793103448275862,0.8226950354609929,0.2581434800034825,0.8820669878126913
22,85,3,110,0.205607476635514,0.9727272727272728,0.2564881809320207,0.8819468436396837
10,52,4,66,0.16129032258064516,0.9393939393939394,0.23471172841553023,0.8746757975336862
13,107,12,132,0.10833333333333334,0.9090909090909091,0.214473633177435,0.8902602131181018
15,34,1,50,0.30612244897959184,0.98,0.23534826874594808,0.9386851215430101
30,67,2,99,0.30927835051546393,0.9797979797979798,0.23730267820862444,0.9393048154142377
5,21,4,30,0.19230769230769232,0.8666666666666667,0.237464281311404,0.9243388290196799
17,78,1,96,0.17894736842105263,0.9895833333333334,0.2088409989676135,0.9481800144300143
23,32,2,57,0.41818181818181815,0.9649122807017544,0.23920876204565694,0.9470635869977974
0,10,49,59,0.0,0.1694915254237288,0.21616728739127908,0.8370775278591959
16,181,11,208,0.08121827411167512,0.9471153846153846,0.21229370750247073,0.8425095957912638
46,166,23,235,0.2169811320754717,0.902127659574468,0.19955923365902503,0.8313849757304735
58,89,4,151,0.3945578231292517,0.9735099337748344,0.21174201546099472,0.8304866834414527
10,48,7,65,0.1724137931034483,0.8923076923076924,0.20890002986038844,0.8341496871044564
50,174,6,230,0.22321428571428573,0.9739130434782609,0.21522387518799313,0.8319110742680175
8,45,13,66,0.1509433962264151,0.803030303030303,0.1770469577657927,0.8087850774578101
7,6,2,15,0.5384615384615384,0.8666666666666667,0.25397003468886964,0.9083815262068013
24,59,5,88,0.2891566265060241,0.9431818181818182,0.28367551360234805,0.9078195881448633
7,55,3,65,0.11290322580645161,0.9538461538461539,0.2688072412782023,0.9152079444693898
23,117,3,143,0.16428571428571428,0.9790209790209791,0.23591122572912557,0.9159952366474106
16,108,472,596,0.12903225806451613,0.2080536912751678,0.22971386358070664,0.8182446650713355
3,47,9,59,0.06,0.847457627118644,0.20639753705009442,0.8001796055913903
23,64,20,107,0.26436781609195403,0.8130841121495327,0.2226010256023143,0.8016158640369946
2,0,0,2,1.0,1.0,0.2885350915363802,0.8206634830846136
13,3,1,17,0.8125,0.9411764705882353,0.36329843060694816,0.8203770048569589
21,82,2,105,0.20388349514563106,0.9809523809523809,0.3762956119411167,0.8242493230149913
52,77,21,150,0.40310077519379844,0.86,0.41041204921370017,0.8072463260119943
29,30,4,63,0.4915254237288136,0.9365079365079365,0.4621967871657426,0.9113112181881041
6,20,5,31,0.23076923076923078,0.8387096774193549,0.4865923915613471,0.9100615110882057
6,14,2,22,0.3,0.9090909090909091,0.5199629155630601,0.9365588709920312
43,46,24,113,0.48314606741573035,0.7876106194690266,0.4461266394795929,0.9062175309161777
22,72,2,96,0.23404255319148937,0.9791666666666666,0.36348986136409145,0.9116447017845252
1,0,0,1,1.0,1.0,0.47101674308452157,0.9146522205815176
15,65,27,107,0.1875,0.7476635514018691,0.43808348781520073,0.8987248808421467
152,185,39,376,0.45103857566765576,0.8962765957446809,0.4322996523778925,0.892977546447396
18,57,20,95,0.24,0.7894736842105263,0.4136753137535538,0.8727545752262397
2,23,8,33,0.08,0.7575757575757576,0.38224674232498235,0.8511095535812181
0,13,1,14,0.0,0.9285714285714286,0.3132258755513066,0.8712468120244183
4,5,2,11,0.4444444444444444,0.8181818181818182,0.3432832885874431,0.8482489765265828
39,143,60,242,0.21428571428571427,0.7520661157024794,0.2310383906282594,0.8128298501983656
45,78,35,158,0.36585365853658536,0.7784810126582279,0.2565174847049145,0.8172323446635597
3,18,4,25,0.14285714285714285,0.84,0.21249156573198405,0.8091928309857481
7,19,96,122,0.2692307692307692,0.21311475409836064,0.2166673899078082,0.7268558409697244
6,40,3,49,0.13043478260869565,0.9387755102040817,0.2238723588519076,0.752741519916628
20,141,25,186,0.12422360248447205,0.8655913978494624,0.24161858777826076,0.7437443726706328
34,98,3,135,0.25757575757575757,0.9777777777777777,0.214923061082734,0.7665437954700556
42,95,7,144,0.30656934306569344,0.9513888888888888,0.22810643662273106,0.7950184773538282
39,64,3,106,0.3786407766990291,0.9716981132075472,0.22993316778879444,0.8226209202894453
54,166,7,227,0.24545454545454545,0.9691629955947136,0.2445899395884234,0.841072776802976
26,56,1,83,0.3170731707317073,0.9879518072289156,0.2514245683742717,0.9517637843930552
12,31,10,53,0.27906976744186046,0.8113207547169812,0.27265813763615243,0.9335559621806121
4,19,13,36,0.17391304347826086,0.6388888888888888,0.27975662920669364,0.9011698894719589
40,114,4,158,0.2597402597402597,0.9746835443037974,0.2800658438016225,0.9007278561185331
23,80,28,131,0.22330097087378642,0.7862595419847328,0.2681703620599215,0.8771379494179393
43,57,25,125,0.43,0.8,0.27550739396006024,0.852609647531147
21,79,3,103,0.21,0.970873786407767,0.2704424588951252,0.8528540462187261
10,50,4,64,0.16666666666666666,0.9375,0.2489558154572622,0.8456466451860238
10,62,48,120,0.1388888888888889,0.6,0.22892997566398052,0.8154579659407408
15,31,1,47,0.32608695652173914,0.9787234042553191,0.2506691060987632,0.8640057538502308
31,63,1,95,0.32978723404255317,0.9894736842105263,0.26067581671337653,0.8661186309797635
4,20,5,29,0.16666666666666666,0.8275862068965517,0.2525852018266451,0.8720224402528804
14,55,11,80,0.2028985507246377,0.8625,0.2201421376444505,0.880951011681452
23,25,5,53,0.4791666666666667,0.9056603773584906,0.2585945185968314,0.8716348103886981
0,2,55,57,0.0,0.03508771929824561,0.23478499478730766,0.7427187702884475
15,153,11,179,0.08928571428571429,0.9385474860335196,0.22769882698685415,0.7910826968646646
5,74,121,200,0.06329113924050633,0.395,0.19015656737524944,0.7076936391139047
47,87,8,142,0.35074626865671643,0.9436619718309859,0.1931507151772728,0.7011491087739704
12,44,7,63,0.21428571428571427,0.8888888888888888,0.19995343626570813,0.7099066347728756
50,156,6,212,0.24271844660194175,0.9716981132075472,0.2056419928196087,0.7255063652310966
3,10,54,67,0.23076923076923078,0.19402985074626866,0.17015664483426077,0.6238448614293507
7,5,2,14,0.5833333333333334,0.8571428571428571,0.25348997816759405,0.7412813096928667
22,49,5,76,0.30985915492957744,0.9342105263157895,0.28500046968814596,0.7406617440189053
5,56,3,64,0.08196721311475409,0.953125,0.28766848024160996,0.8203938868760481
49,69,3,121,0.4152542372881356,0.9752066115702479,0.29688390433181266,0.8249002639816568
17,76,412,505,0.1827956989247312,0.18415841584158416,0.29238533070881506,0.7242244821177563
2,42,9,53,0.045454545454545456,0.8301886792452831,0.2642047734020442,0.7040088486945757
23,59,20,102,0.2804878048780488,0.803921568627451,0.271307426846161,0.791136236963316
2,0,0,2,1.0,1.0,0.3308312363699706,0.8115444002286221
13,3,1,17,0.8125,0.9411764705882353,0.40263707138003085,0.8125395351246858
20,73,2,95,0.21505376344086022,0.9789473684210527,0.4216494357123318,0.8162284448991218
51,70,21,142,0.4214876033057851,0.852112676056338,0.422539916571996,0.7986435969685634
29,30,4,63,0.4915254237288136,0.9365079365079365,0.46664416297257916,0.9061220999208993
8,17,5,30,0.32,0.8333333333333334,0.5058649421933584,0.9065713362191923
6,14,2,22,0.3,0.9090909090909091,0.4874104510891022,0.9366492716343623
43,46,25,114,0.48314606741573035,0.7807017543859649,0.4135741750056351,0.9053209508323573
22,72,2,96,0.23404255319148937,0.9791666666666666,0.3487945397472764,0.9107481217007046
1,0,0,1,1.0,1.0,0.46252546901218633,0.9134692101360787
32,66,9,107,0.32653061224489793,0.9158878504672897,0.4567173421900289,0.922405569726644
155,184,38,377,0.45722713864306785,0.8992042440318302,0.44939627967172624,0.9170764708014858
25,55,15,95,0.3125,0.8421052631578947,0.444778053070741,0.9037366696857935
2,23,8,33,0.08,0.7575757575757576,0.41334948164216956,0.8820916480407719
0,13,1,14,0.0,0.9285714285714286,0.3443286148684938,0.9032158872101238
2,8,1,11,0.2,0.9090909090909091,0.3394653929839953,0.8932050646993013
39,142,61,242,0.2154696132596685,0.7479338842975206,0.22738962344966224,0.8571956195989471
44,79,35,158,0.35772357723577236,0.7784810126582279,0.23184576130550144,0.8375660713405095
3,18,4,25,0.14285714285714285,0.84,0.18693576190751213,0.8291083221931055
9,18,95,122,0.3333333333333333,0.22131147540983606,0.18991195238370265,0.7404234953719542
6,39,3,48,0.13333333333333333,0.9375,0.19753100000275028,0.7661269585754173
23,140,25,188,0.1411042944785276,0.8670212765957447,0.21768875635682564,0.7573340797217482
37,96,3,136,0.2781954887218045,0.9779411764705882,0.22885954045994053,0.7671698322045595
46,91,7,144,0.3357664233576642,0.9513888888888888,0.2460447990453685,0.7962348328604693
38,65,3,106,0.36893203883495146,0.9716981132075472,0.2476460078452512,0.8238372757960863
52,168,6,226,0.23636363636363636,0.9734513274336283,0.2610040783461789,0.8429017511437474
26,56,1,83,0.3170731707317073,0.9879518072289156,0.258681197974518,0.952421798546473
12,30,11,53,0.2857142857142857,0.7924528301886793,0.2804499054575112,0.931700774287713
4,19,13,36,0.17391304347826086,0.6388888888888888,0.2851368696003303,0.8991104331867337
46,109,4,159,0.2967741935483871,0.9748427672955975,0.2877909702898421,0.8986678033045921
23,82,26,131,0.21904761904761905,0.8015267175572519,0.271116855388407,0.8772589216857869
46,55,25,126,0.45544554455445546,0.8015873015873016,0.2834759276340505,0.852957377168609
22,78,3,103,0.22,0.970873786407767,0.28113826529638813,0.8525891570220573
13,47,4,64,0.21666666666666667,0.9375,0.2667944790013823,0.845381755989355
10,62,48,120,0.1388888888888889,0.6,0.24581942231203993,0.8178884945338295
15,31,1,47,0.32608695652173914,0.9787234042553191,0.2675585527468225,0.8664362824433195
30,64,1,95,0.3191489361702128,0.9894736842105263,0.2707549445499405,0.8685264134311665
5,20,5,30,0.2,0.8333333333333334,0.2680338561145663,0.8730702156848923
14,55,11,80,0.2028985507246377,0.8625,0.23195571413887808,0.8817720297438492
20,28,4,52,0.4166666666666667,0.9230769230769231,0.2600509522341162,0.8749439064108716
0,6,51,57,0.0,0.10526315789473684,0.22909857128173522,0.7560529289672626
14,154,11,179,0.08333333333333333,0.9385474860335196,0.22116206334522728,0.8044168555434795
3,75,122,200,0.038461538461538464,0.39,0.18007271790805573,0.7203135120784341
47,81,8,136,0.3671875,0.9411764705882353,0.18693536988373965,0.7134139101323925
10,46,7,63,0.17857142857142858,0.8888888888888888,0.18387414539394373,0.7213504180689004
52,154,6,212,0.2524271844660194,0.9716981132075472,0.1909496644998554,0.7369501485271215
3,11,53,67,0.21428571428571427,0.208955223880597,0.16203809987400505,0.6349327629276463
8,4,2,14,0.6666666666666666,0.8571428571428571,0.2572761951121003,0.7423441485345206
21,50,5,76,0.29577464788732394,0.9342105263157895,0.28762495433409896,0.7417245828605592
2,59,3,64,0.03278688524590164,0.953125,0.286814289589008,0.8221710114319877
50,69,3,122,0.42016806722689076,0.9754098360655737,0.2943829420499924,0.8270614922144646
16,77,412,505,0.17204301075268819,0.18415841584158416,0.2934503109330295,0.726385710350564
3,41,9,53,0.06818181818181818,0.8301886792452831,0.2671295443210007,0.7061700769273834
25,57,20,102,0.3048780487804878,0.803921568627451,0.28007130639168265,0.7911652690340768
2,0,0,2,1.0,1.0,0.32769035401073027,0.811573432299383
13,3,1,17,0.8125,0.9411764705882353,0.4015082614553983,0.8125685671954467
23,70,2,95,0.24731182795698925,0.9789473684210527,0.4321546818426965,0.8162574769698827
51,71,20,142,0.4180327868852459,0.8591549295774648,0.4318496417938901,0.7996496331858671
29,30,4,63,0.4915254237288136,0.9365079365079365,0.47748998650476515,0.9071281361382031
10,17,2,29,0.37037037037037035,0.9310344827586207,0.5206597796745583,0.9215346794972514
6,15,2,23,0.2857142857142857,0.9130434782608695,0.48210314695138656,0.937213924372928
42,48,27,117,0.4666666666666667,0.7692307692307693,0.4059126707609103,0.9042468914058951
24,86,2,112,0.21818181818181817,0.9821428571428571,0.33886721621545585,0.9100992323422697
1,0,0,1,1.0,1.0,0.45121118292835455,0.9128203207776439
33,79,9,121,0.29464285714285715,0.9256198347107438,0.44307980537733416,0.9231469638315596
152,226,37,415,0.4021164021164021,0.9108433734939759,0.4303070880041325,0.9194805976867081
26,66,15,107,0.2826086956521739,0.8598130841121495,0.4214186750677436,0.9086704852787663
3,28,8,39,0.0967741935483871,0.7948717948717948,0.3944272333297581,0.8917888162231842
0,13,1,14,0.0,0.9285714285714286,0.32776056666309145,0.9145517675575642
4,11,1,16,0.26666666666666666,0.9375,0.33468697358949834,0.9081742165371559
37,173,61,271,0.1761904761904762,0.7749077490774908,0.21699989875956632,0.8760181806910831
43,94,35,172,0.31386861313868614,0.7965116279069767,0.21974643533039906,0.8575741511476879
4,18,4,26,0.18181818181818182,0.8461538461538461,0.18827526100208186,0.848332790099098
8,15,103,126,0.34782608695652173,0.18253968253968253,0.19759203118841726,0.7515794470173169
6,44,3,53,0.12,0.9433962264150944,0.2009100035386477,0.7727972229520741
24,154,26,204,0.1348314606741573,0.8725490196078431,0.220171640777813,0.7647940216715619
41,124,3,168,0.24848484848484848,0.9821428571428571,0.21757423818041044,0.77117157269197
44,100,7,151,0.3055555555555556,0.9536423841059603,0.2360549638039932,0.7967050919817514
43,71,3,117,0.37719298245614036,0.9743589743589743,0.2451013022779152,0.8221118557606081
54,166,6,226,0.24545454545454545,0.9734513274336283,0.2541922113688243,0.8402972102291484
23,79,1,103,0.22549019607843138,0.9902912621359223,0.23671565552909715,0.9556902930286114
14,35,11,60,0.2857142857142857,0.8166666666666667,0.26038912491685223,0.9375860702074074
3,22,14,39,0.12,0.6410256410256411,0.25827034482054406,0.9045113018385214
48,111,4,163,0.3018867924528302,0.9754601226993865,0.26589919395882716,0.903556625489454
24,90,26,140,0.21052631578947367,0.8142857142857143,0.2523235882779583,0.8836485298008475
45,71,25,141,0.3879310344827586,0.8226950354609929,0.25385759571033234,0.8619822528154216
20,87,3,110,0.18691588785046728,0.9727272727272728,0.24549493033832118,0.8618788164287994
11,50,4,65,0.18032786885245902,0.9384615384615385,0.2390431693060394,0.8544745701896017
11,73,48,132,0.13095238095238096,0.6363636363636364,0.21693432576862445,0.8287169944320258
14,35,1,50,0.2857142857142857,0.98,0.2406077951563795,0.8771419028569343
27,71,1,99,0.2755102040816326,0.98989898989899,0.2368397111033513,0.8792045981711633
6,18,6,30,0.25,0.8,0.24247880884771225,0.8771637818446327
17,69,10,96,0.19767441860465115,0.8958333333333334,0.21529929229369688,0.88761211011211
24,31,2,57,0.43636363636363634,0.9649122807017544,0.2509346849384353,0.8864956826798931
0,8,51,59,0.0,0.13559322033898305,0.22517356081665543,0.7718002086623851
14,183,11,208,0.07106598984771574,0.9471153846153846,0.21661836208741755,0.8161933155554921
4,108,123,235,0.03571428571428571,0.4765957446808511,0.18090407637313186,0.7442784219384707
34,100,17,151,0.2537313432835821,0.8874172185430463,0.17779281054483892,0.7296381688876217
7,51,7,65,0.1206896551724138,0.8923076923076924,0.159319904140898,0.7428249820744348
47,176,7,230,0.21076233183856502,0.9695652173913043,0.16118960603145713,0.7533581083684308
4,11,52,67,0.26666666666666666,0.22388059701492538,0.13694718178903292,0.6474964392703123
8,5,2,15,0.6153846153846154,0.8666666666666667,0.22485926970112086,0.75193550303141
24,59,5,88,0.2891566265060241,0.9431818181818182,0.256015074938022,0.7513735649694719
5,57,3,65,0.08064516129032258,0.9538461538461539,0.2624337714488844,0.8195521948502295
53,87,3,143,0.37857142857142856,0.9790209790209791,0.28026806934714826,0.8326384463470771
16,106,470,592,0.13114754098360656,0.20608108108108109,0.28176205303446145,0.734606073314704
4,46,9,59,0.08,0.847457627118644,0.2630817199146665,0.7171621318471811
25,62,20,107,0.28735632183908044,0.8130841121495327,0.266037384939297,0.8013340625806963
2,0,0,2,1.0,1.0,0.32098243988435193,0.8203816816283155
11,5,1,17,0.6875,0.9411764705882353,0.37788863609777706,0.8200952034006608
21,82,2,105,0.20388349514563106,0.9809523809523809,0.3954941123628211,0.8239675215586931
47,81,22,150,0.3671875,0.8533333333333334,0.39386783685261706,0.8060121436033152
30,29,4,63,0.5084745762711864,0.9365079365079365,0.447771699036557,0.9103588372357232
10,19,2,31,0.3448275862068966,0.9354838709677419,0.48560421135182796,0.9229340149284513
6,16,2,24,0.2727272727272727,0.9166666666666666,0.5042543291937561,0.9396362846213753
42,48,27,117,0.4666666666666667,0.7692307692307693,0.4280638530032799,0.9066692516543424
22,88,2,112,0.2,0.9821428571428571,0.3494924244318514,0.9125215925907169
1,0,0,1,1.0,1.0,0.46322335369676126,0.915242681026091
34,78,9,121,0.30357142857142855,0.9256198347107438,0.4472500412948774,0.9236645621752448
144,234,37,415,0.38095238095238093,0.9108433734939759,0.42903258482076234,0.9199981960303933
25,67,15,107,0.2717391304347826,0.8598130841121495,0.41366526847893326,0.9091880836224516
3,28,8,39,0.0967741935483871,0.7948717948717948,0.388529114310521,0.8917888162231843
0,13,1,14,0.0,0.9285714285714286,0.32186244764385435,0.9145517675575642
4,11,1,16,0.26666666666666666,0.9375,0.33138625716766384,0.9081742165371559
38,172,61,271,0.18095238095238095,0.7749077490774908,0.21437945444657544,0.8760181806910833
43,94,35,172,0.31386861313868614,0.7965116279069767,0.21585048081332653,0.857574151147688
4,18,4,26,0.18181818181818182,0.8461538461538461,0.1874027380798695,0.848332790099098
7,19,100,126,0.2692307692307692,0.20634920634920634,0.18704440076501047,0.7549808075615346
5,45,3,53,0.1,0.9433962264150944,0.187505230258098,0.7761985834962918
24,154,26,204,0.1348314606741573,0.8725490196078431,0.20676686749726333,0.7681953822157795
40,125,3,168,0.24242424242424243,0.9821428571428571,0.2033036640340599,0.7745729332361877
46,98,7,151,0.3194444444444444,0.9536423841059603,0.22308824453292608,0.800106452525969
43,71,3,117,0.37719298245614036,0.9743589743589743,0.23213458300684814,0.8255132163048258
54,166,6,226,0.24545454545454545,0.9734513274336283,0.2412254920977572,0.8436985707733662
22,80,1,103,0.21568627450980393,0.9902912621359223,0.23357627856619076,0.9556902930286112
15,34,11,60,0.30612244897959184,0.8166666666666667,0.2630223427061324,0.9375860702074073
3,22,14,39,0.12,0.6410256410256411,0.2609035626098243,0.9045113018385214
48,111,4,163,0.3018867924528302,0.9754601226993865,0.26939821261390823,0.903556625489454
24,90,26,140,0.21052631578947367,0.8142857142857143,0.2538384799489124,0.8836485298008475
45,71,25,141,0.3879310344827586,0.8226950354609929,0.25537248738128643,0.8619822528154215
20,87,3,110,0.18691588785046728,0.9727272727272728,0.24700982200927526,0.8618788164287994
11,50,4,65,0.18032786885245902,0.9384615384615385,0.2419586212010831,0.8544745701896017
11,73,48,132,0.13095238095238096,0.6363636363636364,0.21693432576862445,0.828716994432026
14,35,1,50,0.2857142857142857,0.98,0.2406077951563795,0.8771419028569343
28,70,1,99,0.2857142857142857,0.98989898989899,0.23829743705087317,0.8792045981711635
6,19,5,30,0.24,0.8333333333333334,0.24250796336666264,0.8819256866065376
17,69,10,96,0.19767441860465115,0.8958333333333334,0.21532844681264732,0.8923740148740149
25,31,1,57,0.44642857142857145,0.9824561403508771,0.252401687323805,0.8937638531059583
0,8,53,61,0.0,0.13114754098360656,0.2266405632020252,0.7784332820376824
14,183,11,208,0.07106598984771574,0.9471153846153846,0.21808536447278729,0.8228263889307891
4,113,118,235,0.03418803418803419,0.4978723404255319,0.18215304282617995,0.7539510089915795
33,100,18,151,0.24812030075187969,0.8807947019867549,0.17678247354583623,0.7383646821469744
8,50,7,65,0.13793103448275862,0.8923076923076924,0.1622011927576589,0.7467895905718829
47,176,7,230,0.21076233183856502,0.9695652173913043,0.16407089464821797,0.7573227168658787
2,8,57,67,0.2,0.14925373134328357,0.12886681301556493,0.6382938012933653
8,5,2,15,0.6153846153846154,0.8666666666666667,0.21677890092765287,0.743367962105231
24,59,5,88,0.2891566265060241,0.9431818181818182,0.24793470616455404,0.7428060240432931
5,57,3,65,0.08064516129032258,0.9538461538461539,0.2545714386077381,0.807945140246239
53,87,3,143,0.37857142857142856,0.9790209790209791,0.2732073140105308,0.8219774655368425
16,105,471,592,0.1322314049586777,0.20439189189189189,0.2723930812213764,0.7237037797631566
4,46,9,59,0.08,0.847457627118644,0.2537127481015814,0.7062598382956338
25,62,20,107,0.28735632183908044,0.8130841121495327,0.2661922226500214,0.8010927498393835
2,0,0,2,1.0,1.0,0.3211372775950764,0.8201403688870028
11,5,1,17,0.6875,0.9411764705882353,0.37804347380850156,0.819853890659348
22,81,2,105,0.21359223300970873,0.9809523809523809,0.3970359126255567,0.8237262088173803
45,83,22,150,0.3515625,0.8533333333333334,0.39317749425820975,0.8057708308620024
29,30,4,63,0.4915254237288136,0.9365079365079365,0.44450521122537207,0.9103588372357232
10,19,2,31,0.3448275862068966,0.9354838709677419,0.4823377235406429,0.9229340149284514
6,16,2,24,0.2727272727272727,0.9166666666666666,0.5007341205888018,0.9396362846213753
43,48,26,117,0.4725274725274725,0.7777777777777778,0.4253809023784407,0.9078902528753435
22,88,2,112,0.2,0.9821428571428571,0.34680947380701216,0.9137425938117182
1,0,0,1,1.0,1.0,0.460540403071922,0.9164636822470923
32,80,9,121,0.2857142857142857,0.9256198347107438,0.443114971360776,0.9248855633962461
153,224,38,415,0.40583554376657827,0.908433734939759,0.43087355993759946,0.9208749631722207
29,63,15,107,0.31521739130434784,0.8598130841121495,0.42171742371999404,0.910064850764279
3,28,8,39,0.0967741935483871,0.7948717948717948,0.3965812695515818,0.8926655833650116
0,13,1,14,0.0,0.9285714285714286,0.32907734490480006,0.9142075334783903
6,9,1,16,0.4,0.9375,0.3576487734762286,0.9078299824579821
39,171,61,271,0.18571428571428572,0.7749077490774908,0.2413222428639837,0.8756739466119093
42,95,35,172,0.30656934306569344,0.7965116279069767,0.24430153677132768,0.857229917068514
3,19,4,26,0.13636363636363635,0.8461538461538461,0.20580554999947884,0.848332790099098
9,19,98,126,0.32142857142857145,0.2222222222222222,0.2066928614457965,0.7572483812576797
6,44,3,53,0.12,0.9433962264150944,0.21001083379602692,0.7784661571924368
26,152,26,204,0.14606741573033707,0.8725490196078431,0.23087760747178934,0.7704629559119247
41,124,3,168,0.24848484848484848,0.9821428571428571,0.20923258582676768,0.7768405069323328
45,99,7,151,0.3125,0.9536423841059603,0.22734483072472692,0.8023740262221143
44,70,3,117,0.38596491228070173,0.9743589743589743,0.2386870548982995,0.8277807900009709
54,166,6,226,0.24545454545454545,0.9734513274336283,0.25427147048271503,0.8459661444695111
33,69,1,103,0.3235294117647059,0.9902912621359223,0.2545715905307343,0.9556902930286112
15,34,11,60,0.30612244897959184,0.8166666666666667,0.2811605118135331,0.9375860702074074
4,21,14,39,0.16,0.6410256410256411,0.28315088099491353,0.9045113018385214
52,107,4,163,0.3270440251572327,0.9754601226993865,0.29437362051953986,0.903556625489454
24,90,26,140,0.21052631578947367,0.8142857142857143,0.27980595134660746,0.8836485298008475
43,73,25,141,0.3706896551724138,0.8226950354609929,0.27762377175970926,0.8619822528154216
21,86,3,110,0.19626168224299065,0.9727272727272728,0.2705962198723443,0.8618788164287994
12,49,4,65,0.19672131147540983,0.9384615384615385,0.2524807769738734,0.8544745701896017
11,74,47,132,0.12941176470588237,0.6439393939393939,0.22723639350620065,0.829799245514277
16,33,1,50,0.32653061224489793,0.98,0.2510264809697575,0.8782241539391854
32,66,1,99,0.32653061224489793,0.98989898989899,0.25095313626799537,0.8802868492534144
6,19,5,30,0.24,0.8333333333333334,0.25516366258378487,0.8830079376887886
17,69,10,96,0.19767441860465115,0.8958333333333334,0.23044720021696158,0.8934562659562658
26,30,1,57,0.4642857142857143,0.9824561403508771,0.2687363476516364,0.8948461041882093
0,8,53,61,0.0,0.13114754098360656,0.2406333031551493,0.7795155331199333
15,182,11,208,0.07614213197969544,0.9471153846153846,0.2330233556228369,0.8228263889307892
5,108,122,235,0.04424778761061947,0.4808510638297872,0.19269723781793993,0.7515193980493302
47,96,8,151,0.32867132867132864,0.9470198675496688,0.1930030544502872,0.7453938091422844
11,48,6,65,0.1864406779661017,0.9076923076923077,0.18535172273115888,0.7560165197649951
53,171,6,230,0.23660714285714285,0.9739130434782609,0.19091354048151482,0.7671707640714132
2,12,53,67,0.14285714285714285,0.208955223880597,0.14499517313457602,0.6566706331470875
8,5,2,15,0.6153846153846154,0.8666666666666667,0.23290726104666395,0.7617447939589531
24,59,5,88,0.2891566265060241,0.9431818181818182,0.26333790312185373,0.7611828558970151
6,56,3,65,0.0967741935483871,0.9538461538461539,0.2708416753986777,0.8287535830422103
53,87,3,143,0.37857142857142856,0.9790209790209791,0.27797026109869194,0.8333251703952547
16,107,469,592,0.13008130081300814,0.20777027027027026,0.2699189215053929,0.7333363079063921
4,46,9,59,0.08,0.847457627118644,0.24754647252580106,0.715271248426447
25,62,20,107,0.28735632183908044,0.8130841121495327,0.2681892123803636,0.8015753753220091
2,0,0,2,1.0,1.0,0.32313426732541856,0.8206229943696283
12,4,1,17,0.75,0.9411764705882353,0.3889690349674151,0.8203365161419736
21,82,2,105,0.20388349514563106,0.9809523809523809,0.40427036376702136,0.8242088343000059
54,76,20,150,0.4153846153846154,0.8666666666666667,0.4095293904546195,0.8081582182493898
30,29,4,63,0.5084745762711864,0.9365079365079365,0.46358557266293066,0.912263599140485
11,18,2,31,0.3793103448275862,0.9354838709677419,0.5063441933525857,0.9248387768332132
6,16,2,24,0.2727272727272727,0.9166666666666666,0.5024994948807823,0.9386839036689943
44,48,25,117,0.4782608695652174,0.7863247863247863,0.42796533339009907,0.9081588731439638
29,81,2,112,0.2636363636363636,0.9821428571428571,0.3584848139095796,0.9140112140803384
1,0,0,1,1.0,1.0,0.47221574317448944,0.9167323025157125
33,79,9,121,0.29464285714285715,0.9256198347107438,0.45672175488149785,0.9261065646172473
159,219,37,415,0.42063492063492064,0.9108433734939759,0.4441732326477456,0.9224401984723959
27,65,15,107,0.29347826086956524,0.8598130841121495,0.43191150636802833,0.9116300860644541
2,29,8,39,0.06451612903225806,0.7948717948717948,0.40216705726874047,0.8942308186651866
0,13,1,14,0.0,0.9285714285714286,0.3338440759022809,0.9145517675575642
4,11,1,16,0.26666666666666666,0.9375,0.3342769763351813,0.9081742165371559
42,168,61,271,0.2,0.7749077490774908,0.21999126204946703,0.8760181806910831
46,92,34,172,0.3333333333333333,0.8023255813953488,0.22551847293382074,0.8584047159317411
3,19,4,26,0.13636363636363635,0.8461538461538461,0.1849082894664944,0.8491633548831511
9,21,96,126,0.3,0.23809523809523808,0.18583996648512796,0.760346519737878
6,44,3,53,0.12,0.9433962264150944,0.19376623376623398,0.7815642956726352
27,151,26,204,0.15168539325842698,0.8725490196078431,0.21543557566029495,0.7735610943921228
39,126,3,168,0.23636363636363636,0.9821428571428571,0.2111065713312906,0.7799386454125311
50,94,7,151,0.3472222222222222,0.9536423841059603,0.23213831736303664,0.8054721647023124
46,68,3,117,0.40350877192982454,0.9743589743589743,0.24216338001967824,0.830048363697116
55,165,6,226,0.25,0.9734513274336283,0.2583971462534445,0.8482337181656564
33,69,1,103,0.3235294117647059,0.9902912621359223,0.2617584907912596,0.9556902930286112
15,34,11,60,0.30612244897959184,0.8166666666666667,0.28834741207405845,0.9375860702074074
4,24,11,39,0.14285714285714285,0.717948717948718,0.2870862334453036,0.9155003128275324
53,106,4,163,0.3333333333333333,0.9754601226993865,0.30093904729811743,0.914545636478465
24,90,26,140,0.21052631578947367,0.8142857142857143,0.28141106066486765,0.8946375407898586
44,72,25,141,0.3793103448275862,0.8226950354609929,0.277954142507405,0.8729712638044326
22,85,3,110,0.205607476635514,0.9727272727272728,0.2716123534553356,0.8728678274178103
12,49,4,65,0.19672131147540983,0.9384615384615385,0.2534969105568647,0.8654635811786127
11,62,59,132,0.1506849315068493,0.553030303030303,0.2312915509179015,0.8278012435162749
16,33,1,50,0.32653061224489793,0.98,0.25753061797329513,0.8652371409521723
32,66,1,99,0.32653061224489793,0.98989898989899,0.2565588006749472,0.8672998362664014
6,19,5,30,0.24,0.8333333333333334,0.2607693269907367,0.8700209247017756
16,69,11,96,0.18823529411764706,0.8854166666666666,0.23347289117503106,0.8789811577311576
27,29,1,57,0.48214285714285715,0.9824561403508771,0.2729779455332229,0.8803709959631011
0,4,57,61,0.0,0.06557377049180328,0.24487490103673584,0.755672743395996
15,182,11,208,0.07614213197969544,0.9471153846153846,0.23422592967571385,0.8119706121938649
4,107,124,235,0.036036036036036036,0.4723404255319149,0.1927267045030193,0.7394478158412812
51,92,8,151,0.35664335664335667,0.9470198675496688,0.19702852513137054,0.7333222269342353
10,49,6,65,0.1694915254237288,0.9076923076923077,0.18695588590618892,0.743944937556946
47,176,7,230,0.21076233183856502,0.9695652173913043,0.19017403415203435,0.7559661590890371
2,10,54,66,0.16666666666666666,0.18181818181818182,0.14510600694115,0.6415893078700806
8,5,2,15,0.6153846153846154,0.8666666666666667,0.2330180948532379,0.7560311501807755
24,59,5,88,0.2891566265060241,0.9431818181818182,0.2634487369284277,0.7554692121188374
6,56,3,65,0.0967741935483871,0.9538461538461539,0.2721256165730493,0.8242557447351572
53,87,3,143,0.37857142857142856,0.9790209790209791,0.27525819827705955,0.8288273320882016
17,108,468,593,0.136,0.21079258010118043,0.2704736946450983,0.729270228146612
4,46,9,59,0.08,0.847457627118644,0.2517933615253033,0.711826286679089
25,62,20,107,0.28735632183908044,0.8130841121495327,0.2690347408356481,0.8020071338692821
2,0,0,2,1.0,1.0,0.3239797957807031,0.8210547529169011
12,4,1,17,0.75,0.9411764705882353,0.3898145634226996,0.8207682746892464
21,82,2,105,0.20388349514563106,0.9809523809523809,0.4051158922223059,0.8246405928472786
53,77,20,150,0.4076923076923077,0.8666666666666667,0.4092760178110029,0.8085899767966628
29,30,4,63,0.4915254237288136,0.9365079365079365,0.4600653640579763,0.912263599140485
11,18,2,31,0.3793103448275862,0.9354838709677419,0.5028239847476315,0.9248387768332132
6,16,2,24,0.2727272727272727,0.9166666666666666,0.5202113101648369,0.9356290496396745
47,50,20,117,0.4845360824742268,0.8290598290598291,0.446573607661155,0.9112090252196501
30,80,2,112,0.2727272727272727,0.9821428571428571,0.37839178947933677,0.9170613661560247
1,0,0,1,1.0,1.0,0.484382572889475,0.9200688849530172
33,84,3,120,0.28205128205128205,0.975,0.46158037508727723,0.9386302531622727
163,219,33,415,0.42670157068062825,0.9204819277108434,0.4547411321578755,0.9363408233341166
27,71,9,107,0.2755102040816326,0.9158878504672897,0.43060766924890237,0.9341770187210693
2,30,7,39,0.0625,0.8205128205128205,0.40057520171643485,0.9204407549848055
0,13,1,14,0.0,0.9285714285714286,0.33135576136297384,0.934656697772177
6,9,1,16,0.4,0.9375,0.34953757954479203,0.9282791467517687
42,168,61,271,0.2,0.7749077490774908,0.23525186525907776,0.8961231109056959
44,93,35,172,0.32116788321167883,0.7965116279069767,0.24083995113913442,0.8706247720352641
3,23,0,26,0.11538461538461539,1.0,0.1963661003825612,0.8819844966480007
11,39,76,126,0.22,0.3968253968253968,0.18843607122804223,0.8078327175563018
6,44,3,53,0.12,0.9433962264150944,0.19665035694232794,0.8253874898280553
29,151,24,204,0.16111111111111112,0.8823529411764706,0.21966622995820098,0.8187848487716326
40,125,3,168,0.24242424242424243,0.9821428571428571,0.19715540744737844,0.8251623997920409
46,98,7,151,0.3194444444444444,0.9536423841059603,0.2142188995108705,0.8506959190818222
45,69,3,117,0.39473684210526316,0.9743589743589743,0.22472875078138252,0.8761026828606789
55,165,5,225,0.25,0.9777777777777777,0.24395952001215176,0.8729280796860758
33,69,1,103,0.3235294117647059,0.9902912621359223,0.25874943597853833,0.9577089175875794
12,47,1,60,0.2033898305084746,0.9833333333333333,0.2706622689083204,0.9634142185758992
4,22,13,39,0.15384615384615385,0.6666666666666666,0.26962441787046937,0.9326018936459273
44,115,4,163,0.27672955974842767,0.9754601226993865,0.27452517748821015,0.9316472172968601
24,91,25,140,0.20869565217391303,0.8214285714285714,0.2587039214495628,0.9127595297715188
56,70,15,141,0.4444444444444444,0.8936170212765957,0.2658050074980173,0.9012249650454647
23,84,3,110,0.21495327102803738,0.9727272727272728,0.26079833193059404,0.9005034643239639
15,49,1,65,0.234375,0.9846153846153847,0.2480619873927789,0.8996926246781729
12,108,12,132,0.1,0.9090909090909091,0.23329201160585397,0.8890865640721123
15,34,1,50,0.30612244897959184,0.98,0.25504576805348794,0.9338484688340171
31,67,1,99,0.3163265306122449,0.98989898989899,0.2607024781768904,0.935911164148246
5,7,18,30,0.4166666666666667,0.4,0.29041262310442667,0.875707082515593
17,75,4,96,0.18478260869565216,0.9583333333333334,0.25331807514031346,0.8849522699522698
28,28,1,57,0.5,0.9824561403508771,0.29403903642202245,0.8863421081842134
0,4,57,61,0.0,0.06557377049180328,0.26055689356487954,0.7550504490237018
15,183,10,208,0.07575757575757576,0.9519230769230769,0.2570936901016761,0.7611693301425829
42,167,26,235,0.20095693779904306,0.8893617021276595,0.24207004564731197,0.7482210018751055
59,89,3,151,0.39864864864864863,0.9801324503311258,0.25383034822394107,0.7468257819368392
11,52,2,65,0.1746031746031746,0.9692307692307692,0.21924984935772793,0.8281444632555205
46,178,6,230,0.20535714285714285,0.9739130434782609,0.22218906852365516,0.8303701361333674
9,50,8,67,0.15254237288135594,0.8805970149253731,0.17255226464956316,0.8158188325011525
7,6,2,15,0.5384615384615384,0.8666666666666667,0.2494753415726401,0.9302606748118473
25,58,5,88,0.30120481927710846,0.9431818181818182,0.28168209064685906,0.9290119235630961
6,56,3,65,0.0967741935483871,0.9538461538461539,0.2667988414681939,0.9382239880943095
54,86,3,143,0.38571428571428573,0.9790209790209791,0.2649510753347135,0.9380652064785743
17,107,469,593,0.13709677419354838,0.209106239460371,0.2595930181333383,0.829475987939946
2,48,9,59,0.04,0.847457627118644,0.2359705691537465,0.8114109284600007
26,61,20,107,0.2988505747126437,0.8130841121495327,0.25687174084393044,0.8017662280634521
2,0,0,2,1.0,1.0,0.32280580677799636,0.8208138471110712
12,4,1,17,0.75,0.9411764705882353,0.3869194040241237,0.8205273688834164
21,82,2,105,0.20388349514563106,0.9809523809523809,0.40222073282373,0.824399687041449
52,77,21,150,0.40310077519379844,0.86,0.40470451703508903,0.8073966900384519
30,29,4,63,0.5084745762711864,0.9365079365079365,0.4577584887604659,0.9113112181881041
11,18,2,31,0.3793103448275862,0.9354838709677419,0.5062313951644067,0.9238863958808323
6,15,2,23,0.2857142857142857,0.9130434782608695,0.5145895731477698,0.9349544811060554
41,46,26,113,0.47126436781609193,0.7699115044247787,0.4390559114072114,0.9020846960238809
23,71,2,96,0.24468085106382978,0.9791666666666666,0.3668674615591871,0.9075118668922283
1,0,0,1,1.0,1.0,0.47439434327961727,0.9105193856892208
32,65,9,106,0.32989690721649484,0.9150943396226415,0.46149846327813204,0.9206797726059304
157,183,36,376,0.46176470588235297,0.9042553191489362,0.45724693215720913,0.9160722558403588
25,55,15,95,0.3125,0.8421052631578947,0.443688731099008,0.9033680816116838
1,24,8,33,0.04,0.7575757575757576,0.4085866902826815,0.8811584072280964
0,13,1,14,0.0,0.9285714285714286,0.341263209166097,0.9038241106776178
3,7,1,11,0.3,0.9090909090909091,0.34916594472840695,0.8938132881667953
41,140,61,242,0.2265193370165746,0.7479338842975206,0.23866870715934624,0.8578038430664411
43,79,35,157,0.3524590163934426,0.7770700636942676,0.2418918656131959,0.8380860893623876
3,18,4,25,0.14285714285714285,0.84,0.1963336423238802,0.8289067580553968
10,19,93,122,0.3448275862068966,0.23770491803278687,0.20095186892486544,0.7425638516089528
6,40,3,49,0.13043478260869565,0.9387755102040817,0.2138711235832505,0.7684495305558562
28,135,25,188,0.17177914110429449,0.8670212765957447,0.23841100088386402,0.759656651702187
39,92,3,134,0.29770992366412213,0.9776119402985075,0.23808384712159575,0.7694453704461298
50,87,7,144,0.36496350364963503,0.9513888888888888,0.25786158521203295,0.7985103711020394
40,63,3,106,0.3883495145631068,0.9716981132075472,0.2629887992362707,0.826314378175365
55,165,5,225,0.25,0.9777777777777777,0.2782949216852503,0.8459969178579048
27,55,1,83,0.32926829268292684,0.9879518072289156,0.2760721654675403,0.9531750448859232
15,33,5,53,0.3125,0.9056603773584906,0.30208148223772663,0.9484443116222673
3,21,12,36,0.125,0.6666666666666666,0.295398747794256,0.9198222244895419
52,102,4,158,0.33766233766233766,0.9746835443037974,0.3011062355082868,0.9194038822045832
23,83,26,132,0.2169811320754717,0.803030303030303,0.27996589671197775,0.8982097985104998
43,55,26,124,0.4387755102040816,0.7903225806451613,0.2871696103749741,0.8722990081444445
23,78,2,103,0.22772277227722773,0.9805825242718447,0.283987149271721,0.8726996862150255
15,45,4,64,0.25,0.9375,0.2726631074598743,0.8654922851823234
11,49,60,120,0.18333333333333332,0.5,0.2542107265074934,0.8075408027025388
14,32,1,47,0.30434782608695654,0.9787234042553191,0.27983184451991566,0.852120336643775
30,64,1,95,0.3191489361702128,0.9894736842105263,0.27718707287818356,0.8542332137733076
5,5,19,29,0.5,0.3448275862068966,0.3176183397245448,0.7887756827985353
15,55,10,80,0.21428571428571427,0.875,0.2855483688790637,0.8008724569920836
27,25,1,53,0.5192307692307693,0.9811320754716981,0.3271923684438554,0.8009509643063485
0,2,57,59,0.0,0.03389830508474576,0.29147808272956965,0.6718650078898836
12,156,11,179,0.07142857142857142,0.9385474860335196,0.2754916881717465,0.7345146487518149
2,73,124,199,0.02666666666666667,0.3768844221105528,0.23582295111170512,0.6485376513025626
53,73,10,136,0.42063492063492064,0.9264705882352942,0.2503209488923776,0.6395372090203866
9,50,4,63,0.15254237288135594,0.9365079365079365,0.20068414501828563,0.7240629733491065
43,162,6,211,0.2097560975609756,0.9715639810426541,0.20003705691475154,0.7378578277837714
3,7,57,67,0.3,0.14925373134328357,0.16871837559607022,0.6190180643368551
7,5,2,14,0.5833333333333334,0.8571428571428571,0.25205170892940354,0.7366244289165852
23,49,5,77,0.3194444444444444,0.935064935064935,0.2874825479316711,0.7361269216353589
6,55,3,64,0.09836065573770492,0.953125,0.29772454637039086,0.8184470041909943
51,68,3,122,0.42857142857142855,0.9754098360655737,0.29885833321846345,0.8254383253096057
16,78,411,505,0.1702127659574468,0.18613861386138614,0.3013826750864764,0.7182427077886697
2,42,9,53,0.045454545454545456,0.8301886792452831,0.2779110247855578,0.6980462361033312
24,57,20,101,0.2962962962962963,0.801980198019802,0.2773819242564573,0.7912928741999766
2,0,0,2,1.0,1.0,0.33690573378026684,0.8117010374652828
12,4,1,17,0.75,0.9411764705882353,0.3984136702882033,0.8125741139686112
24,69,2,95,0.25806451612903225,0.9789473684210527,0.42122850748696433,0.8162630237430475
53,67,22,142,0.44166666666666665,0.8450704225352113,0.4230992557862841,0.7976431075244242
28,31,4,63,0.4745762711864407,0.9365079365079365,0.46657975653328326,0.9048387250453601
12,15,2,29,0.4444444444444444,0.9310344827586207,0.5235783135318403,0.9192452684044082
6,14,2,22,0.3,0.9090909090909091,0.49253004788999194,0.9366231073224837
40,48,25,113,0.45454545454545453,0.7787610619469026,0.41460796996791405,0.9050175447434697
25,70,2,97,0.2631578947368421,0.979381443298969,0.3450590977874629,0.9104753979878604
1,0,0,1,1.0,1.0,0.45990503616281303,0.9132226507351131
33,63,9,105,0.34375,0.9142857142857143,0.45432467901995593,0.9219301337283105
159,181,37,377,0.4676470588235294,0.9018567639257294,0.44849217652743345,0.9169799662165665
25,56,15,96,0.30864197530864196,0.84375,0.44824891191635274,0.903875127506889
1,24,8,33,0.04,0.7575757575757576,0.41110605477349565,0.8822301058618675
0,13,1,14,0.0,0.9285714285714286,0.3461709898384307,0.9036315868082283
4,6,1,11,0.4,0.9090909090909091,0.36571986201888185,0.8935900819213626
40,141,61,242,0.22099447513812154,0.7479338842975206,0.2544333584671849,0.8575806368210083
42,81,34,157,0.34146341463414637,0.7834394904458599,0.2541067034149201,0.8388883191296006
3,18,4,25,0.14285714285714285,0.84,0.2077081439911506,0.8300516385687821
9,22,91,122,0.2903225806451613,0.2540983606557377,0.20509108761065334,0.7458156900910303
5,41,3,49,0.10869565217391304,0.9387755102040817,0.21490475220692665,0.7717013690379338
28,135,25,188,0.17177914110429449,0.8670212765957447,0.23944462950754014,0.7629084901842648
40,91,3,134,0.3053435114503817,0.9776119402985075,0.2259222740004518,0.7726972089282073
49,88,7,144,0.35766423357664234,0.9513888888888888,0.24544652520595478,0.801762209584117
40,63,3,106,0.3883495145631068,0.9716981132075472,0.25214453948152055,0.8286562985500724
55,165,5,225,0.25,0.9777777777777777,0.2674506619305001,0.8483388382326121
27,55,1,83,0.32926829268292684,0.9879518072289156,0.27301433507875233,0.9531750448859232
15,33,5,53,0.3125,0.9056603773584906,0.3021292419110505,0.9484443116222673
3,20,13,36,0.13043478260869565,0.6388888888888888,0.2962229049831078,0.9158539705212879
52,102,4,158,0.33766233766233766,0.9746835443037974,0.30083988015624435,0.9154356282363294
23,82,26,131,0.21904761904761905,0.8015267175572519,0.28103750665209815,0.8940267466175241
43,55,26,124,0.4387755102040816,0.7903225806451613,0.28824122031509464,0.8681159562514689
23,78,2,103,0.22772277227722773,0.9805825242718447,0.28505875921184143,0.8685166343220498
13,47,4,64,0.21666666666666667,0.9375,0.26897281263809,0.8613092332893476
12,48,60,120,0.2,0.5,0.2529013840666614,0.8033577508095633
15,31,1,47,0.32608695652173914,0.9787234042553191,0.28085169462566756,0.8519055387190535
29,65,1,95,0.30851063829787234,0.9894736842105263,0.2766871661450297,0.854018415848586
5,6,18,29,0.45454545454545453,0.3793103448275862,0.3103297140732919,0.7937017911729195
16,53,11,80,0.2318840579710145,0.8625,0.28077379232571087,0.8040128510807536
26,26,1,53,0.5,0.9811320754716981,0.3196705391432498,0.8040913583950184
0,2,57,59,0.0,0.03389830508474576,0.28871815819086877,0.6750054019785535
12,156,11,179,0.07142857142857142,0.9385474860335196,0.2703508112520933,0.7376550428404849
2,73,124,199,0.02666666666666667,0.3768844221105528,0.2275764841299401,0.6516780453912325
52,75,10,137,0.4094488188976378,0.927007299270073,0.24199622421562086,0.6427542761140249
12,47,4,63,0.2033898305084746,0.9365079365079365,0.20611684935319516,0.7223539320683606
45,161,6,212,0.21844660194174756,0.9716981132075472,0.2041972127775856,0.7379536625265818
3,9,55,67,0.25,0.1791044776119403,0.16848292706329993,0.6233782914037593
7,5,2,14,0.5833333333333334,0.8571428571428571,0.25181626039663324,0.7409846559834893
22,49,5,76,0.30985915492957744,0.9342105263157895,0.2858777723253484,0.7403650903095279
6,55,3,64,0.09836065573770492,0.953125,0.29611977076406815,0.8226851728651632
53,67,3,123,0.44166666666666665,0.975609756097561,0.300722320445358,0.8296283809833759
16,77,412,505,0.17204301075268819,0.18415841584158416,0.2962442033373885,0.7221498780310398
3,40,10,53,0.06976744186046512,0.8113207547169812,0.27500432332577673,0.6992388268181017
24,57,20,101,0.2962962962962963,0.801980198019802,0.2816180799395333,0.7882210725906533
2,0,0,2,1.0,1.0,0.34114188946334284,0.8086292358559596
12,4,1,17,0.75,0.9411764705882353,0.40401915304483177,0.8096243707520232
23,70,2,95,0.24731182795698925,0.9789473684210527,0.4252978919333009,0.8133132805264592
50,69,22,141,0.42016806722689076,0.8439716312056738,0.4222266634419044,0.7945078341133326
29,30,4,63,0.4915254237288136,0.9365079365079365,0.4678670081527795,0.9019863370656687
11,16,2,29,0.4074074074074074,0.9310344827586207,0.5161012889451998,0.9190882982144742
5,17,2,24,0.22727272727272727,0.9166666666666666,0.49592167691023076,0.9377053584047348
42,48,27,117,0.4666666666666667,0.7692307692307693,0.4197312007197546,0.9047383254377018
26,84,2,112,0.23636363636363636,0.9821428571428571,0.34635457734313124,0.9105906663740765
1,0,0,1,1.0,1.0,0.4569988350462126,0.9133379191213292
34,84,3,121,0.288135593220339,0.9752066115702479,0.44124141979197523,0.9307483874408884
161,218,36,415,0.42480211081794195,0.9132530120481928,0.4268669029354585,0.9274262553752106
29,63,15,107,0.31521739130434784,0.8598130841121495,0.4226368750922372,0.9166161429672688
2,30,8,40,0.0625,0.8,0.39909791405327616,0.8999494763006022
0,13,1,14,0.0,0.9285714285714286,0.3324312473866095,0.9227124276349822
5,10,1,16,0.3333333333333333,0.9375,0.3462840612394234,0.9163348766145739
41,170,60,271,0.1943127962085308,0.7785977859778598,0.2311858892692135,0.8847059888971254
41,95,35,171,0.3014705882352941,0.7953216374269005,0.23309088855706417,0.8590081354480757
3,19,4,26,0.13636363636363635,0.8461538461538461,0.19188539220644912,0.849422540320312
6,19,101,126,0.24,0.1984126984126984,0.18114005059154228,0.7549367709346761
7,43,3,53,0.14,0.9433962264150944,0.19221147916297082,0.7754219461368325
28,151,26,205,0.1564245810055866,0.8731707317073171,0.21455784787805462,0.7675075608705307
45,120,3,168,0.2727272727272727,0.9821428571428571,0.20589983922004598,0.773885111890939
47,97,7,151,0.3263888888888889,0.9536423841059603,0.22476785246009712,0.7988914830520961
50,63,4,117,0.4424778761061947,0.9658119658119658,0.24491175072736865,0.8232472442499627
55,165,5,225,0.25,0.9777777777777777,0.26114551696113486,0.8420506630533814
25,76,1,102,0.24752475247524752,0.9901960784313726,0.26222048160045597,0.9551625744846205
16,39,5,60,0.2909090909090909,0.9166666666666666,0.2837789231588975,0.951344065949131
2,23,14,39,0.08,0.6410256410256411,0.27286112587238515,0.9181804815660344
54,104,4,162,0.34177215189873417,0.9753086419753086,0.2827246800397368,0.9172041651135273
24,90,26,140,0.21052631578947367,0.8142857142857143,0.26617288388267746,0.8972960694249209
45,71,25,141,0.3879310344827586,0.8226950354609929,0.25838047793647234,0.8768507936604962
21,87,2,110,0.19444444444444445,0.9818181818181818,0.2504439699999644,0.8774279942376967
13,49,4,66,0.20967741935483872,0.9393939393939394,0.24503720812562027,0.8701705458037777
13,58,60,131,0.18309859154929578,0.5419847328244275,0.2296357082170781,0.8166445552548863
12,37,1,50,0.24489795918367346,0.98,0.25319255952903147,0.8650694636797949
26,72,1,99,0.2653061224489796,0.98989898989899,0.2422688410362094,0.8671537990974636
7,5,18,30,0.5833333333333334,0.4,0.2955269863996179,0.8079701256280758
15,70,11,96,0.17647058823529413,0.8854166666666666,0.2653183512214087,0.8169303586574578
25,29,2,56,0.46296296296296297,0.9642857142857143,0.30367813958119705,0.8144257204385339
0,4,57,61,0.0,0.06557377049180328,0.27372422253050577,0.6895942677382286
15,182,11,208,0.07614213197969544,0.9471153846153846,0.2584447283062772,0.7474700751369368
3,106,125,234,0.027522935779816515,0.4658119658119658,0.22739115353429762,0.6740146416815034
42,89,19,150,0.32061068702290074,0.8733333333333333,0.23529180561628632,0.6573624050292667
9,52,4,65,0.14754098360655737,0.9384615384615385,0.17303575565531837,0.7342854819523436
46,177,7,230,0.2062780269058296,0.9695652173913043,0.17729396117968058,0.7463067034844347
3,4,60,67,0.42857142857142855,0.1044776119402985,0.1723808848380328,0.6234769745779467
8,4,3,15,0.6666666666666666,0.8,0.267618980076128,0.728395007364832
23,60,5,88,0.27710843373493976,0.9431818181818182,0.2963284517554486,0.7278330693028939
7,55,3,65,0.11290322580645161,0.9538461538461539,0.3085256360449679,0.7975522390220637
53,87,3,143,0.37857142857142856,0.9790209790209791,0.3168057419804719,0.8126504741202989
19,99,476,594,0.16101694915254236,0.19865319865319866,0.31873087991561266,0.7069635684333931
3,46,10,59,0.061224489795918366,0.8305084745762712,0.2980089460427681,0.6870983194598169
26,61,20,107,0.2988505747126437,0.8130841121495327,0.2794773954915132,0.7883278194897076
2,0,0,2,1.0,1.0,0.3270964431105608,0.8168992480611362
12,4,1,17,0.75,0.9411764705882353,0.39465238114842655,0.8166127698334814
20,82,2,104,0.19607843137254902,0.9807692307692307,0.4065345533721548,0.8204589236796352
49,79,22,150,0.3828125,0.8533333333333334,0.4071404207190935,0.8025035457242573
30,29,4,63,0.5084745762711864,0.9365079365079365,0.4567772245931856,0.9079113654177913
9,20,2,31,0.3103448275862069,0.9354838709677419,0.49236584427751245,0.9229078506165729
5,17,2,24,0.22727272727272727,0.9166666666666666,0.501012423940356,0.9372841129834893
42,50,25,117,0.45652173913043476,0.7863247863247863,0.42337267238756093,0.9067590824584588
26,84,2,112,0.23636363636363636,0.9821428571428571,0.34999604901093756,0.9126114233948334
1,0,0,1,1.0,1.0,0.46315022157105074,0.9167323025157126
32,86,3,121,0.2711864406779661,0.9752066115702479,0.43987563779193406,0.9331903898828908
158,220,37,415,0.41798941798941797,0.9108433734939759,0.4269491866088243,0.9295240237380392
27,65,15,107,0.29347826086956524,0.8598130841121495,0.414687460329107,0.9187139113300974
2,30,8,40,0.0625,0.8,0.39114849929014595,0.9020472446634308
0,13,1,14,0.0,0.9285714285714286,0.32593110798579816,0.9223681935558083
5,10,1,16,0.3333333333333333,0.9375,0.339783921838612,0.9159906425354001
42,168,61,271,0.2,0.7749077490774908,0.2254982075528977,0.8838346066893273
42,94,35,171,0.3088235294117647,0.7953216374269005,0.23087493451486893,0.8581367532402778
3,19,4,26,0.13636363636363635,0.8461538461538461,0.19064267999690013,0.8488953921916877
6,20,100,126,0.23076923076923078,0.20634920634920634,0.1816842471254238,0.7555434096541245
7,43,3,53,0.14,0.9433962264150944,0.19275567569685234,0.7760285848562809
30,149,26,205,0.16759776536312848,0.8731707317073171,0.2166982136058707,0.7681141995899792
44,121,3,168,0.26666666666666666,0.9821428571428571,0.2071744040820612,0.7744917506103874
52,92,7,151,0.3611111111111111,0.9536423841059603,0.23019027709793421,0.8000252699001688
48,65,4,117,0.4247787610619469,0.9658119658119658,0.24675531019081737,0.8243810310980352
55,165,5,225,0.25,0.9777777777777777,0.2629890764245836,0.843184449901454
25,76,1,102,0.24752475247524752,0.9901960784313726,0.26538272238258603,0.9551625744846206
14,41,5,60,0.2545454545454545,0.9166666666666666,0.2817463587462224,0.9513440659491309
3,22,14,39,0.12,0.6410256410256411,0.27494667798006117,0.9181804815660344
53,105,4,162,0.33544303797468356,0.9753086419753086,0.28477187388120645,0.9172041651135273
24,90,26,140,0.21052631578947367,0.8142857142857143,0.26325976026382963,0.8972960694249208
46,70,25,141,0.39655172413793105,0.8226950354609929,0.25922732641754165,0.876850793660496
25,83,2,110,0.23148148148148148,0.9818181818181818,0.25658182377203903,0.8774279942376967
11,51,4,66,0.1774193548387097,0.9393939393939394,0.2465667669668193,0.8701705458037777
13,58,60,131,0.18309859154929578,0.5419847328244275,0.23636007225308234,0.8166445552548864
14,35,1,50,0.2857142857142857,0.98,0.2600335416408375,0.8650694636797949
25,73,1,99,0.25510204081632654,0.98989898989899,0.24855625633250075,0.8671537990974636
7,6,17,30,0.5384615384615384,0.43333333333333335,0.2954041452856529,0.8127320303899807
15,70,11,96,0.17647058823529413,0.8854166666666666,0.2639639830138476,0.8216922634193625
26,28,2,56,0.48148148148148145,0.9642857142857143,0.2996782687281333,0.8191876252004385
0,4,57,61,0.0,0.06557377049180328,0.27433264660831763,0.6943561725001334
13,184,11,208,0.06598984771573604,0.9471153846153846,0.25760282606066626,0.7522319798988416
3,106,125,234,0.027522935779816515,0.4658119658119658,0.2207183474985992,0.6787765464434081
42,90,19,151,0.3181818181818182,0.8741721854304636,0.22972974426509804,0.6622441458050473
8,53,4,65,0.13114754098360656,0.9384615384615385,0.17154203033967916,0.7344053179662193
44,179,7,230,0.19730941704035873,0.9695652173913043,0.1745190058832598,0.7464265394983105
2,6,59,67,0.25,0.11940298507462686,0.14145022281447675,0.6257290067538694
8,4,3,15,0.6666666666666666,0.8,0.236688318052572,0.7306470395407547
24,59,5,88,0.2891566265060241,0.9431818181818182,0.26856928645118455,0.7300851014788166
6,56,3,65,0.0967741935483871,0.9538461538461539,0.2784623232752661,0.7998042711979864
53,87,3,143,0.37857142857142856,0.9790209790209791,0.2870894104737819,0.8147826702823456
19,94,480,593,0.168141592920354,0.1905564924114671,0.29237427503617436,0.7079390922751927
3,46,10,59,0.061224489795918366,0.8305084745762712,0.2729335711441115,0.6880738433016165
26,61,20,107,0.2988505747126437,0.8130841121495327,0.2799122246744891,0.7871711471694602
2,0,0,2,1.0,1.0,0.32753127229353673,0.8157425757408888
12,4,1,17,0.75,0.9411764705882353,0.3933660399355333,0.815456097513234
23,79,2,104,0.22549019607843138,0.9807692307692307,0.41175404029696816,0.819302251359388
51,77,22,150,0.3984375,0.8533333333333334,0.4145920505010498,0.80134687340401
31,28,4,63,0.5254237288135594,0.9365079365079365,0.46563235562865063,0.9079113654177914
10,19,2,31,0.3448275862068966,0.9354838709677419,0.5061470836873617,0.9229078506165729
5,17,2,24,0.22727272727272727,0.9166666666666666,0.5059612057786728,0.9363317320311084
41,51,25,117,0.44565217391304346,0.7863247863247863,0.42676865919482176,0.9058067015060779
26,84,2,112,0.23636363636363636,0.9821428571428571,0.344463464389627,0.9116590424424525
1,0,0,1,1.0,1.0,0.4576176369497401,0.9157799215633317
34,84,3,121,0.288135593220339,0.9752066115702479,0.4407441502669314,0.9331903898828908
165,212,38,415,0.4376657824933687,0.908433734939759,0.4306286082986718,0.9291797896588655
27,65,15,107,0.29347826086956524,0.8598130841121495,0.4183668820189545,0.9183696772509238
2,30,8,40,0.0625,0.8,0.3948279209799935,0.9017030105842571
0,13,1,14,0.0,0.9285714285714286,0.33116332470670157,0.9220239594766345
6,9,1,16,0.4,0.9375,0.35453994808332495,0.9156464084562265
45,165,61,271,0.21428571428571427,0.7749077490774908,0.2422950501241412,0.8834903726101536
45,90,36,171,0.3333333333333333,0.7894736842105263,0.24875187014028327,0.8569570972730505
4,18,4,26,0.18181818181818182,0.8461538461538461,0.21220221290097085,0.8480599703036343
6,21,99,126,0.2222222222222222,0.21428571428571427,0.20202277880849331,0.7558417746141436
7,43,3,53,0.14,0.9433962264150944,0.21309420737992185,0.7763269498163
30,149,26,205,0.16759776536312848,0.8731707317073171,0.2370367452889402,0.7684125645499983
47,118,3,168,0.28484848484848485,0.9821428571428571,0.22058652883872373,0.7747901155704063
49,95,7,151,0.3402777777777778,0.9536423841059603,0.2385853950518757,0.8003236348601879
44,70,3,117,0.38596491228070173,0.9743589743589743,0.24610419204435688,0.8267358191671089
55,165,5,225,0.25,0.9777777777777777,0.2558444517846166,0.8455392379705279
33,68,1,102,0.32673267326732675,0.9901960784313726,0.27077451621963156,0.9563835757056217
13,42,5,60,0.23636363636363636,0.9166666666666666,0.2845407499858653,0.9525650671701321
3,22,14,39,0.12,0.6410256410256411,0.2777410692197041,0.9194014827870356
51,107,4,162,0.3227848101265823,0.9753086419753086,0.2831605442594323,0.9184251663345286
24,90,26,140,0.21052631578947367,0.8142857142857143,0.26462462111824603,0.898517070645922
48,68,25,141,0.41379310344827586,0.8226950354609929,0.26860007699932803,0.876850793660496
25,83,2,110,0.23148148148148148,0.9818181818181818,0.2659545743538254,0.8774279942376967
13,49,4,66,0.20967741935483872,0.9393939393939394,0.24923239522346993,0.8701705458037777
15,57,59,131,0.20833333333333334,0.549618320610687,0.24522806621914098,0.8177350677957806
16,33,1,50,0.32653061224489793,0.98,0.2747324393969835,0.866159976220689
33,65,1,99,0.336734693877551,0.98989898989899,0.2767252799328362,0.8682443116383577
6,6,18,30,0.5,0.4,0.31807866339148283,0.80906063816897
16,69,11,96,0.18823529411764706,0.8854166666666666,0.285856119201393,0.8180208711983521
25,30,1,56,0.45454545454545453,0.9821428571428571,0.31772240106767485,0.8180672533875912
0,4,59,63,0.0,0.06349206349206349,0.28776848401698363,0.6929384139730376
16,181,11,208,0.08121827411167512,0.9471153846153846,0.26960918984246096,0.7497237088308515
2,108,124,234,0.01818181818181818,0.4700854700854701,0.2255593621191639,0.6768787759859187
53,90,8,151,0.3706293706293706,0.9470198675496688,0.23040145879799526,0.6707531870788728
10,49,6,65,0.1694915254237288,0.9076923076923077,0.18318596242995652,0.7432806596063453
47,177,6,230,0.20982142857142858,0.9739130434782609,0.18626969592335388,0.7559229991508588
3,9,55,67,0.25,0.1791044776119403,0.15704891670257465,0.6412032306464421
8,5,2,15,0.6153846153846154,0.8666666666666667,0.24496100461466258,0.7559424596713854
24,59,5,88,0.2891566265060241,0.9431818181818182,0.274666483528141,0.7553805216094475
7,55,3,65,0.11290322580645161,0.9538461538461539,0.2881981131888029,0.8244891907181165
53,87,3,143,0.37857142857142856,0.9790209790209791,0.2893326928948112,0.8290607780711607
20,101,472,593,0.1652892561983471,0.20404721753794267,0.28873236871975666,0.7285400509062515
3,46,10,59,0.061224489795918366,0.8305084745762712,0.2675042346089695,0.7080536839202531
25,62,20,107,0.28735632183908044,0.8130841121495327,0.2728408520145524,0.7986222031399091
2,0,0,2,1.0,1.0,0.32778590695960735,0.8176698221875282
12,4,1,17,0.75,0.9411764705882353,0.3936206746016039,0.8173833439598734
21,80,3,104,0.2079207920792079,0.9711538461538461,0.4071946126405691,0.8198558714324008
56,73,21,150,0.43410852713178294,0.86,0.4151284838634769,0.8028528744294039
30,29,4,63,0.5084745762711864,0.9365079365079365,0.4641549581595968,0.9074901199965459
11,18,2,31,0.3793103448275862,0.9354838709677419,0.5095957945926921,0.9224866051953274
5,17,2,24,0.22727272727272727,0.9166666666666666,0.41509548883282105,0.9372841129834893
41,52,24,117,0.44086021505376344,0.7948717948717948,0.4066469481262159,0.90798008367946
26,84,2,112,0.23636363636363636,0.9821428571428571,0.33327032474959245,0.9138324246158345
1,0,0,1,1.0,1.0,0.4464244973097057,0.9179533037367137
32,80,9,121,0.2857142857142857,0.9256198347107438,0.42744015938849067,0.9273275658382486
162,214,39,415,0.4308510638297872,0.9060240963855422,0.41877239368862973,0.9229727315350493
28,64,15,107,0.30434782608695654,0.8598130841121495,0.4179156791887368,0.9121626191271076
1,31,8,40,0.03125,0.8,0.3899124324354902,0.8954959524604409
0,13,1,14,0.0,0.9285714285714286,0.3269324017135239,0.9145959001318172
4,11,1,16,0.26666666666666666,0.9375,0.33126140604252824,0.9082183491114091
43,167,61,271,0.20476190476190476,0.7749077490774908,0.21765596386565747,0.8760623132653363
43,93,35,171,0.3161764705882353,0.7953216374269005,0.22200770456193597,0.8574482850819302
4,18,4,26,0.18181818181818182,0.8461538461538461,0.18643157856027806,0.8488953921916879
12,21,93,126,0.36363636363636365,0.2619047619047619,0.19490136963876478,0.7634799175906324
7,43,3,53,0.14,0.9433962264150944,0.21043708392447907,0.7839650927927888
27,150,26,203,0.15254237288135594,0.8719211822660099,0.2322288514789585,0.7758722004634432
46,119,3,168,0.2787878787878788,0.9821428571428571,0.23396045321056022,0.7822497514838513
49,95,7,151,0.3402777777777778,0.9536423841059603,0.2533198636413992,0.8077832707736328
42,71,4,117,0.37168141592920356,0.9658119658119658,0.2612491415472519,0.8321390319714992
55,165,5,225,0.25,0.9777777777777777,0.2709894012875116,0.8509424507749179
33,68,1,102,0.32673267326732675,0.9901960784313726,0.2657174455205063,0.9549840674215767
12,43,5,60,0.21818181818181817,0.9166666666666666,0.27688627668933746,0.951165558886087
3,22,14,39,0.12,0.6410256410256411,0.2722373662777152,0.9181804815660344
45,114,4,163,0.2830188679245283,0.9754601226993865,0.27284179329723657,0.9172258052169672
24,90,26,140,0.21052631578947367,0.8142857142857143,0.2543058701560502,0.8973177095283605
45,70,26,141,0.391304347826087,0.8156028368794326,0.2571091461413193,0.8758592625379986
24,84,2,110,0.2222222222222222,0.9818181818181818,0.25314089217306535,0.8764364631151992
12,50,4,66,0.1935483870967742,0.9393939393939394,0.23411456557727212,0.8691790146812802
13,58,60,131,0.18309859154929578,0.5419847328244275,0.22910267605834037,0.8156530241323889
15,34,1,50,0.30612244897959184,0.98,0.25569159734113917,0.8640779325572973
31,67,1,99,0.3163265306122449,0.98989898989899,0.26044983486795587,0.8661406278715263
6,5,19,30,0.5454545454545454,0.36666666666666664,0.3082967248201089,0.8021950496402338
16,69,11,96,0.18823529411764706,0.8854166666666666,0.27928686000461755,0.812168453895553
26,29,1,56,0.4727272727272727,0.9821428571428571,0.3150732957910533,0.8122148360847924
0,4,59,63,0.0,0.06349206349206349,0.28742352620579986,0.6870859966702386
14,183,11,208,0.07106598984771574,0.9471153846153846,0.2714188688198598,0.7449618040689467
4,106,124,234,0.03636363636363636,0.4700854700854701,0.23288189558900907,0.6721168712240139
52,91,9,152,0.36363636363636365,0.9407894736842105,0.2396404431638832,0.6651012260504741
12,46,7,65,0.20689655172413793,0.8923076923076924,0.19127501548811068,0.7401928011420491
46,178,6,230,0.20535714285714285,0.9739130434782609,0.19372099387946723,0.7528351406865627
6,47,13,66,0.11320754716981132,0.803030303030303,0.14236103308554418,0.7272476329561978
8,5,2,15,0.6153846153846154,0.8666666666666667,0.23027312099763209,0.841986861981141
24,59,5,88,0.2891566265060241,0.9431818181818182,0.2614289262345333,0.841424923919203
8,54,3,65,0.12903225806451613,0.9538461538461539,0.27466730076323037,0.9105335930278721
55,84,3,142,0.39568345323741005,0.9788732394366197,0.27924545642052273,0.9159741309925019
22,100,471,593,0.18032786885245902,0.2057335581787521,0.2754499302959971,0.8178921118312248
1,48,10,59,0.02040816326530612,0.8305084745762712,0.24902864749716333,0.7974057448452262
26,61,20,107,0.2988505747126437,0.8130841121495327,0.27554908000328227,0.7988420032908305
2,0,0,2,1.0,1.0,0.3304941349483372,0.8178896223384495
13,3,1,17,0.8125,0.9411764705882353,0.40525747401890516,0.817603144110795
21,80,3,104,0.2079207920792079,0.9711538461538461,0.4165272645924326,0.8200756715833224
52,76,22,150,0.40625,0.8533333333333334,0.41803677127280253,0.8021413992828529
30,29,4,63,0.5084745762711864,0.9365079365079365,0.46491487233262074,0.9065377390441649
11,18,2,31,0.3793103448275862,0.9354838709677419,0.5161866125558037,0.9215342242429464
5,17,2,24,0.22727272727272727,0.9166666666666666,0.5029972045710547,0.9329071565040786
43,55,19,117,0.4387755102040816,0.8376068376068376,0.42282227745735196,0.9097081333050554
27,82,2,111,0.24770642201834864,0.9819819819819819,0.3510660520314018,0.9155374920755907
1,0,0,1,1.0,1.0,0.45781644449608005,0.9200967625923081
31,87,3,121,0.2627118644067797,0.9752066115702479,0.4263394469173875,0.9398577881560415
159,230,25,414,0.4087403598971722,0.9396135265700483,0.4169343167332063,0.9403014438792004
26,71,10,107,0.26804123711340205,0.9065420560747663,0.4076068744160733,0.9368025257815068
2,31,7,40,0.06060606060606061,0.825,0.38379735060654946,0.9237072876862688
0,13,1,14,0.0,0.9285714285714286,0.3211151348631092,0.9367022292526388
6,9,1,16,0.4,0.9375,0.34287136028905946,0.9303476603980699
43,172,56,271,0.2,0.7933579335793358,0.22858564600334513,0.900827365195118
44,92,35,171,0.3235294117647059,0.7953216374269005,0.23727386705447745,0.8751295117460683
3,23,0,26,0.11538461538461539,1.0,0.19536590355268363,0.88375615080749
19,36,71,126,0.34545454545454546,0.4365079365079365,0.20642494760141838,0.8166084194408
6,44,3,53,0.12,0.9433962264150944,0.2149097960862669,0.8335221660715277
32,147,24,203,0.1787709497206704,0.8817733990147784,0.2404485031892198,0.8268367332777207
45,120,3,168,0.2727272727272727,0.9821428571428571,0.22226668500740163,0.8332142842981288
55,89,7,151,0.3819444444444444,0.9536423841059603,0.24825874849946508,0.8561120629447895
43,71,3,117,0.37719298245614036,0.9743589743589743,0.2559249728839557,0.8816888253636571
55,165,5,225,0.25,0.9777777777777777,0.27515574211472493,0.878514222189054
34,67,1,102,0.33663366336633666,0.9901960784313726,0.2738956161021237,0.9576125281781164
13,46,1,60,0.22033898305084745,0.9833333333333333,0.28822975653795907,0.9633178291664362
4,22,13,39,0.15384615384615385,0.6666666666666666,0.2846690714130281,0.9325882959738487
52,107,4,163,0.3270440251572327,0.9754601226993865,0.29242860747445093,0.9316336196247814
24,91,25,140,0.20869565217391303,0.8214285714285714,0.2676787800072322,0.9127459320994402
56,70,15,141,0.4444444444444444,0.8936170212765957,0.27728613171984706,0.9012113673733861
24,83,3,110,0.22429906542056074,0.9727272727272728,0.27361456963707004,0.9004898666518855
10,55,1,66,0.15384615384615385,0.9848484848484849,0.2475020682770439,0.8997259247114728
15,104,12,131,0.12605042016806722,0.9083969465648855,0.23403227357950387,0.8890207266016946
14,35,1,50,0.2857142857142857,0.98,0.2528705781320942,0.9337826313635994
31,67,1,99,0.3163265306122449,0.98989898989899,0.2513395074828102,0.9358453266778285
7,5,18,30,0.5833333333333334,0.4,0.30485917621987024,0.8756412450451754
16,69,11,96,0.18823529411764706,0.8854166666666666,0.2682578690303278,0.8744697658151855
26,29,1,56,0.4727272727272727,0.9821428571428571,0.3037476129312866,0.875814849303126
0,4,59,63,0.0,0.06349206349206349,0.28176959095326465,0.744192503395066
15,182,11,208,0.07614213197969544,0.9471153846153846,0.2746398354977829,0.7497237088308515
41,159,34,234,0.205,0.8547008547008547,0.263109223252885,0.7318238309309736
58,91,3,152,0.38926174496644295,0.9802631578947368,0.273528539589199,0.7304472835017946
8,55,2,65,0.12698412698412698,0.9692307692307692,0.20833579582502665,0.811765964820476
47,177,6,230,0.20982142857142858,0.9739130434782609,0.211419529318424,0.8244083043649894
5,59,2,66,0.078125,0.9696969696969697,0.15504777607167072,0.8226303204441484
8,5,2,15,0.6153846153846154,0.8666666666666667,0.24295986398375868,0.9373695494690917
26,57,5,88,0.3132530120481928,0.9431818181818182,0.2768328468506869,0.9368076114071536
6,56,3,65,0.0967741935483871,0.9538461538461539,0.2613720173575993,0.9509712255707677
55,84,3,142,0.39568345323741005,0.9788732394366197,0.26228940425345176,0.9507726657910368
28,111,454,593,0.2014388489208633,0.23440134907251264,0.27292579310155696,0.8457970343398573
4,45,10,59,0.08163265306122448,0.8305084745762712,0.2546131108858135,0.8253106673538587
26,61,20,107,0.2988505747126437,0.8130841121495327,0.2861453358447626,0.8029374019899392
1,1,0,2,0.5,1.0,0.2696618193612461,0.8219850210375582
12,4,1,17,0.75,0.9411764705882353,0.3320542462115043,0.8216985428099035
21,80,3,104,0.2079207920792079,0.9711538461538461,0.34793233171590726,0.824171070282431
54,75,21,150,0.4186046511627907,0.86,0.35120678856239024,0.8071891789343424
29,30,4,63,0.4915254237288136,0.9365079365079365,0.3926477278206688,0.9074901199965458
9,20,2,31,0.3103448275862069,0.9354838709677419,0.42532089560995207,0.9224866051953274
4,16,2,22,0.2,0.9090909090909091,0.5023191740842362,0.9319890106203947
36,53,24,113,0.4044943820224719,0.7876106194690266,0.41724694294458936,0.9016476705445414
24,70,2,96,0.2553191489361702,0.9791666666666666,0.33764967850689936,0.9070748414128887
1,0,0,1,1.0,1.0,0.4459699296842934,0.9116341119296061
32,70,3,105,0.3137254901960784,0.9714285714285714,0.43076384725132016,0.9306913122745328
151,191,34,376,0.4415204678362573,0.9095744680851063,0.4211989746177589,0.9268436739284143
28,55,15,98,0.3373493975903614,0.8469387755102041,0.4217726980830486,0.9148300014643548
1,25,7,33,0.038461538461538464,0.7878787878787878,0.3986957750061256,0.8975139841483374
0,13,1,14,0.0,0.9285714285714286,0.3409108632886296,0.9176512425915376
3,7,1,11,0.3,0.9090909090909091,0.34729384201203384,0.9076404200807151
40,142,61,243,0.21978021978021978,0.7489711934156379,0.23583387340920808,0.871779161997235
45,87,25,157,0.3409090909090909,0.8407643312101911,0.23971724493963847,0.8531128419660378
3,18,4,25,0.14285714285714285,0.84,0.1970510556569078,0.843173632239594
11,20,91,122,0.3548387096774194,0.2540983606557377,0.19954952881220184,0.7584821444032416
4,42,3,49,0.08695652173913043,0.9387755102040817,0.20647738356614354,0.7800388190211408
25,138,25,188,0.15337423312883436,0.8670212765957447,0.22838798829883417,0.7712459401674716
40,91,3,134,0.3053435114503817,0.9776119402985075,0.22915134707746013,0.7810346589114142
52,85,7,144,0.3795620437956204,0.9513888888888888,0.25197732193680306,0.8099514725504501
42,54,10,106,0.4375,0.9056603773584906,0.26577602323550437,0.8192223362859214
55,165,5,225,0.25,0.9777777777777777,0.281082145684484,0.8389048759684611
29,53,1,83,0.35365853658536583,0.9879518072289156,0.2809135495284763,0.9437410826217721
13,35,5,53,0.2708333333333333,0.9056603773584906,0.3071816654705053,0.9390103493581163
4,20,12,36,0.16666666666666666,0.6666666666666666,0.30908058454733844,0.9103882622253909
50,105,4,159,0.3225806451612903,0.9748427672955975,0.3115430322203254,0.9099926660821182
23,82,26,131,0.21904761904761905,0.8015267175572519,0.28861240011346806,0.8885837844633128
41,57,26,124,0.41836734693877553,0.7903225806451613,0.2858791639618646,0.8721069563614086
24,77,2,103,0.2376237623762376,0.9805825242718447,0.2841111300156128,0.8725076344319895
10,50,4,64,0.16666666666666666,0.9375,0.25739800574151295,0.8653002333992873
13,95,13,121,0.12037037037037036,0.8925619834710744,0.23590329674680394,0.8634290342725137
14,32,1,47,0.30434782608695654,0.9787234042553191,0.25557203380684534,0.9080085682137496
30,64,1,95,0.3191489361702128,0.9894736842105263,0.25508178966526285,0.9100986992015967
6,5,18,29,0.5454545454545454,0.3793103448275862,0.30171135058053805,0.8497820745259302
15,54,11,80,0.21739130434782608,0.8625,0.27300048735325955,0.8600931344337643
27,24,1,52,0.5294117647058824,0.9807692307692307,0.31468448768606594,0.8601198067905338
0,2,59,61,0.0,0.03278688524590164,0.29087496387654216,0.7308750761113768
13,155,11,179,0.07738095238095238,0.9385474860335196,0.2847336184494824,0.7374444336202975
52,132,15,199,0.2826086956521739,0.9246231155778895,0.2816280283873706,0.7297158209520934
50,80,10,140,0.38461538461538464,0.9285714285714286,0.2909803781652523,0.7210154987179365
11,48,4,63,0.1864406779661017,0.9365079365079365,0.23969268280976033,0.8006151546722722
43,162,6,211,0.2097560975609756,0.9715639810426541,0.2386019389830674,0.8161957233926513
2,11,53,66,0.15384615384615385,0.19696969696969696,0.18494970886024906,0.7042243614212894
8,4,2,14,0.6666666666666666,0.8571428571428571,0.28018780409834426,0.8219895002637116
22,49,5,76,0.30985915492957744,0.9342105263157895,0.313398975891005,0.8213699345897502
6,55,3,64,0.09836065573770492,0.953125,0.28707782733179515,0.8254416323643373
51,67,3,121,0.4322033898305085,0.9752066115702479,0.2938761137910985,0.8321038013641687
24,82,398,504,0.22641509433962265,0.21031746031746032,0.2995867447016015,0.7283623047655292
3,40,10,53,0.06976744186046512,0.8113207547169812,0.2795883653158143,0.7054704152904332
24,57,20,101,0.2962962962962963,0.801980198019802,0.2999383856658347,0.7919004868690196
2,0,0,2,1.0,1.0,0.3475574332848823,0.8123086501343257
12,4,1,17,0.75,0.9411764705882353,0.41043469686637124,0.8133037850303895
23,68,3,94,0.25274725274725274,0.9680851063829787,0.43248992501059236,0.8154409430851006
57,61,23,141,0.4830508474576271,0.8368794326241135,0.4397538475287522,0.7956799175213671
28,31,4,63,0.4745762711864407,0.9365079365079365,0.4752054442211548,0.8994214141200066
9,18,2,29,0.3333333333333333,0.9310344827586207,0.5128577144315645,0.9165233752688122
4,16,2,22,0.2,0.9090909090909091,0.4745643258154634,0.9343363464642944
35,53,25,113,0.3977272727272727,0.7787610619469026,0.3885253647765023,0.9027307838852803
26,68,2,96,0.2765957446808511,0.9791666666666666,0.3119676140166239,0.9081579547536277
1,0,0,1,1.0,1.0,0.42541299216788436,0.912239587406689
39,63,3,105,0.38235294117647056,0.9714285714285714,0.4271664494563115,0.9300627166583897
164,183,32,379,0.47262247838616717,0.9155672823218998,0.42930864370518285,0.9270711946318129
29,54,15,98,0.3493975903614458,0.8469387755102041,0.43981371819031556,0.914421895280736
1,25,7,33,0.038461538461538464,0.7878787878787878,0.4167367951133924,0.8971058779647187
0,13,1,14,0.0,0.9285714285714286,0.35991861329521063,0.9185073589110796
2,8,1,11,0.2,0.9090909090909091,0.3489763640550891,0.9084965364002571
43,140,61,244,0.23497267759562843,0.75,0.23968674656875025,0.8727822506859714
45,87,25,157,0.3409090909090909,0.8407643312101911,0.23376619653055314,0.8541159306547742
4,17,4,25,0.19047619047619047,0.84,0.19345958397198504,0.8433206046087885
10,18,94,122,0.35714285714285715,0.22950819672131148,0.19456605065504382,0.7551162362103753
5,41,3,49,0.10869565217391304,0.9387755102040817,0.20459949547109732,0.7766729108282744
25,140,25,190,0.15151515151515152,0.868421052631579,0.22624451711611895,0.7680799999797244
44,87,3,134,0.33587786259541985,0.9776119402985075,0.2456556403440361,0.7778687187236671
52,85,7,144,0.3795620437956204,0.9513888888888888,0.2663112640868921,0.8066385599935085
41,55,10,106,0.4270833333333333,0.9056603773584906,0.2786218701474982,0.8159094237289797
58,162,5,225,0.2636363636363636,0.9777777777777777,0.2890733234560943,0.8355919634115194
29,53,1,83,0.35365853658536583,0.9879518072289156,0.28857556337645274,0.9439410506268915
15,33,5,53,0.3125,0.9056603773584906,0.31769047020875085,0.9392103173632356
3,21,12,36,0.125,0.6666666666666666,0.31390259142087207,0.9103882622253909
51,104,4,159,0.32903225806451614,0.9748427672955975,0.31292464791645724,0.9099926660821182
24,81,26,131,0.22857142857142856,0.8015267175572519,0.29135456002728694,0.8885837844633128
40,59,26,125,0.40404040404040403,0.792,0.28806271298543995,0.8723465876978141
23,79,2,104,0.22549019607843138,0.9807692307692307,0.2826132604771639,0.8727739381251646
10,50,4,64,0.16666666666666666,0.9375,0.255900136203064,0.8655665370924623
12,61,48,121,0.1643835616438356,0.6033057851239669,0.23474064500932626,0.8223730239161018
14,32,1,47,0.30434782608695654,0.9787234042553191,0.26036176302174857,0.8669525578573378
29,65,1,95,0.30851063829787234,0.9894736842105263,0.25743010305508524,0.8690426888451849
6,5,18,29,0.5454545454545454,0.3793103448275862,0.3026991197526733,0.8087260641695183
15,54,11,80,0.21739130434782608,0.8625,0.2760349626537336,0.8187974927409469
25,26,1,52,0.49019607843137253,0.9807692307692307,0.31385008870415376,0.8187974927409469
0,3,58,61,0.0,0.04918032786885246,0.29004056489463,0.6918946824364972
14,157,10,181,0.08187134502923976,0.9447513812154696,0.27825310537825915,0.7406726247352834
52,132,15,199,0.2826086956521739,0.9246231155778895,0.27514751531614734,0.732944012067079
49,79,10,138,0.3828125,0.927536231884058,0.28576206698787987,0.7240958045918694
10,47,7,64,0.17543859649122806,0.890625,0.23290264570740596,0.7971407553307858
43,163,6,212,0.2087378640776699,0.9716981132075472,0.2316664399545265,0.8127404857890067
2,10,54,66,0.16666666666666666,0.18181818181818182,0.1854479525595685,0.6986046216531425
9,3,2,14,0.75,0.8571428571428571,0.2925908097024257,0.8140278401208575
26,45,5,76,0.36619718309859156,0.9342105263157895,0.3332087865694759,0.8125220037066174
8,53,3,64,0.13114754098360656,0.953125,0.3115714787596806,0.8165937014812046
52,68,3,123,0.43333333333333335,0.975609756097561,0.31878874066444246,0.8234613477974193
25,82,397,504,0.2336448598130841,0.2123015873015873,0.32710392113899334,0.7265580031262175
3,40,10,53,0.06976744186046512,0.8113207547169812,0.3072510036793927,0.7036469519132795
23,58,20,101,0.2839506172839506,0.801980198019802,0.3240058537675761,0.7922415256563681
2,0,0,2,1.0,1.0,0.3597201394818618,0.8126496889216744
13,3,1,17,0.8125,0.9411764705882353,0.4234776847534916,0.813644823817738
22,69,3,94,0.24175824175824176,0.9680851063829787,0.43927921343558235,0.8157819818724493
50,69,23,142,0.42016806722689076,0.8380281690140845,0.43739846113466196,0.7961274694319526
30,29,4,63,0.5084745762711864,0.9365079365079365,0.4766598492001051,0.8995855193185739
9,18,2,29,0.3333333333333333,0.9310344827586207,0.5143121194105149,0.9166874804673796
3,19,2,24,0.13636363636363635,0.9166666666666666,0.47138031383039625,0.9308103026156698
38,54,25,117,0.41304347826086957,0.7863247863247863,0.3875293821533776,0.9002852720906392
24,85,2,111,0.22018348623853212,0.9819819819819819,0.30291273733031077,0.9061146308611745
1,0,0,1,1.0,1.0,0.4163581154815713,0.9101962635142357
42,76,3,121,0.3559322033898305,0.9752066115702479,0.4098377440873176,0.9285591127861759
172,211,33,416,0.4490861618798956,0.9206730769230769,0.40861760740672154,0.9262969899883388
28,53,26,107,0.345679012345679,0.7570093457943925,0.4171839969254921,0.9054089241801645
2,31,7,40,0.06060606060606061,0.825,0.4063614861029813,0.8923136860849263
0,13,1,14,0.0,0.9285714285714286,0.34735527492285706,0.9126346349773039
6,9,1,16,0.4,0.9375,0.3730433483173524,0.9062800661227349
46,164,61,271,0.21904761904761905,0.7749077490774908,0.2614787224670123,0.8741240302766623
44,102,26,172,0.3013698630136986,0.8488372093023255,0.25368410241327916,0.8560712585241019
6,16,4,26,0.2727272727272727,0.8461538461538461,0.22848997539147592,0.8454256541284976
10,18,98,126,0.35714285714285715,0.2222222222222222,0.2301276675053585,0.7690274936181875
6,43,3,52,0.12244897959183673,0.9423076923076923,0.23896237021761224,0.7857857353764294
23,157,26,206,0.12777777777777777,0.8737864077669902,0.2572163384715805,0.7779593038329381
33,132,3,168,0.2,0.9821428571428571,0.2286449099001519,0.7843368548533461
52,92,7,151,0.3611111111111111,0.9536423841059603,0.24893969448065079,0.8098703741431276
40,61,16,117,0.39603960396039606,0.8632478632478633,0.26246394318732186,0.81192903899249
58,162,5,225,0.2636363636363636,0.9777777777777777,0.2611652418886205,0.8307324577959089
29,72,1,102,0.2871287128712871,0.9901960784313726,0.25116322127839624,0.9404430086829303
16,39,5,60,0.2909090909090909,0.9166666666666666,0.27522895146657544,0.9367800050199266
2,24,13,39,0.07692307692307693,0.6666666666666666,0.26796399420161815,0.9071914705770234
54,106,4,164,0.3375,0.975609756097561,0.2876068513444753,0.9062581704276953
26,88,26,140,0.22807017543859648,0.8142857142857143,0.2686010033912589,0.8863500747390888
40,75,26,141,0.34782608695652173,0.8156028368794326,0.26171335810499113,0.8795436424007415
24,84,2,110,0.2222222222222222,0.9818181818181818,0.25579705218868526,0.8801208429779421
8,54,4,66,0.12903225806451613,0.9393939393939394,0.23321184435914652,0.8728633945440231
14,106,12,132,0.11666666666666667,0.9090909090909091,0.20832006946737167,0.8717811434617719
13,35,1,49,0.2708333333333333,0.9795918367346939,0.23602153466883682,0.9164847391857759
26,72,1,99,0.2653061224489796,0.98989898989899,0.22570812359011966,0.9185260583002657
8,5,17,30,0.6153846153846154,0.43333333333333335,0.2810387578681223,0.8641042895927827
17,68,11,96,0.2,0.8854166666666666,0.2599207454457621,0.874077693848102
27,28,1,56,0.4909090909090909,0.9821428571428571,0.29830458382960046,0.8741240760373412
0,5,58,63,0.0,0.07936507936507936,0.2798714041060982,0.7512628103189326
16,182,10,208,0.08080808080808081,0.9519230769230769,0.2747487489834431,0.7573816914378136
49,171,15,235,0.22272727272727272,0.9361702127659575,0.2678764546111487,0.7511786022994228
40,92,19,151,0.30303030303030304,0.8741721854304636,0.2732656232656235,0.7346462016610619
9,49,7,65,0.15517241379310345,0.8923076923076924,0.2075210230382646,0.8002139672288274
48,176,6,230,0.21428571428571427,0.9739130434782609,0.20956183936479525,0.812856306773341
2,9,55,66,0.18181818181818182,0.16666666666666666,0.16540599520895105,0.6963597081338851
8,5,2,15,0.6153846153846154,0.8666666666666667,0.253318083121039,0.8088313634626835
28,55,5,88,0.3373493975903614,0.9431818181818182,0.2899668426613648,0.8075826122139321
7,55,3,65,0.11290322580645161,0.9538461538461539,0.2742776931012475,0.8101077466539602
54,85,3,142,0.38848920863309355,0.9788732394366197,0.2864861081873604,0.825065040083411
25,97,472,594,0.20491803278688525,0.2053872053872054,0.2935926251864721,0.7269335419519131
4,45,10,59,0.08163265306122448,0.8305084745762712,0.2746421878686878,0.7064471749659144
26,61,20,107,0.2988505747126437,0.8130841121495327,0.29136110113932523,0.7987925243206097
2,0,0,2,1.0,1.0,0.3463061560843802,0.8178401433682286
13,3,1,17,0.8125,0.9411764705882353,0.41418481357147147,0.8175536651405738
21,81,3,105,0.20588235294117646,0.9714285714285714,0.42746754601928927,0.8200654390809193
47,80,23,150,0.3700787401574803,0.8466666666666667,0.42483747909420166,0.8011787858280688
27,32,4,63,0.4576271186440678,0.9365079365079365,0.46093877707379916,0.9056246045596018
8,21,2,31,0.27586206896551724,0.9354838709677419,0.4886858364886981,0.9206210897583834
3,19,2,24,0.13636363636363635,0.9166666666666666,0.47573827094816873,0.9367791417642325
38,54,25,117,0.41304347826086957,0.7863247863247863,0.3918873392711501,0.9062541112392019
25,84,2,111,0.22935779816513763,0.9819819819819819,0.30858131043759834,0.9120834700097371
1,0,0,1,1.0,1.0,0.4223122397025082,0.9148045584451113
42,76,3,121,0.3559322033898305,0.9752066115702479,0.4146670089156786,0.9331674077170514
168,216,32,416,0.4375,0.9230769230769231,0.4117917062522403,0.9312486915126211
31,50,26,107,0.38271604938271603,0.7570093457943925,0.4221304522231702,0.9057523307735711
2,31,7,40,0.06060606060606061,0.825,0.4113079414006594,0.892657092678333
0,13,1,14,0.0,0.9285714285714286,0.3523017302205352,0.9129780415707104
6,9,1,16,0.4,0.9375,0.3766791876255155,0.9066234727161415
47,164,60,271,0.22274881516587677,0.7785977859778598,0.2656433040777836,0.874994584998693
44,102,26,172,0.3013698630136986,0.8488372093023255,0.2578486840240505,0.8569418132461326
6,16,4,26,0.2727272727272727,0.8461538461538461,0.23430972298508945,0.8459528022571217
9,17,100,126,0.34615384615384615,0.20634920634920634,0.2290865510952509,0.7672870680506664
6,43,3,52,0.12244897959183673,0.9423076923076923,0.23792125380750462,0.7840453098089082
26,154,26,206,0.14444444444444443,0.8737864077669902,0.25855617444242524,0.7762188782654171
32,133,3,168,0.19393939393939394,0.9821428571428571,0.22911894500519583,0.7825964292858253
53,91,7,151,0.3680555555555556,0.9536423841059603,0.24987705077514993,0.8076028004469824
40,66,11,117,0.37735849056603776,0.905982905982906,0.26073256899691266,0.8157664714013511
58,162,5,225,0.2636363636363636,0.9777777777777777,0.25943386769821136,0.8345698902047698
35,66,1,102,0.3465346534653465,0.9901960784313726,0.2594882687427114,0.9465480147879365
12,43,5,60,0.21818181818181817,0.9166666666666666,0.27316438854128017,0.9428850111249328
2,24,13,39,0.07692307692307693,0.6666666666666666,0.26351847889537056,0.9132964766820294
54,106,4,164,0.3375,0.975609756097561,0.28402713690402853,0.9123631765327014
26,88,26,140,0.22807017543859648,0.8142857142857143,0.2640292254587487,0.8924550808440949
44,71,26,141,0.3826086956521739,0.8156028368794326,0.2647792547567681,0.8795436424007416
21,87,2,110,0.19444444444444445,0.9818181818181818,0.2548946948722082,0.8801208429779421
9,53,4,66,0.14516129032258066,0.9393939393939394,0.22612707156609885,0.8728633945440231
14,106,12,132,0.11666666666666667,0.9090909090909091,0.21162490706393436,0.8717811434617719
14,34,1,49,0.2916666666666667,0.9795918367346939,0.24230256274159004,0.916484739185776
25,73,1,99,0.25510204081632654,0.98989898989899,0.23053142571535098,0.9185260583002658
8,5,17,30,0.6153846153846154,0.43333333333333335,0.2858620599933537,0.8641042895927828
16,67,13,96,0.1927710843373494,0.8645833333333334,0.25874240123409303,0.8711015033719114
25,30,1,56,0.45454545454545453,0.9821428571428571,0.2958996883913802,0.8711478855611506
0,5,58,63,0.0,0.07936507936507936,0.2751623612024401,0.7482866198427421
17,181,10,208,0.08585858585858586,0.9519230769230769,0.2707612068012857,0.7544055009616233
49,174,12,235,0.21973094170403587,0.948936170212766,0.260484674663767,0.7500261200299193
40,93,19,152,0.3007518796992481,0.875,0.26700608021847005,0.7336119786157779
8,50,7,65,0.13793103448275862,0.8923076923076924,0.1987984258039191,0.7991797441835434
45,179,6,230,0.20089285714285715,0.9739130434782609,0.1999586790618488,0.8147982742042474
2,8,56,66,0.2,0.15151515151515152,0.16359504269821243,0.6961371734002896
8,5,2,15,0.6153846153846154,0.8666666666666667,0.25150713061030033,0.8086088287290876
27,56,5,88,0.3253012048192771,0.9431818181818182,0.28571321903325625,0.8073600774803363
8,54,3,65,0.12903225806451613,0.9538461538461539,0.27275626422761057,0.8080615037136775
52,87,3,142,0.37410071942446044,0.9788732394366197,0.2832346699026409,0.8229005379189089
22,99,473,594,0.18181818181818182,0.2037037037037037,0.2895042623791299,0.7245285395469105
4,45,10,59,0.08163265306122448,0.8305084745762712,0.2724670903674681,0.704042172560912
26,61,20,107,0.2988505747126437,0.8130841121495327,0.28658860104070294,0.7985520240801093
2,0,0,2,1.0,1.0,0.34153365598575786,0.8175996431277284
13,3,1,17,0.8125,0.9411764705882353,0.4111334838687183,0.8173131649000737
21,81,3,105,0.20588235294117646,0.9714285714285714,0.42211206885109837,0.8198249388404191
51,76,23,150,0.4015748031496063,0.8466666666666667,0.4260369379546906,0.8009382855875685
27,32,4,63,0.4576271186440678,0.9365079365079365,0.46543821464410284,0.9056246045596019
8,20,3,31,0.2857142857142857,0.9032258064516129,0.49459273359454015,0.9160127948275077
4,18,2,24,0.18181818181818182,0.9166666666666666,0.47304724589646796,0.9367791417642325
38,53,26,117,0.4175824175824176,0.7777777777777778,0.3898447341225276,0.9050331100182009
31,78,2,111,0.28440366972477066,0.9819819819819819,0.3144024012260663,0.9108624687887359
1,0,0,1,1.0,1.0,0.4350681432510316,0.9135835572241101
40,78,3,121,0.3389830508474576,0.9752066115702479,0.42725132374330055,0.9319464064960502
177,205,34,416,0.46335078534031415,0.9182692307692307,0.4280689904141929,0.9293408771048065
30,51,26,107,0.37037037037037035,0.7570093457943925,0.43664406795478766,0.9038445163657567
2,31,7,40,0.06060606060606061,0.825,0.4193280506387703,0.8907492782705185
0,13,1,14,0.0,0.9285714285714286,0.35967341955556786,0.9122912283838972
6,9,1,16,0.4,0.9375,0.3761871810234577,0.9059366595293284
48,163,60,271,0.22748815165876776,0.7785977859778598,0.2658283455461388,0.8743077718118799
46,100,26,172,0.3150684931506849,0.8488372093023255,0.26241198016088557,0.8562550000593195
4,18,4,26,0.18181818181818182,0.8461538461538461,0.22219303680058097,0.8459528022571217
9,21,96,126,0.3,0.23809523809523808,0.21214012674767094,0.7718222154429568
6,43,3,52,0.12244897959183673,0.9423076923076923,0.22097482945992467,0.7885804572011985
28,152,26,206,0.15555555555555556,0.8737864077669902,0.24319705168214686,0.7807540256577072
36,129,3,168,0.21818181818181817,0.9821428571428571,0.2172230257081209,0.7871315766781155
46,98,7,151,0.3194444444444444,0.9536423841059603,0.23035963896321757,0.8121379478392726
41,65,11,117,0.3867924528301887,0.905982905982906,0.24060591891743238,0.8203016187936413
58,162,5,225,0.2636363636363636,0.9777777777777777,0.2522942306057441,0.8391050375970602
37,64,1,102,0.36633663366336633,0.9901960784313726,0.2617708925576535,0.9465480147879365
14,41,5,60,0.2545454545454545,0.9166666666666666,0.2806418175510275,0.9428850111249327
4,22,13,39,0.15384615384615385,0.6666666666666666,0.2803976173068273,0.9132964766820295
53,107,4,164,0.33125,0.975609756097561,0.2965502147094247,0.9123631765327014
26,88,26,140,0.22807017543859648,0.8142857142857143,0.2834967477085893,0.8924550808440949
44,71,26,141,0.3826086956521739,0.8156028368794326,0.28289906811173,0.8795436424007415
22,86,2,110,0.2037037037037037,0.9818181818181818,0.27433725954992144,0.8801208429779421
9,53,4,66,0.14516129032258066,0.9393939393939394,0.24274078192980922,0.8728633945440231
15,105,12,132,0.125,0.9090909090909091,0.2242342884233157,0.871781143461772
16,32,1,49,0.3333333333333333,0.9795918367346939,0.24987531406434135,0.9164847391857759
32,66,1,99,0.32653061224489793,0.98989898989899,0.24920111581361248,0.9185260583002658
7,5,18,30,0.5833333333333334,0.4,0.29995299551286053,0.859342384830878
18,67,11,96,0.21176470588235294,0.8854166666666666,0.275546711260029,0.8693157890861972
26,29,1,56,0.4727272727272727,0.9821428571428571,0.3139786496919674,0.8693621712754364
0,5,58,63,0.0,0.07936507936507936,0.29324132250302737,0.7465009055570279
16,182,10,208,0.08080808080808081,0.9519230769230769,0.28692819118989604,0.7526197866759089
51,169,15,235,0.2318181818181818,0.9361702127659575,0.2724260266877315,0.7464166975375182
54,88,10,152,0.38028169014084506,0.9342105263157895,0.28010475210143826,0.738461202739918
12,46,7,65,0.20689655172413793,0.8923076923076924,0.22632806901441035,0.8087908730695883
45,179,6,230,0.20089285714285715,0.9739130434782609,0.22477494776591098,0.8214332126141018
2,11,53,66,0.15384615384615385,0.19696969696969696,0.17922050221146543,0.7092656183036504
7,6,2,15,0.5384615384615384,0.8666666666666667,0.2561435791345424,0.8217372736324485
28,55,5,88,0.3373493975903614,0.9431818181818182,0.29279233867486815,0.8204885223836973
8,54,3,65,0.12903225806451613,0.9538461538461539,0.2781086352814873,0.8230136568237254
55,84,3,142,0.39568345323741005,0.9788732394366197,0.2803088871524252,0.8293940444124155
24,98,472,594,0.19672131147540983,0.2053872053872054,0.2788552814026069,0.7312625462809172
5,45,9,59,0.1,0.847457627118644,0.26444201609648443,0.7131974868009721
26,61,20,107,0.2988505747126437,0.8130841121495327,0.28515693336312586,0.8012138318266627
2,0,0,2,1.0,1.0,0.3510909992971918,0.8202614508742819
13,3,1,17,0.8125,0.9411764705882353,0.41896965678428305,0.8199749726466272
21,82,2,105,0.20388349514563106,0.9809523809523809,0.4296626906530137,0.8238472908046596
52,75,23,150,0.4094488188976378,0.8466666666666667,0.4316291714616177,0.8049606375518092
27,32,4,63,0.4576271186440678,0.9365079365079365,0.46890142962856884,0.9094064562833422
9,20,2,31,0.3103448275862069,0.9354838709677419,0.49895069071231263,0.9219816339760705
3,19,2,24,0.13636363636363635,0.9166666666666666,0.4675812835676335,0.9386839036689943
39,56,22,117,0.4105263157894737,0.811965811965812,0.38337075725184405,0.9118218768069675
29,80,2,111,0.26605504587155965,0.9819819819819819,0.32316433523349547,0.9176512355775027
1,0,0,1,1.0,1.0,0.4396691896024275,0.9203723240128768
40,78,3,121,0.3389830508474576,0.9752066115702479,0.42940209498373655,0.9368304113800551
173,208,35,416,0.4540682414698163,0.9158653846153846,0.4264723764527902,0.9338814753954049
28,53,26,107,0.345679012345679,0.7570093457943925,0.4216679003839463,0.908385114656355
3,30,7,40,0.09090909090909091,0.825,0.4151743938904398,0.8952898765611169
0,13,1,14,0.0,0.9285714285714286,0.35652777734908636,0.9119478217904906
6,9,1,16,0.4,0.9375,0.3756627707960064,0.9055932529359217
43,169,59,271,0.2028301886792453,0.7822878228782287,0.2617813691787558,0.8744915133470973
44,102,26,172,0.3013698630136986,0.8488372093023255,0.2564080566310759,0.856438741594537
4,18,4,26,0.18181818181818182,0.8461538461538461,0.21751519096655672,0.8464799503857457
9,21,96,126,0.3,0.23809523809523808,0.21098961777431688,0.7723493635715809
6,43,3,52,0.12244897959183673,0.9423076923076923,0.21549531615756629,0.7891076053298226
32,148,26,206,0.17777777777777778,0.8737864077669902,0.24089214155439168,0.7812811737863316
44,121,3,168,0.26666666666666666,0.9821428571428571,0.2218445225067726,0.7876587248067396
54,90,7,151,0.375,0.9536423841059603,0.24644020983830897,0.8121379478392727
41,66,10,117,0.38317757009345793,0.9145299145299145,0.25812702513541746,0.8215226200146425
58,162,5,225,0.2636363636363636,0.9777777777777777,0.26981533682372916,0.8403260388180612
37,64,1,102,0.36633663366336633,0.9901960784313726,0.27929199877563865,0.9477690160089376
9,46,5,60,0.16363636363636364,0.9166666666666666,0.2851759107819996,0.944106012345934
2,24,13,39,0.07692307692307693,0.6666666666666666,0.2707680963741852,0.9145174779030307
49,111,4,164,0.30625,0.975609756097561,0.27642285827894714,0.9135841777537027
26,88,26,140,0.22807017543859648,0.8142857142857143,0.25543288334160374,0.8936760820650961
47,68,26,141,0.40869565217391307,0.8156028368794326,0.2590783236388116,0.8795436424007416
19,89,2,110,0.17592592592592593,0.9818181818181818,0.2465482611087491,0.8801208429779421
9,53,4,66,0.14516129032258066,0.9393939393939394,0.2149517834886369,0.8728633945440231
13,107,12,132,0.10833333333333334,0.9090909090909091,0.20705135058820395,0.8717811434617719
15,33,1,49,0.3125,0.9795918367346939,0.24070519674205013,0.9164847391857759
29,69,1,99,0.29591836734693877,0.98989898989899,0.23922924922018424,0.9185260583002657
7,5,18,30,0.5833333333333334,0.4,0.2899811289194324,0.859342384830878
17,67,12,96,0.20238095238095238,0.875,0.26050760037758086,0.8678276938481019
28,27,1,56,0.509090909090909,0.9821428571428571,0.3081025979725784,0.8678740760373412
0,4,57,61,0.0,0.06557377049180328,0.2873652707836384,0.7430426233370361
21,177,10,208,0.10606060606060606,0.9519230769230769,0.28704059545896304,0.7491615044559171
52,168,15,235,0.23636363636363636,0.9361702127659575,0.2761639720823396,0.7429584153175262
49,93,10,152,0.34507042253521125,0.9342105263157895,0.28318569425209283,0.7350029205199261
9,49,7,65,0.15517241379310345,0.8923076923076924,0.22201984860348856,0.8053325908495965
48,176,6,230,0.21428571428571427,0.9739130434782609,0.2237205288755974,0.8194630256322052
2,11,53,66,0.15384615384615385,0.19696969696969696,0.17297127812634663,0.7072954313217538
7,6,2,15,0.5384615384615384,0.8666666666666667,0.24989435504942356,0.8217372736324486
27,56,5,88,0.3253012048192771,0.9431818181818182,0.2812144405863766,0.8204885223836973
5,57,3,65,0.08064516129032258,0.9538461538461539,0.25896894414733174,0.8230136568237254
54,85,3,142,0.38848920863309355,0.9788732394366197,0.26517162787560067,0.8293940444124155
26,96,472,594,0.21311475409836064,0.2053872053872054,0.27344910506206593,0.7312625462809172
4,46,9,59,0.08,0.847457627118644,0.2542654315926782,0.7131974868009721
27,60,20,107,0.3103448275862069,0.8130841121495327,0.2766223849841144,0.8012138318266627
2,0,0,2,1.0,1.0,0.3425564509181803,0.8202614508742817
13,3,1,17,0.8125,0.9411764705882353,0.4121562788011407,0.8199749726466272
16,87,2,105,0.1553398058252427,0.9809523809523809,0.4228269423061293,0.8238472908046596
50,77,23,150,0.3937007874015748,0.8466666666666667,0.42357145355876946,0.8049606375518091
27,32,4,63,0.4576271186440678,0.9365079365079365,0.4585017913510134,0.9094064562833423
9,20,2,31,0.3103448275862069,0.9354838709677419,0.4914081952919001,0.9219816339760705
3,19,2,24,0.13636363636363635,0.9166666666666666,0.4798489110850941,0.9352808719477029
40,58,19,117,0.40816326530612246,0.8376068376068376,0.3953008061288258,0.9120818487486797
28,81,2,111,0.25688073394495414,0.9819819819819819,0.33378376812096217,0.9179112075192151
1,0,0,1,1.0,1.0,0.43782103520170745,0.9209507211970266
37,81,3,121,0.3135593220338983,0.9752066115702479,0.42329319016538786,0.9398577881560416
171,219,25,415,0.43846153846153846,0.9397590361445783,0.4229765576453655,0.9403222309612761
30,51,26,107,0.37037037037037035,0.7570093457943925,0.4176855523543602,0.9154614971092434
2,31,7,40,0.06060606060606061,0.825,0.4068630415318494,0.9023662590140055
0,13,1,14,0.0,0.9285714285714286,0.3485540036309748,0.9153612005803754
6,9,1,16,0.4,0.9375,0.36899961306740986,0.9090066317258065
46,169,56,271,0.21395348837209302,0.7933579335793358,0.25670725426342317,0.8794863365228546
43,103,26,172,0.2945205479452055,0.8488372093023255,0.2539874293936099,0.8614335647702942
6,20,0,26,0.23076923076923078,1.0,0.2243170997232802,0.8700394167496402
14,41,71,126,0.2545454545454545,0.4365079365079365,0.2077706831768637,0.8242535011372893
6,43,3,52,0.12244897959183673,0.9423076923076923,0.2166053858891174,0.841011742895531
33,148,24,205,0.18232044198895028,0.8829268292682927,0.24265116331611034,0.834491085852226
44,121,3,168,0.26666666666666666,0.9821428571428571,0.22360354426849124,0.8408686368726342
55,88,7,150,0.38461538461538464,0.9533333333333334,0.24798381516039006,0.8637222654089196
38,68,11,117,0.3584905660377358,0.905982905982906,0.2571223891736087,0.8718859363632881
58,162,5,225,0.2636363636363636,0.9777777777777777,0.26181769386891335,0.8687113331886849
37,64,1,102,0.36633663366336633,0.9901960784313726,0.27778786231432934,0.9478096391777473
11,48,1,60,0.1864406779661017,0.9833333333333333,0.2869295335106529,0.9536704450385531
2,24,13,39,0.07692307692307693,0.6666666666666666,0.271872767072671,0.9227761360954637
50,110,4,164,0.3125,0.975609756097561,0.27842038612029,0.9218428359461356
26,89,25,140,0.22608695652173913,0.8214285714285714,0.25577346782119786,0.9029992985311697
56,70,15,141,0.4444444444444444,0.8936170212765957,0.2680525933078705,0.9012327435731253
23,85,2,110,0.21296296296296297,0.9818181818181818,0.26081353606881325,0.901809944150326
9,53,4,66,0.14516129032258066,0.9393939393939394,0.229217058448701,0.8945524957164069
14,106,12,132,0.11666666666666667,0.9090909090909091,0.21924934254878173,0.8839464351103464
14,34,1,49,0.2916666666666667,0.9795918367346939,0.2499269982264374,0.9286500308343502
26,72,1,99,0.2653061224489796,0.98989898989899,0.2431850157191488,0.9306913499488401
6,6,18,30,0.5,0.4,0.2823154505017575,0.870487268316187
18,71,7,96,0.20224719101123595,0.9270833333333334,0.247715842868442,0.8752681700385782
26,29,1,56,0.4727272727272727,0.9821428571428571,0.2848250299776291,0.8753145522278174
0,4,57,61,0.0,0.06557377049180328,0.26408770278868904,0.7504830995275122
19,179,10,208,0.09595959595959595,0.9519230769230769,0.26112954983053605,0.7566019806463934
53,168,14,235,0.2398190045248869,0.9404255319148936,0.2537227409531389,0.7510067942435648
53,95,4,152,0.3581081081081081,0.9736842105263158,0.26698016747587155,0.7486903971903256
9,54,2,65,0.14285714285714285,0.9692307692307692,0.21595975931260622,0.830009078509007
48,176,6,230,0.21428571428571427,0.9739130434782609,0.21767954835181744,0.8366990371011394
12,52,2,66,0.1875,0.9696969696969697,0.17693279510506418,0.8349210531802983
7,6,2,15,0.5384615384615384,0.8666666666666667,0.2538558720281411,0.9493628954909932
29,54,5,88,0.3493975903614458,0.9431818181818182,0.29006129979983397,0.9481141442422418
5,57,3,65,0.08064516129032258,0.9538461538461539,0.2673221793377533,0.9500313759467076
54,84,3,141,0.391304347826087,0.9787234042553191,0.2720644992974646,0.9507512607651367
26,97,471,594,0.21138211382113822,0.20707070707070707,0.2818537808637497,0.8418712518851278
5,45,9,59,0.1,0.847457627118644,0.26552725025150475,0.8238061924051826
26,61,20,107,0.2988505747126437,0.8130841121495327,0.2814344752104539,0.8014329270412629
2,0,0,2,1.0,1.0,0.3473685411445198,0.8204805460888819
11,5,1,17,0.6875,0.9411764705882353,0.39566888537859896,0.8201940678612273
19,84,2,105,0.18446601941747573,0.9809523809523809,0.4105004365396208,0.8240663860192597
53,76,21,150,0.4108527131782946,0.86,0.41329306016136474,0.8071058996970714
28,31,4,63,0.4745762711864407,0.9365079365079365,0.4508922254992651,0.9113112181881041
11,18,2,31,0.3793103448275862,0.9354838709677419,0.49079370333177746,0.9238863958808323
3,17,2,22,0.15,0.9090909090909091,0.48150514515526643,0.9318249054218276
28,54,32,114,0.34146341463414637,0.7192982456140351,0.38742849010300157,0.8917246547952612
26,68,2,96,0.2765957446808511,0.9791666666666666,0.32872788220026605,0.8971518256636085
1,0,0,1,1.0,1.0,0.4354782746649442,0.9017110961803257
36,67,3,106,0.34951456310679613,0.9716981132075472,0.4236655851329853,0.9209709076922448
165,180,31,376,0.4782608695652174,0.9175531914893617,0.42903457134205997,0.9182630869753057
29,44,25,98,0.3972602739726027,0.7448979591836735,0.42758498085137353,0.8916721550360275
3,24,7,34,0.1111111111111111,0.7941176470588235,0.422029425295818,0.8752474033171581
0,12,2,14,0.0,0.8571428571428571,0.37324893749093996,0.8949394906784184
1,9,1,11,0.1,0.9090909090909091,0.3480209739651041,0.884928668167596
46,136,60,242,0.25274725274725274,0.7520661157024794,0.24127058150042593,0.8495095418393787
42,94,21,157,0.3088235294117647,0.8662420382165605,0.23545757668685002,0.8344443882692377
6,15,4,25,0.2857142857142857,0.84,0.20795092185100264,0.8233653609136146
11,21,90,122,0.34375,0.26229508196721313,0.20030659699777367,0.7544220927398345
4,41,3,48,0.08888888888888889,0.9375,0.19713199382317045,0.7749052860171455
32,130,25,187,0.19753086419753085,0.8663101604278075,0.225350688708532,0.7762149007721384
42,89,3,134,0.32061068702290074,0.9776119402985075,0.256866501140375,0.786003619516081
47,89,7,143,0.34558823529411764,0.951048951048951,0.27012949864707003,0.8144297388512912
39,60,7,106,0.3939393939393939,0.9339622641509434,0.2822889078653027,0.8241040568419173
58,162,5,225,0.2636363636363636,0.9777777777777777,0.27913491899702814,0.8437865965244571
30,52,1,83,0.36585365853658536,0.9879518072289156,0.28229258450225464,0.9474518429904145
7,41,5,53,0.14583333333333334,0.9056603773584906,0.2904275051371753,0.9429033254701988
2,22,12,36,0.08333333333333333,0.6666666666666666,0.2741135721565756,0.9143828263614645
50,105,4,159,0.3225806451612903,0.9748427672955975,0.2743949947477741,0.9139872302181917
25,80,26,131,0.23809523809523808,0.8015267175572519,0.2590388522907913,0.8926269111479489
44,56,25,125,0.44,0.8,0.2656189388708779,0.8734894448406713
22,79,2,103,0.21782178217821782,0.9805825242718447,0.25907399866257136,0.8738901229112522
10,50,4,64,0.16666666666666666,0.9375,0.23061871410972584,0.86668272187855
11,97,12,120,0.10185185185185185,0.9,0.22433564532665703,0.8658740965416228
15,31,1,47,0.32608695652173914,0.9787234042553191,0.2590147343535722,0.910453630482859
25,69,1,95,0.26595744680851063,0.9894736842105263,0.25092570601746084,0.9125437614707058
5,6,18,29,0.45454545454545453,0.3793103448275862,0.28184716551034883,0.8522271367950394
17,52,11,80,0.2463768115942029,0.8625,0.2541867100238064,0.8611557082236108
28,23,1,52,0.5490196078431373,0.9807692307692307,0.3015006851187949,0.8611823805803802
0,3,57,60,0.0,0.05,0.27769116130927113,0.7343966662946659
15,155,10,180,0.08823529411764706,0.9444444444444444,0.27574593877581327,0.7407458726438723
57,128,15,200,0.3081081081081081,0.925,0.27317753185958027,0.733071100607398
49,82,8,139,0.37404580152671757,0.9424460431654677,0.28861872539075273,0.7263528661723898
9,47,7,63,0.16071428571428573,0.8888888888888888,0.24664284412915718,0.79914980103829
42,161,6,209,0.20689655172413793,0.9712918660287081,0.24100280700486218,0.8146914961852484
2,11,53,66,0.15384615384615385,0.19696969696969696,0.1845494564338645,0.7027201342138865
8,4,2,14,0.6666666666666666,0.8571428571428571,0.27978755167195973,0.818026256662866
25,46,5,76,0.352112676056338,0.9342105263157895,0.3174843205203442,0.8165642683587724
4,57,3,64,0.06557377049180328,0.953125,0.2828365580037292,0.8205821255016296
50,68,3,121,0.423728813559322,0.9752066115702479,0.2899341311512441,0.8252622067023125
22,68,414,504,0.24444444444444444,0.17857142857142858,0.30189558239840963,0.7237882837998182
3,41,9,53,0.06818181818181818,0.8301886792452831,0.28207919189236397,0.7036306856879003
22,60,20,102,0.2682926829268293,0.803921568627451,0.2984286960467462,0.7903380959247224
2,0,0,2,1.0,1.0,0.34604774366579377,0.8107462591900285
11,5,1,17,0.6875,0.9411764705882353,0.3939602185148883,0.8117413940860921
25,67,2,94,0.2717391304347826,0.9787234042553191,0.42341241279245684,0.8153983089797092
49,69,22,140,0.4152542372881356,0.8428571428571429,0.42220175903943025,0.7964912420206941
26,33,4,63,0.4406779661016949,0.9365079365079365,0.45023511927618026,0.9047678860116238
11,16,2,29,0.4074074074074074,0.9310344827586207,0.4986959177369787,0.9191744293706721
2,20,1,23,0.09090909090909091,0.9565217391304348,0.3820528513891547,0.9397516351093966
26,55,33,114,0.32098765432098764,0.7105263157894737,0.3564796591492958,0.89839825165075
26,68,2,96,0.2765957446808511,0.9791666666666666,0.29777905124656023,0.9038254225190974
1,0,0,1,1.0,1.0,0.41234765096367487,0.9092675993898457
38,65,3,106,0.36893203883495146,0.9716981132075472,0.4110589770964519,0.9271292346099713
167,177,32,376,0.48546511627906974,0.9148936170212766,0.4174571414075055,0.9240414746833057
30,42,26,98,0.4166666666666667,0.7346938775510204,0.4227937588130884,0.8953571899094884
1,25,7,33,0.038461538461538464,0.7878787878787878,0.415301251320581,0.8712653397306817
0,13,1,14,0.0,0.9285714285714286,0.3694458721318684,0.9024146415566753
1,9,1,11,0.1,0.9090909090909091,0.3442179086060325,0.8924038190458526
44,139,60,243,0.24043715846994534,0.7530864197530864,0.23570893124459616,0.8571304504391507
43,91,23,157,0.3208955223880597,0.8535031847133758,0.22884657175218304,0.8402454606542691
8,13,4,25,0.38095238095238093,0.84,0.2139161809912275,0.8295463725083725
11,19,92,122,0.36666666666666664,0.2459016393442623,0.20677332384837038,0.759718909907407
4,41,3,48,0.08888888888888889,0.9375,0.21397723105227756,0.7810933687818659
28,132,27,187,0.175,0.8556149732620321,0.23897723105227756,0.7706710180233806
41,90,3,134,0.31297709923664124,0.9776119402985075,0.2694025309432263,0.7804597367673233
43,93,7,143,0.3161764705882353,0.951048951048951,0.28022243267441055,0.8087400983810182
40,58,8,106,0.40816326530612246,0.9245283018867925,0.29268925309127664,0.8188865436915063
59,161,5,225,0.2681818181818182,0.9777777777777777,0.276579172695482,0.838569083374046
31,51,1,83,0.3780487804878049,0.9879518072289156,0.2782051889556446,0.9445762502147108
8,40,5,53,0.16666666666666666,0.9056603773584906,0.28931630006675574,0.9400277326944951
4,20,12,36,0.16666666666666666,0.6666666666666666,0.28812582387627955,0.9130351174665858
52,103,4,159,0.33548387096774196,0.9748427672955975,0.2913410769807225,0.9126395213233129
25,80,26,131,0.23809523809523808,0.8015267175572519,0.28018661519600857,0.8912792022530702
45,55,25,125,0.45,0.8,0.28616329158084824,0.8734894448406713
25,76,2,103,0.24752475247524752,0.9805825242718447,0.2832122821941953,0.8738901229112522
9,51,4,64,0.15,0.9375,0.25063388498165173,0.86668272187855
12,97,12,121,0.11009174311926606,0.9008264462809917,0.2425517530463088,0.8659921602960503
13,33,1,47,0.2826086956521739,0.9787234042553191,0.2591149000442384,0.9105716942372863
25,69,1,95,0.26595744680851063,0.9894736842105263,0.2491825537357768,0.9126618252251333
6,4,19,29,0.6,0.3448275862068966,0.30088323400788564,0.8474190921750825
18,51,11,80,0.2608695652173913,0.8625,0.27386460046751293,0.856347663603654
27,25,1,53,0.5192307692307693,0.9811320754716981,0.31267974571830176,0.8564261709179187
0,3,57,60,0.0,0.05,0.2912511742897304,0.7296404566322046
18,151,10,179,0.10650887573964497,0.9441340782122905,0.29073933609264163,0.7358272611938185
59,126,15,200,0.31891891891891894,0.925,0.2959265108450338,0.7281524891573443
52,83,3,138,0.3851851851851852,0.9782608695652174,0.3129590448988444,0.7265506584937288
7,49,7,63,0.125,0.8888888888888888,0.24510190204170157,0.8042737017340134
47,156,6,209,0.2315270935960591,0.9712918660287081,0.24091012038151124,0.8198153968809717
2,10,54,66,0.16666666666666666,0.18181818181818182,0.1905438200152109,0.7056276977876124
8,4,2,14,0.6666666666666666,0.8571428571428571,0.2857819152533061,0.8209338202365918
27,44,5,76,0.38028169014084506,0.9342105263157895,0.32489231731062035,0.8195161699656631
5,56,3,64,0.08196721311475409,0.953125,0.29104207362431117,0.8235340271085203
49,70,3,122,0.4117647058823529,0.9754098360655737,0.2948391480096208,0.8231267366085712
23,68,413,504,0.25274725274725274,0.18055555555555555,0.31308875554494264,0.7219362604180949
3,41,9,53,0.06818181818181818,0.8301886792452831,0.289753716200051,0.7017786623061771
24,59,20,103,0.2891566265060241,0.8058252427184466,0.3072522818913878,0.790922528149072
2,0,0,2,1.0,1.0,0.3548713295104355,0.8113306914143782
11,5,1,17,0.6875,0.9411764705882353,0.3987596594903148,0.8123258263104419
23,68,3,94,0.25274725274725274,0.9680851063829787,0.42315680800924316,0.8144629843651531
51,67,23,141,0.4322033898305085,0.8368794326241135,0.42607662000183677,0.7946729267306588
26,33,4,63,0.4406779661016949,0.9365079365079365,0.4529238647667571,0.9026661240095704
11,16,2,29,0.4074074074074074,0.9310344827586207,0.5013846632275556,0.9170726673686186
3,20,1,24,0.13043478260869565,0.9583333333333334,0.46800777228434703,0.9400104342812393
33,55,29,117,0.375,0.7521367521367521,0.37872205799863273,0.9046013988722038
24,86,2,112,0.21818181818181817,0.9821428571428571,0.3116766034531781,0.9104537398085785
1,0,0,1,1.0,1.0,0.4234163488562899,0.9158959166793268
34,85,3,122,0.2857142857142857,0.9754098360655737,0.4091145651506817,0.9342877980220277
165,220,30,415,0.42857142857142855,0.927710843373494,0.4073850597892151,0.933031070431393
27,54,25,106,0.3333333333333333,0.7641509433962265,0.3958908069156518,0.9085549379211766
1,32,7,40,0.030303030303030304,0.825,0.3815862708719853,0.8895073188735575
0,13,1,14,0.0,0.9285714285714286,0.3280148423005568,0.9147122726499398
3,12,1,16,0.2,0.9375,0.3254174397031542,0.9083347216295318
41,170,60,271,0.1943127962085308,0.7785977859778598,0.21031926773294427,0.8767058339120831
42,108,22,172,0.28,0.872093023255814,0.2095029412023321,0.8619462892249745
5,17,4,26,0.22727272727272727,0.8461538461538461,0.18074598387394616,0.8502952896221677
8,18,100,126,0.3076923076923077,0.20634920634920634,0.17708298021094254,0.770609327186879
4,45,3,52,0.08163265306122448,0.9423076923076923,0.18441578346211313,0.7873675689451209
19,158,28,205,0.10734463276836158,0.8634146341463415,0.1997507310004505,0.7780594554558228
44,121,3,168,0.26666666666666666,0.9821428571428571,0.20927454052426,0.7844370064762308
45,98,7,150,0.3146853146853147,0.9533333333333334,0.226470614592372,0.8093992275270129
43,64,10,117,0.40186915887850466,0.9145299145299145,0.24388049443215837,0.81546164056617
58,162,5,225,0.2636363636363636,0.9777777777777777,0.24907529962696356,0.8342650593695888
37,65,1,103,0.3627450980392157,0.9902912621359223,0.2569399839622361,0.9462567816248341
10,45,5,60,0.18181818181818182,0.9166666666666666,0.27125220235608716,0.9425937779618303
3,23,13,39,0.11538461538461539,0.6666666666666666,0.2724007713012663,0.914486925464734
49,110,4,163,0.3081761006289308,0.9754601226993865,0.27833069043873254,0.9135322491156668
27,87,26,140,0.23684210526315788,0.8142857142857143,0.26721023194985305,0.8936683035374353
45,71,25,141,0.3879310344827586,0.8226950354609929,0.2652190713218893,0.880549035099018
15,93,2,110,0.1388888888888889,0.9818181818181818,0.2473980035008215,0.8811262356762187
6,56,4,66,0.0967741935483871,0.9393939393939394,0.20940216000213172,0.873855189570221
13,108,12,133,0.10743801652892562,0.9097744360902256,0.19877642210366653,0.872870585202158
13,36,1,50,0.2653061224489796,0.98,0.22019378025571856,0.9176324899640628
24,74,1,99,0.24489795918367346,0.98989898989899,0.21115404576353897,0.9196951852782919
7,6,17,30,0.5384615384615384,0.43333333333333335,0.25424253622045045,0.8652734165708089
19,66,11,96,0.2235294117647059,0.8854166666666666,0.23075659011787147,0.8742336496001909
26,29,2,57,0.4727272727272727,0.9649122807017544,0.27844778780906915,0.8718185208692726
0,4,57,61,0.0,0.06557377049180328,0.2646229030164425,0.7469870681689674
17,181,10,208,0.08585858585858586,0.9519230769230769,0.2615401272063939,0.7530083025736606
50,170,14,234,0.22727272727272727,0.9401709401709402,0.2561067850383579,0.7473184368837948
43,95,13,151,0.3115942028985507,0.9139072847682119,0.2656348198547689,0.7364624790079695
8,50,7,65,0.13793103448275862,0.8923076923076924,0.2084161764292289,0.8020302445757349
43,179,6,228,0.19369369369369369,0.9736842105263158,0.20415393099051288,0.8146398936985418
2,8,56,66,0.2,0.15151515151515152,0.1651928920294739,0.6984403038147416
8,5,2,15,0.6153846153846154,0.8666666666666667,0.25310497994156184,0.8128821461254363
25,58,5,88,0.30120481927710846,0.9431818181818182,0.28386872757277937,0.8116333948766851
3,59,3,65,0.04838709677419355,0.9538461538461539,0.2583136375015603,0.813586996830287
49,91,3,143,0.35,0.9790209790209791,0.26380017994462446,0.822888953152111
19,98,477,594,0.1623931623931624,0.19696969696969696,0.2672947696461107,0.7235549538181116
4,46,9,59,0.08,0.847457627118644,0.2510528134041545,0.7055225847598728
24,63,20,107,0.27586206896551724,0.8130841121495327,0.2618902518277998,0.80003243627907
1,1,0,2,0.5,1.0,0.24540673534428326,0.8190800553266891
11,5,1,17,0.6875,0.9411764705882353,0.30059176116183917,0.8187935770990344
20,81,4,105,0.19801980198019803,0.9619047619047619,0.3219678619055541,0.8199448068216927
48,79,23,150,0.3779527559055118,0.8466666666666667,0.3259611127491987,0.8010370479139338
26,33,4,63,0.4406779661016949,0.9365079365079365,0.36571608470756045,0.9066853678479682
11,18,2,31,0.3793103448275862,0.9354838709677419,0.40847470539721564,0.9192605455406964
2,21,1,24,0.08695652173913043,0.9583333333333334,0.45059917795026916,0.9400104342812393
33,55,29,117,0.375,0.7521367521367521,0.36131346366455486,0.9046013988722038
22,88,2,112,0.2,0.9821428571428571,0.30059917795026914,0.9104537398085785
1,0,0,1,1.0,1.0,0.4095100690393781,0.9158959166793268
36,83,3,122,0.3025210084033613,0.9754098360655737,0.3953595269327716,0.9342877980220277
168,216,31,415,0.4375,0.9253012048192771,0.3973268392814399,0.9326868363522192
25,56,25,106,0.30864197530864196,0.7641509433962265,0.38723135792159075,0.9082107038420028
1,32,7,40,0.030303030303030304,0.825,0.37913800200214787,0.8891630847943837
0,12,2,14,0.0,0.8571428571428571,0.32556657343071926,0.904163956938113
3,12,1,16,0.2,0.9375,0.32556657343071926,0.8977864059177048
41,170,60,271,0.1943127962085308,0.7785977859778598,0.21046840146050938,0.8661575182002561
41,109,22,172,0.2733333333333333,0.872093023255814,0.20629873359336254,0.8513979735131477
4,18,4,26,0.18181818181818182,0.8461538461538461,0.16977275956738852,0.8400912079895146
8,18,100,126,0.3076923076923077,0.20634920634920634,0.16963709276505504,0.7604052455542261
5,44,3,52,0.10204081632653061,0.9423076923076923,0.1798853479112694,0.7771634873124678
22,156,28,206,0.12359550561797752,0.8640776699029126,0.1975418487138376,0.7781541748496185
42,123,3,168,0.2545454545454545,0.9821428571428571,0.2053340565060454,0.7845317258700267
46,97,7,150,0.32167832167832167,0.9533333333333334,0.22352913157315837,0.8094939469208088
43,68,6,117,0.38738738738738737,0.9487179487179487,0.23982256786659464,0.8204403648439708
58,162,5,225,0.2636363636363636,0.9777777777777777,0.25151087955490636,0.8392437836473896
36,66,1,103,0.35294117647058826,0.9902912621359223,0.2579750036660893,0.9512355059026347
9,46,5,60,0.16363636363636364,0.9166666666666666,0.266774367567494,0.9475725022396311
3,23,13,39,0.11538461538461539,0.6666666666666666,0.26560138324844224,0.9193709303487388
47,112,4,163,0.29559748427672955,0.9754601226993865,0.27146595892433867,0.9184162539996715
27,87,26,140,0.23684210526315788,0.8142857142857143,0.25934649943645816,0.8985523084214402
43,73,25,141,0.3706896551724138,0.8226950354609929,0.25696110912003334,0.880549035099018
16,92,2,110,0.14814814814814814,0.9818181818181818,0.24046279262171685,0.8811262356762185
7,55,4,66,0.11290322580645161,0.9393939393939394,0.20617165681255448,0.873855189570221
13,108,12,133,0.10743801652892562,0.9097744360902256,0.1981433215114919,0.872870585202158
14,35,1,50,0.2857142857142857,0.98,0.22247613155858767,0.9176324899640628
24,74,1,99,0.24489795918367346,0.98989898989899,0.21523334225957963,0.919695185278292
6,8,16,30,0.42857142857142855,0.4666666666666667,0.2426232455893326,0.8700353213327138
19,65,12,96,0.2261904761904762,0.875,0.2219805057347701,0.8775074591240004
25,30,2,57,0.45454545454545453,0.9649122807017544,0.26575154950581387,0.8750923303930822
0,4,57,61,0.0,0.06557377049180328,0.24962251724774934,0.750260877692777
17,181,10,208,0.08585858585858586,0.9519230769230769,0.2465397414377008,0.75628211209747
48,171,15,234,0.2191780821917808,0.9358974358974359,0.2370345695059144,0.7499817457971039
41,98,13,152,0.2949640287769784,0.9144736842105263,0.2441868651621008,0.7392067021273231
8,50,7,65,0.13793103448275862,0.8923076923076924,0.20266680886371938,0.8000125629331841
42,180,6,228,0.1891891891891892,0.9736842105263158,0.1973809107206784,0.8141103072940864
1,9,56,66,0.1,0.15151515151515152,0.14673156007132773,0.6979107174102859
8,4,3,15,0.6666666666666666,0.8,0.241969655309423,0.802828750197171
28,55,5,88,0.3373493975903614,0.9431818181818182,0.2778969141282481,0.8015799989484199
6,56,3,65,0.0967741935483871,0.9538461538461539,0.26041064432204897,0.8041441015125225
47,93,3,143,0.3357142857142857,0.9790209790209791,0.2662321095988071,0.8133651436283015
19,98,477,594,0.1623931623931624,0.19696969696969696,0.2697266993002934,0.714031144294302
3,47,9,59,0.06,0.847457627118644,0.25127110084469495,0.6959987752360632
21,66,20,107,0.2413793103448276,0.8130841121495327,0.27146814517967033,0.7905086267552607
2,0,0,2,1.0,1.0,0.31908719279871794,0.8190800553266891
11,5,1,17,0.6875,0.9411764705882353,0.36910870742866625,0.8187935770990344
22,79,4,105,0.21782178217821782,0.9619047619047619,0.3864012200900707,0.8199448068216927
49,78,23,150,0.3858267716535433,0.8466666666666667,0.39356014665282174,0.8010370479139338
26,33,4,63,0.4406779661016949,0.9365079365079365,0.43331511861118355,0.9066853678479682
12,17,2,31,0.41379310344827586,0.9354838709677419,0.4838569905323658,0.9192605455406964
2,21,1,24,0.08695652173913043,0.9583333333333334,0.44030492871230476,0.9400104342812393
33,55,29,117,0.375,0.7521367521367521,0.3510192144265905,0.9046013988722038
21,89,2,112,0.19090909090909092,0.9821428571428571,0.2890062274136035,0.9104537398085785
1,0,0,1,1.0,1.0,0.4021603999737166,0.9158959166793268
34,85,3,122,0.2857142857142857,0.9754098360655737,0.38673375687553246,0.9342877980220277
163,219,33,415,0.42670157068062825,0.9204819277108434,0.3871584364642905,0.9319983681938716
28,53,25,106,0.345679012345679,0.7641509433962265,0.38728006876983084,0.907522235683655
1,32,7,40,0.030303030303030304,0.825,0.3791867128503879,0.888474616636036
0,12,2,14,0.0,0.8571428571428571,0.32561528427895936,0.9034754887797652
2,13,1,16,0.13333333333333333,0.9375,0.3173901760538511,0.8970979377593571
42,169,60,271,0.1990521327014218,0.7785977859778598,0.20296905215405428,0.8654690500419085
44,106,22,172,0.29333333333333333,0.872093023255814,0.20405748752820393,0.8507095053547999
4,18,4,26,0.18181818181818182,0.8461538461538461,0.16907414626214015,0.8400912079895146
13,20,93,126,0.3939393939393939,0.2619047619047619,0.17596848648981372,0.7683417534907341
6,43,3,52,0.12244897959183673,0.9423076923076923,0.18913219353107177,0.7850999952489757
18,161,27,206,0.1005586592178771,0.8689320388349514,0.2034977162764828,0.7867841640621321
43,122,3,168,0.2606060606060606,0.9821428571428571,0.221679534458301,0.7931617150825403
42,101,7,150,0.2937062937062937,0.9533333333333334,0.23520155745899698,0.8181239361333221
43,69,5,117,0.38392857142857145,0.9572649572649573,0.24814373432974526,0.8302913552774855
58,162,5,225,0.2636363636363636,0.9777777777777777,0.25983204601805693,0.8490947740809043
36,66,1,103,0.35294117647058826,0.9902912621359223,0.25397515780822755,0.9531499883996416
10,49,1,60,0.1694915254237288,0.9833333333333333,0.2606955214984979,0.9590107942604474
3,23,13,39,0.11538461538461539,0.6666666666666666,0.26281351523660335,0.9301157410935496
48,111,4,163,0.3018867924528302,0.9754601226993865,0.2687107626432847,0.9291610647444823
26,88,26,140,0.22807017543859648,0.8142857142857143,0.2593341743193279,0.909297119166251
46,71,24,141,0.39316239316239315,0.8297872340425532,0.26065329170987395,0.8910860158487647
13,95,2,110,0.12037037037037036,0.9818181818181818,0.24018672124330345,0.8916632164259654
8,54,4,66,0.12903225806451613,0.9393939393939394,0.20819973289957883,0.8843921703199678
13,108,12,133,0.10743801652892562,0.9097744360902256,0.19933494591460696,0.8738837564280953
15,34,1,50,0.30612244897959184,0.98,0.2265832078567465,0.91864566119
28,70,1,99,0.2857142857142857,0.98989898989899,0.22427284975124012,0.920708356504229
6,6,18,30,0.5,0.4,0.26311996754572636,0.8615246830348413
19,66,11,96,0.2235294117647059,0.8854166666666666,0.23888668448891387,0.8694717448382862
27,29,1,57,0.48214285714285715,0.9824561403508771,0.2905684683135549,0.8695628817715282
0,4,57,61,0.0,0.06557377049180328,0.2721352885900526,0.744731429071223
17,181,10,208,0.08585858585858586,0.9519230769230769,0.269052512780004,0.7507526634759161
51,168,15,234,0.2328767123287671,0.9358974358974359,0.25858883611560046,0.7444522971755498
50,99,3,152,0.33557046979865773,0.9802631578947368,0.2657111481276536,0.7430757497463709
8,50,7,65,0.13793103448275862,0.8923076923076924,0.21398701019661912,0.8134054200760411
47,175,6,228,0.21171171171171171,0.9736842105263158,0.21229876733190567,0.8260150691988482
3,10,53,66,0.23076923076923078,0.19696969696969696,0.17638824927853047,0.7138027201443939
8,5,2,15,0.6153846153846154,0.8666666666666667,0.2643003371906184,0.8282445624550886
26,57,5,88,0.3132530120481928,0.9431818181818182,0.2967852552177051,0.8269958112063375
3,59,3,65,0.04838709677419355,0.9538461538461539,0.27042959585276605,0.82955991377044
48,92,3,143,0.34285714285714286,0.9790209790209791,0.2714705491468353,0.8293824596456174
21,98,475,594,0.17647058823529413,0.20033670033670034,0.2769761996829118,0.7305294607926186
3,47,9,59,0.06,0.847457627118644,0.25530309800981016,0.7124970917343798
22,65,20,107,0.25287356321839083,0.8130841121495327,0.25846085978826155,0.8005134367600706
2,0,0,2,1.0,1.0,0.3134059147333165,0.8195610558076896
10,6,1,17,0.625,0.9411764705882353,0.3579411987264319,0.8192745775800349
24,77,4,105,0.2376237623762376,0.9619047619047619,0.3849750080981525,0.8204258073026932
51,76,23,150,0.4015748031496063,0.8466666666666667,0.39336324528279004,0.8015180483949342
25,34,4,63,0.423728813559322,0.9365079365079365,0.4286858489005083,0.9066853678479682
11,18,2,31,0.3793103448275862,0.9354838709677419,0.47430161244730634,0.9192605455406964
1,22,1,24,0.043478260869565216,0.9583333333333334,0.43885005203691635,0.9390580533288583
32,56,29,117,0.36363636363636365,0.7521367521367521,0.3479409611278254,0.9036490179198228
19,91,2,112,0.17272727272727273,0.9821428571428571,0.2744020000888644,0.9095013588561974
1,0,0,1,1.0,1.0,0.3875561726489775,0.9149435357269458
34,85,3,122,0.2857142857142857,0.9754098360655737,0.37621830416825197,0.9342877980220275
161,221,33,415,0.4214659685863874,0.9204819277108434,0.37105242558858326,0.9319983681938716
28,53,25,106,0.345679012345679,0.7641509433962265,0.3761001662685079,0.9075222356836551
1,32,7,40,0.030303030303030304,0.825,0.37421799047328863,0.8884746166360359
0,12,2,14,0.0,0.8571428571428571,0.32226993852523667,0.9034754887797654
3,12,1,16,0.2,0.9375,0.3261660424213405,0.8970979377593571
41,170,60,271,0.1943127962085308,0.7785977859778598,0.21106787045113065,0.8654690500419084
42,108,22,172,0.28,0.872093023255814,0.21025154392051842,0.8507095053547999
4,18,4,26,0.18181818181818182,0.8461538461538461,0.17601614581077477,0.8400912079895146
10,23,93,126,0.30303030303030304,0.2619047619047619,0.16992347305143538,0.768341753490734
5,44,3,52,0.10204081632653061,0.9423076923076923,0.18017172819764968,0.7850999952489758
19,160,27,206,0.10614525139664804,0.8689320388349514,0.195335335540028,0.786784164062132
43,122,3,168,0.2606060606060606,0.9821428571428571,0.20399334419803664,0.7931617150825402
37,106,7,150,0.25874125874125875,0.9533333333333334,0.2131974102741406,0.8181239361333221
40,70,7,117,0.36363636363636365,0.9401709401709402,0.2251454622221926,0.827849352835483
58,162,5,225,0.2636363636363636,0.9777777777777777,0.23683377391050423,0.8466527716389018
35,67,1,103,0.3431372549019608,0.9902912621359223,0.2425633384635982,0.9507079859576392
7,48,5,60,0.12727272727272726,0.9166666666666666,0.2461678971701977,0.9470449822946353
4,22,13,39,0.15384615384615385,0.6666666666666666,0.25298231180584146,0.9181499291277376
48,111,4,163,0.3018867924528302,0.9754601226993865,0.25887955921252276,0.9171952527786704
26,88,26,140,0.22807017543859648,0.8142857142857143,0.25449797588357104,0.8973313072004391
45,74,22,141,0.37815126050420167,0.8439716312056738,0.25657153257897647,0.8835885487768296
10,98,2,110,0.09259259259259259,0.9818181818181818,0.23213670814415205,0.8841657493540301
8,54,4,66,0.12903225806451613,0.9393939393939394,0.20155028002451708,0.8768947032480325
13,108,12,133,0.10743801652892562,0.9097744360902256,0.1987167499182597,0.8759100988799696
16,33,1,50,0.32653061224489793,0.98,0.22338595826093743,0.9206720036418743
28,70,1,99,0.2857142857142857,0.98989898989899,0.22107560015543107,0.9227346989561033
10,17,3,30,0.37037037037037035,0.9,0.24140419943139876,0.9349795969152871
19,65,12,96,0.2261904761904762,0.875,0.21969551595800943,0.9394122210287623
27,29,1,57,0.48214285714285715,0.9824561403508771,0.27534555375090436,0.9395033579620045
0,4,57,61,0.0,0.06557377049180328,0.2569123740274021,0.8146719052616993
14,184,10,208,0.0707070707070707,0.9519230769230769,0.25166509605285137,0.8206931396663923
51,168,15,234,0.2328767123287671,0.9358974358974359,0.23828596749340408,0.814392773366026
48,100,4,152,0.32432432432432434,0.9736842105263158,0.24380168729483817,0.8120763763127868
7,51,7,65,0.1206896551724138,0.8923076923076924,0.2081330136951301,0.8109774752138857
45,177,6,228,0.20270270270270271,0.9736842105263158,0.20477761748259105,0.825075219574788
2,9,55,66,0.18181818181818182,0.16666666666666666,0.16187409243620884,0.7085338661913294
8,5,2,15,0.6153846153846154,0.8666666666666667,0.24978618034829678,0.8229757085020241
25,58,5,88,0.30120481927710846,0.9431818181818182,0.2827144301440164,0.8217269572532729
2,60,3,65,0.03225806451612903,0.9538461538461539,0.25405462331363954,0.8242910598173755
47,93,3,143,0.3357142857142857,0.9790209790209791,0.2556817606550626,0.8250534553166132
22,99,474,595,0.18181818181818182,0.20336134453781513,0.26441440731874377,0.7266325484923449
3,47,9,59,0.06,0.847457627118644,0.24402830693264338,0.7086001794341061
24,63,20,107,0.27586206896551724,0.8130841121495327,0.25746314795369135,0.8009455287888011
2,0,0,2,1.0,1.0,0.31240820289874627,0.8199931478364204
10,6,1,17,0.625,0.9411764705882353,0.3586646572877307,0.8197066696087656
21,80,4,105,0.2079207920792079,0.9619047619047619,0.3837593326538849,0.8208578993314238
50,77,23,150,0.3937007874015748,0.8466666666666667,0.39204311860921187,0.801950140423665
25,34,4,63,0.423728813559322,0.9365079365079365,0.4266017802865177,0.9066853678479682
10,19,2,31,0.3448275862068966,0.9354838709677419,0.4672914354589315,0.9192605455406964
1,22,1,24,0.043478260869565216,0.9583333333333334,0.44687354004701924,0.9367070998285347
32,58,27,117,0.35555555555555557,0.7692307692307693,0.35481004798352717,0.9037400668615018
24,86,2,112,0.21818181818181817,0.9821428571428571,0.28776459343807265,0.9095924077978763
0,1,0,1,0.0,1.0,0.25760586327934254,0.9156714351534994
35,84,3,122,0.29411764705882354,0.9754098360655737,0.24297242369661287,0.9357967868627644
148,235,32,415,0.38642297650130547,0.9228915662650602,0.2330127987857718,0.9341489778280304
27,54,25,106,0.3333333333333333,0.7641509433962265,0.2330127987857718,0.9103084722048314
1,32,7,40,0.030303030303030304,0.825,0.23113062299055254,0.8912608531572123
0,13,1,14,0.0,0.9285714285714286,0.18033697219690173,0.914023804491592
3,12,1,16,0.2,0.9375,0.17773956959949913,0.907646253471184
39,175,56,270,0.1822429906542056,0.7925925925925926,0.20377428255009994,0.8780166238415543
43,107,22,172,0.2866666666666667,0.872093023255814,0.20270985677979184,0.8632570791544458
4,22,0,26,0.15384615384615385,1.0,0.16948459640048444,0.8742725696880088
16,43,67,126,0.2711864406779661,0.46825396825396826,0.1606064688782891,0.8320015732391146
5,44,3,52,0.10204081632653061,0.9423076923076923,0.17085472402450347,0.8487598149973563
21,158,27,206,0.11731843575418995,0.8689320388349514,0.1876145005608163,0.8402399021778597
46,119,3,168,0.2787878787878788,0.9821428571428571,0.19886991181622757,0.8466174531982679
39,104,7,150,0.2727272727272727,0.9533333333333334,0.21179623782666573,0.8695804161612308
40,70,7,117,0.36363636363636365,0.9401709401709402,0.2227919088223367,0.8793058328633917
57,163,5,225,0.2590909090909091,0.9777777777777777,0.23782687385730175,0.8761312296887885
34,68,1,103,0.3333333333333333,0.9902912621359223,0.24670500137949708,0.9507079859576392
8,51,1,60,0.13559322033898305,0.9833333333333333,0.25149820195270456,0.956568791818445
3,23,13,39,0.11538461538461539,0.6666666666666666,0.2512219418999082,0.9276737386515472
47,112,4,163,0.29559748427672955,0.9754601226993865,0.25362331411260114,0.9267190623024798
25,90,25,140,0.21739130434782608,0.8214285714285714,0.24571817577268024,0.9078755248875139
47,73,21,141,0.39166666666666666,0.851063829787234,0.24972250477700922,0.8951459376898415
10,97,3,110,0.09345794392523364,0.9727272727272728,0.22606065261048416,0.8944244369683408
8,54,4,66,0.12903225806451613,0.9393939393939394,0.19687478471493883,0.8871533908623432
12,108,12,132,0.1,0.9090909090909091,0.19179003895222696,0.8765473302562826
14,35,1,50,0.2857142857142857,0.98,0.21612284899932271,0.9213092350181876
28,70,1,99,0.2857142857142857,0.98989898989899,0.21471096349040217,0.9233719303324166
10,17,3,30,0.37037037037037035,0.9,0.23656511577933706,0.9345964201283349
19,71,6,96,0.2111111111111111,0.9375,0.21077146498568627,0.9469444444444444
27,29,1,57,0.48214285714285715,0.9824561403508771,0.2662978811596325,0.9483342826763879
0,4,57,61,0.0,0.06557377049180328,0.24786470143613018,0.8235028299760827
14,184,10,208,0.0707070707070707,0.9519230769230769,0.243679997251426,0.8296217110949637
52,169,13,234,0.23529411764705882,0.9444444444444444,0.236477116098965,0.8245423460155986
48,100,4,152,0.32432432432432434,0.9736842105263158,0.2419928359003991,0.8222259489623596
6,52,7,65,0.10344827586206896,0.8923076923076924,0.2038611081134989,0.8211270478634585
44,179,6,229,0.19730941704035873,0.9737991266375546,0.20188943753196287,0.826312637383109
10,54,2,66,0.15625,0.9696969696969697,0.15533331508298326,0.8244898987182652
8,5,2,15,0.6153846153846154,0.8666666666666667,0.2432454029950712,0.93893174102896
25,58,5,88,0.30120481927710846,0.9431818181818182,0.27617365279079087,0.9376829897802087
3,59,3,65,0.04838709677419355,0.9538461538461539,0.24947264980895295,0.93902609112331
49,90,3,142,0.35251798561151076,0.9788732394366197,0.25350031570712245,0.9397673809676392
22,101,472,595,0.17886178861788618,0.20672268907563024,0.2642736746722392,0.8418266662202017
3,47,9,59,0.06,0.847457627118644,0.24465804366647367,0.8237778805746431
23,64,20,107,0.26436781609195403,0.8130841121495327,0.26010344596532425,0.8014046152107236
2,0,0,2,1.0,1.0,0.3150485009103792,0.8204522342583426
11,5,1,17,0.6875,0.9411764705882353,0.37023352672793514,0.8201657560306879
21,80,4,105,0.2079207920792079,0.9619047619047619,0.3930240546286515,0.8213169857533461
46,80,24,150,0.36507936507936506,0.84,0.3948185374097735,0.8014779515481146
27,32,4,63,0.4576271186440678,0.9365079365079365,0.4346421559849424,0.905732986895587
9,20,2,31,0.3103448275862069,0.9354838709677419,0.4704057027829719,0.9183081645883153
1,20,1,22,0.047619047619047616,0.9545454545454546,0.45954890278198574,0.9371937235165974
31,55,28,114,0.36046511627906974,0.7543859649122807,0.3681867765361385,0.9021060042183516
18,76,2,96,0.19148936170212766,0.9791666666666666,0.2883995424935853,0.907533175086699
0,1,0,1,0.0,1.0,0.25982811392215677,0.9136122024423221
36,66,3,105,0.35294117647058826,0.9714285714285714,0.251640223381325,0.9321410528313986
154,187,36,377,0.45161290322580644,0.9045092838196287,0.25349971080957306,0.9278672034473174
27,45,25,97,0.375,0.7422680412371134,0.25416108647094876,0.9009005689442449
1,25,7,33,0.038461538461538464,0.7878787878787878,0.25285287087701885,0.877091045134721
0,12,2,14,0.0,0.8571428571428571,0.2013578542657232,0.8917706011676607
1,8,2,11,0.1111111111111111,0.8181818181818182,0.18987524703843509,0.8687727656698251
39,143,60,242,0.21428571428571427,0.7520661157024794,0.2204874919363943,0.8333536393416079
41,93,22,156,0.30597014925373134,0.8589743589743589,0.21377734519112898,0.8172887518481489
4,21,0,25,0.16,1.0,0.17211835901601383,0.8309302827310593
10,22,90,122,0.3125,0.26229508196721313,0.16318978758744238,0.7623627171210734
3,42,3,48,0.06666666666666667,0.9375,0.1672190916167464,0.7837371759955323
16,146,25,187,0.09876543209876543,0.8663101604278075,0.18132843905942717,0.7850467907505252
40,91,3,134,0.3053435114503817,0.9776119402985075,0.20907592482218013,0.8078225224814809
39,97,7,143,0.2867647058823529,0.951048951048951,0.21943006647884275,0.836248641816691
38,58,10,106,0.3958333333333333,0.9056603773584906,0.2322676642045002,0.8429180730144241
57,163,5,225,0.2590909090909091,0.9777777777777777,0.24642350836034435,0.839743469839821
26,56,1,83,0.3170731707317073,0.9879518072289156,0.24707681846487395,0.9434087163057784
6,42,5,53,0.125,0.9056603773584906,0.2554101517982073,0.9388601987855629
3,21,12,36,0.125,0.6666666666666666,0.2591579472126694,0.9103396996768284
47,108,4,159,0.3032258064516129,0.9748427672955975,0.258855417927131,0.9099441035335555
23,82,26,131,0.21904761904761905,0.8015267175572519,0.24918154837931186,0.8885837844633128
38,67,19,124,0.3619047619047619,0.8467741935483871,0.24433460960380168,0.8801714724904409
9,92,2,103,0.0891089108910891,0.9805825242718447,0.22005146700382738,0.880572150561022
9,51,4,64,0.15,0.9375,0.19618387118501207,0.8733647495283198
11,97,12,120,0.10185185185185185,0.9,0.19287699287813376,0.8725561241913924
15,31,1,47,0.32608695652173914,0.9787234042553191,0.2216037009526679,0.9171356581326285
25,69,1,95,0.26595744680851063,0.9894736842105263,0.21627964957508186,0.9192257891204755
10,16,3,29,0.38461538461538464,0.896551724137931,0.2399321875133341,0.9328007900605726
17,51,12,80,0.25,0.85,0.22394579295551095,0.93326161955366
26,26,1,53,0.5,0.9811320754716981,0.28264451997106965,0.9333401268679247
0,2,57,59,0.0,0.03389830508474576,0.26121594854249824,0.80425417045146
14,155,10,179,0.08284023668639054,0.9441340782122905,0.25850000351886093,0.8105590387675015
49,135,15,199,0.266304347826087,0.9246231155778895,0.24995963084805345,0.8028304260992972
50,86,3,139,0.36764705882352944,0.9784172661870504,0.2644867182787704,0.8012509378102292
6,50,7,63,0.10714285714285714,0.8888888888888888,0.2248477857826951,0.800156247060366
40,167,6,213,0.1932367149758454,0.971830985915493,0.21673874506495872,0.8175606736197222
4,17,45,66,0.19047619047619047,0.3181818181818182,0.1725210579901288,0.7228534940068823
8,4,2,14,0.6666666666666666,0.8571428571428571,0.267759153228224,0.8404598585866124
24,47,5,76,0.3380281690140845,0.9342105263157895,0.3042145721321803,0.8390422083156837
2,59,3,64,0.03278688524590164,0.953125,0.27085493462072524,0.8431139060902709
46,72,3,121,0.3898305084745763,0.9752066115702479,0.27402399885658907,0.8426552411450133
19,74,412,505,0.20430107526881722,0.18415841584158416,0.2879037443031548,0.7419794592811126
1,43,9,53,0.022727272727272728,0.8301886792452831,0.2635452525533587,0.7217448440425113
21,60,20,101,0.25925925925925924,0.801980198019802,0.2733714052366542,0.7908588983050804
2,0,0,2,1.0,1.0,0.3209904528557019,0.8112670615703864
11,5,1,17,0.6875,0.9411764705882353,0.37091500013940404,0.8122621964664501
19,71,4,94,0.2111111111111111,0.9574468085106383,0.3963898895487197,0.8128795976822557
46,70,23,139,0.39655172413793105,0.8345323741007195,0.39735006321491323,0.7927832780437516
26,31,4,61,0.45614035087719296,0.9344262295081968,0.4333271025875383,0.8999643942818392
9,18,2,29,0.3333333333333333,0.9310344827586207,0.47769939695983277,0.9143709376408874
2,19,1,22,0.09523809523809523,0.9545454545454546,0.4353745534151921,0.9388759117298549
33,55,26,114,0.375,0.7719298245614035,0.3460888391294778,0.9062944580957696
18,76,2,96,0.19148936170212766,0.9791666666666666,0.2841587479440674,0.911721628964117
0,1,0,1,0.0,1.0,0.26152791343204485,0.9171638058348652
37,66,3,106,0.3592233009708738,0.9716981132075472,0.2602740992850268,0.9353214513510013
154,189,34,377,0.4489795918367347,0.9098143236074271,0.2592511337078185,0.9318054647937485
27,45,25,97,0.375,0.7422680412371134,0.2635614785354047,0.9042032034036588
1,25,7,33,0.038461538461538464,0.7878787878787878,0.2554505418530394,0.8803936795941351
0,12,2,14,0.0,0.8571428571428571,0.20187911328161084,0.8925669699629141
1,8,2,11,0.1111111111111111,0.8181818181818182,0.19039650605432276,0.8695691344650786
39,143,60,242,0.21428571428571427,0.7520661157024794,0.22100875095228195,0.8341500081368614
39,95,22,156,0.291044776119403,0.8589743589743589,0.2112689616877861,0.8180466146749773
3,18,4,25,0.14285714285714285,0.84,0.16753718326213013,0.8080731398739163
10,23,89,122,0.30303030303030304,0.27049180327868855,0.15725579798074488,0.7406765344512841
3,42,3,48,0.06666666666666667,0.9375,0.16128510201004892,0.762050993325743
15,148,25,188,0.09202453987730061,0.8670212765957447,0.17443146484966326,0.763462196104727
38,95,3,136,0.2857142857142857,0.9779411764705882,0.19937477550725966,0.7862849615745512
37,99,7,143,0.27205882352941174,0.951048951048951,0.20762807682778783,0.8147110809097615
37,62,7,106,0.37373737373737376,0.9339622641509434,0.21944130505892653,0.8254236387921308
57,163,5,225,0.2590909090909091,0.9777777777777777,0.23604612880660744,0.8451061784746704
25,57,1,83,0.3048780487804878,0.9879518072289156,0.23631009248520524,0.9476004647532743
6,46,1,53,0.11538461538461539,0.9811320754716981,0.2432697994449122,0.9538336183920882
3,21,12,36,0.125,0.6666666666666666,0.2479805794624407,0.9252115312593628
46,109,4,159,0.2967741935483871,0.9748427672955975,0.24956056629588375,0.9247689013772213
23,82,26,131,0.21904761904761905,0.8015267175572519,0.24198753708419907,0.9034085823069786
37,63,24,124,0.37,0.8064516129032258,0.2414536265502885,0.8851927749858761
11,90,2,103,0.10891089108910891,0.9805825242718447,0.21999933826431706,0.8855934530564571
8,52,4,64,0.13333333333333333,0.9375,0.195492950343295,0.8783860520237549
11,97,12,120,0.10185185185185185,0.9,0.19355969841004309,0.866795755527798
15,31,1,47,0.32608695652173914,0.9787234042553191,0.22228640648457726,0.911375289469034
25,69,1,95,0.26595744680851063,0.9894736842105263,0.21788401409316635,0.913465420456881
10,16,3,29,0.38461538461538464,0.896551724137931,0.24153655203141855,0.927040421396978
18,51,11,80,0.2608695652173913,0.8625,0.22594648991961733,0.9350473338393742
27,25,1,53,0.5192307692307693,0.9811320754716981,0.28456361536842595,0.9351258411536391
0,2,57,59,0.0,0.03389830508474576,0.26551599632080686,0.8060398847371741
12,157,10,179,0.07100591715976332,0.9441340782122905,0.26110943422193705,0.8123447530532157
51,133,15,199,0.27717391304347827,0.9246231155778895,0.25412185658218556,0.8046161403850114
48,87,4,139,0.35555555555555557,0.9712230215827338,0.2669215864031919,0.8020089028667554
6,50,7,63,0.10714285714285714,0.8888888888888888,0.2272826539071166,0.8009142121168923
44,163,6,213,0.21256038647342995,0.971830985915493,0.22038134265797926,0.8165329243905342
2,7,57,66,0.2222222222222222,0.13636363636363635,0.17795155022818682,0.6958517188036681
7,4,2,13,0.6363636363636364,0.8461538461538461,0.26886064113727776,0.8118882246706826
28,43,5,76,0.39436619718309857,0.9342105263157895,0.3150549668548971,0.8104705743997538
1,60,3,64,0.01639344262295082,0.953125,0.27780061393767885,0.8145422721743409
46,72,3,121,0.3898305084745763,0.9752066115702479,0.2826970357832533,0.8151113564582716
19,73,413,505,0.20652173913043478,0.18217821782178217,0.29689401892433576,0.7141526891629706
1,43,9,53,0.022727272727272728,0.8301886792452831,0.26977500267488475,0.6939180739243691
22,59,20,101,0.2716049382716049,0.801980198019802,0.27682967639622513,0.7890061541609643
2,0,0,2,1.0,1.0,0.32877772834427704,0.8109841761389862
12,4,1,17,0.75,0.9411764705882353,0.37958255731812013,0.8119793110350499
18,72,4,94,0.2,0.9574468085106383,0.40581206551484145,0.8125967122508554
48,69,22,139,0.41025641025641024,0.841726618705036,0.40873005148367486,0.7935281418415394
25,32,4,61,0.43859649122807015,0.9344262295081968,0.4418835874976228,0.9009921435110272
10,17,2,29,0.37037037037037035,0.9310344827586207,0.49154688716092243,0.9153986868700754
1,22,1,24,0.043478260869565216,0.9583333333333334,0.4254230070626864,0.9394170372709805
33,57,27,117,0.36666666666666664,0.7692307692307693,0.3349468165864959,0.9064500043039475
15,95,2,112,0.13636363636363635,0.9821428571428571,0.2651416217813011,0.9123023452403219
0,1,0,1,0.0,1.0,0.24392521442627987,0.9177445221110704
34,84,3,121,0.288135593220339,0.9752066115702479,0.23365887060061402,0.9364033816790208
156,223,35,414,0.41160949868073876,0.9154589371980676,0.22729732028683483,0.9336937684918595
27,55,25,107,0.32926829268292684,0.7663551401869159,0.22507456406912488,0.9095325212374558
0,33,7,40,0.0,0.825,0.21886338394490126,0.8904849021898366
0,12,2,14,0.0,0.8571428571428571,0.16648243156394887,0.9030437718915635
2,11,2,15,0.15384615384615385,0.8666666666666667,0.16897993406145137,0.8865471732521077
38,172,60,270,0.18095238095238095,0.7777777777777778,0.19483027419750581,0.854801141506076
38,112,21,171,0.25333333333333335,0.8771929824561403,0.18985852278507645,0.8407991944897749
4,18,4,26,0.18181818181818182,0.8461538461538461,0.15703119180471117,0.8308984671977433
8,17,101,126,0.32,0.1984126984126984,0.15570714999286445,0.7497638326585693
4,46,3,53,0.08,0.9433962264150944,0.1671357214214359,0.7666775792892971
17,163,27,207,0.09444444444444444,0.8695652173913043,0.1806277849134994,0.7684522021819324
31,134,3,168,0.18787878787878787,0.9821428571428571,0.18548958977530425,0.7849488008213882
36,106,7,149,0.2535211267605634,0.9530201342281879,0.19585655346218747,0.8099834231714469
39,68,10,117,0.3644859813084112,0.9145299145299145,0.21173550317291287,0.8153172706105575
55,165,5,225,0.25,0.9777777777777777,0.22147576291317259,0.8341206894139761
32,70,1,103,0.3137254901960784,0.9902912621359223,0.22057940436975523,0.947246198517294
10,45,5,60,0.18181818181818182,0.9166666666666666,0.2351248589152098,0.9434276899818043
2,24,13,39,0.07692307692307693,0.6666666666666666,0.23262180641215727,0.9144421827354273
45,115,4,164,0.28125,0.975609756097561,0.2459605510009019,0.9135088825860994
24,90,26,140,0.21052631578947367,0.8142857142857143,0.23981843514788906,0.8936896797371745
40,79,22,141,0.33613445378151263,0.8439716312056738,0.23576821692976072,0.8836099249765689
12,95,3,110,0.11214953271028037,0.9727272727272728,0.2160752930312293,0.8828884242550681
9,53,4,66,0.14516129032258066,0.9393939393939394,0.19199469304930106,0.8756173781490705
11,109,12,132,0.09166666666666666,0.9090909090909091,0.17911590517051315,0.8745351270668195
14,35,1,50,0.2857142857142857,0.98,0.20894322071211444,0.9192970318287241
24,74,1,99,0.24489795918367346,0.98989898989899,0.20375007202406778,0.9213383509432141
11,16,3,30,0.4074074074074074,0.9,0.23187594225520117,0.9335832489023977
18,67,11,96,0.21176470588235294,0.8854166666666666,0.21410883541246406,0.9395039682539681
27,27,2,56,0.5,0.9642857142857143,0.2695160450252812,0.9382980313337456
0,4,57,61,0.0,0.06557377049180328,0.24877871783634106,0.8134665786334404
10,187,10,207,0.050761421319796954,0.9516908212560387,0.24293511135821683,0.819552280371316
49,171,15,235,0.22272727272727272,0.9361702127659575,0.2339369666457864,0.8132908821950242
40,97,13,150,0.291970802919708,0.9133333333333333,0.24066165860807703,0.8023529312570732
8,50,7,65,0.13793103448275862,0.8923076923076924,0.2021650339045558,0.8012540301581722
34,190,6,230,0.15178571428571427,0.9739130434782609,0.1935966065336074,0.8138963697026856
2,6,58,66,0.25,0.12121212121212122,0.1578823208193217,0.6934572849778865
7,6,2,15,0.5384615384615384,0.8666666666666667,0.23480539774239859,0.8078991272885814
28,55,5,88,0.3373493975903614,0.9431818181818182,0.2757465372096221,0.8066835554208357
1,61,3,65,0.016129032258064516,0.9538461538461539,0.24623250285687812,0.8092086898608637
45,94,3,142,0.3237410071942446,0.9788732394366197,0.2507711034675261,0.8185715335899045
18,103,474,595,0.1487603305785124,0.20336134453781513,0.2523181457669196,0.7201506267656363
1,49,9,59,0.02,0.847457627118644,0.23349161515467468,0.7020855672856913
22,65,20,107,0.25287356321839083,0.8130841121495327,0.23390212418587336,0.8009244231338928
2,0,0,2,1.0,1.0,0.2998361901199393,0.8199720421815118
10,6,1,17,0.625,0.9411764705882353,0.34092913332131625,0.819685563953857
16,85,4,105,0.15841584158415842,0.9619047619047619,0.3612558203679011,0.8208367936765154
46,79,23,148,0.368,0.8445945945945946,0.3675785336258661,0.8016541301276547
26,31,4,61,0.45614035087719296,0.9344262295081968,0.4114899650971062,0.9060919708377092
10,19,2,31,0.3448275862068966,0.9354838709677419,0.4578939059838057,0.9186671485304375
2,21,1,24,0.08695652173913043,0.9583333333333334,0.43804770657572606,0.9407775814886675
33,56,28,117,0.3707865168539326,0.7606837606837606,0.34816006612628786,0.9065895473006332
14,96,2,112,0.12727272727272726,0.9821428571428571,0.27705617002239175,0.9124418882370079
0,1,0,1,0.0,1.0,0.2518460859887783,0.9165235208900692
33,85,3,121,0.2796610169491525,0.9752066115702479,0.2403690884100858,0.9351823804580196
152,227,35,414,0.40105540897097625,0.9154589371980676,0.2350060766590724,0.9324727672708583
26,56,25,107,0.3170731707317073,0.7663551401869159,0.22611505178823252,0.9083115200164544
0,33,7,40,0.0,0.825,0.21369269153978535,0.8892639009688355
0,12,2,14,0.0,0.8571428571428571,0.16072318913208067,0.9030437718915635
2,11,2,15,0.15384615384615385,0.8666666666666667,0.16451939292828446,0.8865471732521077
38,172,60,270,0.18095238095238095,0.7777777777777778,0.19036973306433888,0.854801141506076
40,110,21,171,0.26666666666666666,0.8771929824561403,0.18851339730969802,0.8407991944897749
4,18,4,26,0.18181818181818182,0.8461538461538461,0.15719379343072742,0.8308984671977432
6,21,99,126,0.2222222222222222,0.21428571428571427,0.14364365792937242,0.7520314063547145
4,46,3,53,0.08,0.9433962264150944,0.15507222935794382,0.7689451529854423
19,161,27,207,0.10555555555555556,0.8695652173913043,0.1701515944373089,0.7707197758780777
30,135,3,168,0.18181818181818182,0.9821428571428571,0.17414759843331293,0.7872163745175333
36,106,7,149,0.2535211267605634,0.9530201342281879,0.1845145621201961,0.812250996867592
41,69,7,117,0.37272727272727274,0.9401709401709402,0.1996660772717113,0.8212478479697063
55,165,5,225,0.25,0.9777777777777777,0.209406337011971,0.840051266773125
32,70,1,103,0.3137254901960784,0.9902912621359223,0.2224782324368076,0.9509092021802976
10,45,5,60,0.18181818181818182,0.9166666666666666,0.23702368698226217,0.9470906936448079
2,24,13,39,0.07692307692307693,0.6666666666666666,0.23293333289190807,0.918105186398431
43,117,4,164,0.26875,0.975609756097561,0.24535216406073923,0.9171718862491031
24,90,26,140,0.21052631578947367,0.8142857142857143,0.2392100482077264,0.8973526834001782
41,76,24,141,0.3504273504273504,0.8297872340425532,0.2360243450220232,0.8815835825246945
10,97,3,110,0.09345794392523364,0.9727272727272728,0.21366119415419946,0.8808620818031938
8,54,4,66,0.12903225806451613,0.9393939393939394,0.18727644670683344,0.8735910356971962
11,109,12,132,0.09166666666666666,0.9090909090909091,0.17439765882804553,0.8725087846149452
11,38,1,50,0.22448979591836735,0.98,0.1954786186845156,0.9172706893768499
23,75,1,99,0.23469387755102042,0.98989898989899,0.1906134583346614,0.9193120084913396
11,15,4,30,0.4230769230769231,0.8666666666666667,0.22097783080429703,0.9267950016886186
19,66,11,96,0.2235294117647059,0.8854166666666666,0.20284955385249062,0.9347420634920633
26,28,2,56,0.48148148148148145,0.9642857142857143,0.2582814877890975,0.9335361265718406
0,4,57,61,0.0,0.06557377049180328,0.23984830806559515,0.8087046738715354
10,187,10,207,0.050761421319796954,0.9516908212560387,0.23400470158747094,0.8147903756094113
49,172,14,235,0.22171945701357465,0.9404255319148936,0.23360893888678627,0.8091368801686818
39,98,13,150,0.2846715328467153,0.9133333333333333,0.24074860392902836,0.7981989292307309
6,52,7,65,0.10344827586206896,0.8923076923076924,0.19508736861262063,0.8018619328937344
33,191,6,230,0.14732142857142858,0.9739130434782609,0.1842005138707239,0.814504272438248
1,7,58,66,0.125,0.12121212121212122,0.133274587944798,0.694065187713449
7,6,2,15,0.5384615384615384,0.8666666666666667,0.2101976648678749,0.8085070300241437
28,55,5,88,0.3373493975903614,0.9431818181818182,0.2511388043350984,0.8072914581563978
1,61,3,65,0.016129032258064516,0.9538461538461539,0.2217687436557398,0.8092086898608637
44,95,3,142,0.31654676258992803,0.9788732394366197,0.22632234790477018,0.8185715335899045
17,104,474,595,0.14049586776859505,0.20336134453781513,0.2316148610342739,0.7201506267656365
1,49,9,59,0.02,0.847457627118644,0.2134260855240698,0.702085567285691
22,65,20,107,0.25287356321839083,0.8130841121495327,0.23169373741241134,0.8009244231338928
2,0,0,2,1.0,1.0,0.29762780334647726,0.8199720421815119
10,6,1,17,0.625,0.9411764705882353,0.3387207465478542,0.819685563953857
15,86,4,105,0.1485148514851485,0.9619047619047619,0.3576330064374377,0.8208367936765154
45,80,23,148,0.36,0.8445945945945946,0.3638406117817337,0.8016541301276546
26,31,4,61,0.45614035087719296,0.9344262295081968,0.40893268079724765,0.9060919708377091
10,19,2,31,0.3448275862068966,0.9354838709677419,0.4553366216839471,0.9186671485304375
2,21,1,24,0.08695652173913043,0.9583333333333334,0.4397117385251394,0.9394170372709805
31,59,27,117,0.34444444444444444,0.7692307692307693,0.3460609448743458,0.9064500043039475
18,92,2,112,0.16363636363636364,0.9821428571428571,0.2801518539652549,0.912302345240322
0,1,0,1,0.0,1.0,0.253277737982228,0.9177445221110704
34,84,3,121,0.288135593220339,0.9752066115702479,0.24301139415656214,0.9364033816790208
151,230,32,413,0.3963254593175853,0.9225181598062954,0.23697267531220717,0.9347022288644634
28,54,25,107,0.34146341463414637,0.7663551401869159,0.23156597099885864,0.9105409816100598
0,33,7,40,0.0,0.825,0.21914361075041144,0.8914933625624407
0,12,2,14,0.0,0.8571428571428571,0.16993726154406222,0.9040522322641676
2,11,2,15,0.15384615384615385,0.8666666666666667,0.16853866014546082,0.8875556336247117
37,174,59,270,0.17535545023696683,0.7814814814814814,0.1935894387507418,0.8563387024077805
41,109,21,171,0.2733333333333333,0.8771929824561403,0.19147483019545528,0.8423367553914795
3,19,4,26,0.13636363636363635,0.8461538461538461,0.15433742691631974,0.8314275677268438
7,18,101,126,0.28,0.1984126984126984,0.14555693911144169,0.75029293318767
4,46,3,53,0.08,0.9433962264150944,0.1569855105400131,0.7672066798183977
17,163,27,207,0.09444444444444444,0.8695652173913043,0.17047757403207658,0.7689813027110329
31,134,3,168,0.18787878787878787,0.9821428571428571,0.1753393788938815,0.7854779013504888
37,105,7,149,0.2605633802816901,0.9530201342281879,0.18751194032884191,0.8099834231714468
39,70,8,117,0.3577981651376147,0.9316239316239316,0.1995783448723107,0.8177592730525598
55,165,5,225,0.25,0.9777777777777777,0.21581211110607693,0.8365626918559786
32,70,1,103,0.3137254901960784,0.9902912621359223,0.22063003827694527,0.9496882009592963
8,51,1,60,0.13559322033898305,0.9833333333333333,0.2285719268968,0.9553935019476161
2,24,13,39,0.07692307692307693,0.6666666666666666,0.2260688743937475,0.9264079947012395
36,124,4,164,0.225,0.975609756097561,0.23137190469677776,0.9254746945519113
24,90,26,140,0.21052631578947367,0.8142857142857143,0.2242237526264612,0.9056554917029865
40,79,22,141,0.33613445378151263,0.8439716312056738,0.22112893671844658,0.8931337345003784
10,98,2,110,0.09259259259259259,0.9818181818181818,0.19864216423167408,0.8937109350775788
9,53,4,66,0.14516129032258066,0.9393939393939394,0.17456156424974584,0.8864398889715813
11,109,12,132,0.09166666666666666,0.9090909090909091,0.16828634229655776,0.8758338283655208
14,35,1,50,0.2857142857142857,0.98,0.19811365783815904,0.9205957331274254
25,73,1,99,0.25510204081632654,0.98989898989899,0.20241394938334856,0.9226370522419154
9,18,3,30,0.3333333333333333,0.9,0.21995780903247136,0.934881950201099
19,66,11,96,0.2235294117647059,0.8854166666666666,0.2038713744586418,0.9408026695526693
26,28,2,56,0.48148148148148145,0.9642857142857143,0.25942693001419737,0.9382980313337456
0,4,57,61,0.0,0.06557377049180328,0.23868960282525725,0.8134665786334404
10,187,10,207,0.050761421319796954,0.9516908212560387,0.23284599634713302,0.819552280371316
49,171,15,235,0.22272727272727272,0.9361702127659575,0.22384785163470258,0.8132908821950242
45,101,4,150,0.3082191780821918,0.9733333333333334,0.23143601410125478,0.8109243598285019
5,53,7,65,0.08620689655172414,0.8923076923076924,0.19613223741816777,0.8098254587296009
36,188,6,230,0.16071428571428573,0.9739130434782609,0.18715864798239343,0.8224677982741142
2,7,57,66,0.2222222222222222,0.13636363636363635,0.15012161094535642,0.7041932157138174
7,6,2,15,0.5384615384615384,0.8666666666666667,0.22704468786843332,0.8186350580245121
29,54,5,88,0.3493975903614458,0.9431818181818182,0.269706997731526,0.8174194861567664
1,61,3,65,0.016129032258064516,0.9538461538461539,0.240192963378782,0.8199446205967945
45,95,3,143,0.32142857142857145,0.9790209790209791,0.24208001957112193,0.8207571414093152
17,104,474,595,0.14049586776859505,0.20336134453781513,0.24983558688781776,0.722336234585047
1,49,9,59,0.02,0.847457627118644,0.22973354607149127,0.7042711751051017
22,65,20,107,0.25287356321839083,0.8130841121495327,0.2341123090709439,0.8009455287888011
2,0,0,2,1.0,1.0,0.30004637500500986,0.8199931478364204
10,6,1,17,0.625,0.9411764705882353,0.33941814781051755,0.8197066696087656
18,84,3,105,0.17647058823529413,0.9714285714285714,0.3623240843786933,0.8222184435491109
45,80,23,148,0.36,0.8445945945945946,0.3678342884603259,0.8030146743453417
25,32,4,61,0.43859649122807015,0.9344262295081968,0.4104200918116795,0.9074525150553964
11,18,2,31,0.3793103448275862,0.9354838709677419,0.46175014107276324,0.9200276927481246
2,21,1,24,0.08695652173913043,0.9583333333333334,0.44301441994702806,0.9395681289080583
32,58,27,117,0.35555555555555557,0.7692307692307693,0.350950927883536,0.9066010959410253
20,90,2,112,0.18181818181818182,0.9821428571428571,0.2876392395718477,0.9124534368773999
0,1,0,1,0.0,1.0,0.2635939779028237,0.9178956137481481
35,83,3,121,0.2966101694915254,0.9752066115702479,0.25225257354447017,0.9365544733160986
149,229,35,413,0.3941798941798942,0.9152542372881356,0.24206152394455357,0.9336645256475834
29,53,25,107,0.35365853658536583,0.7663551401869159,0.23839697990995065,0.9095032783931797
0,33,7,40,0.0,0.825,0.22597461966150348,0.8904556593455607
0,12,2,14,0.0,0.8571428571428571,0.17518096886785267,0.9030145290472875
2,11,2,15,0.15384615384615385,0.8666666666666667,0.17118496487184867,0.8865179304078319
37,173,60,270,0.1761904761904762,0.7777777777777778,0.19635503289905956,0.8547718986618001
41,108,22,171,0.2751677852348993,0.8713450292397661,0.19329183514811296,0.8399345297574454
3,19,4,26,0.13636363636363635,0.8461538461538461,0.15646094117436185,0.8300630453096899
11,20,95,126,0.3548387096774194,0.24603174603174602,0.15662953733036947,0.7557311318589512
4,46,3,53,0.08,0.9433962264150944,0.16805810875894092,0.772644878489679
18,163,26,207,0.09944751381215469,0.8743961352657005,0.18226489644639157,0.7751096325072282
33,132,3,168,0.2,0.9821428571428571,0.1888583030397982,0.7916062311466838
40,102,7,149,0.28169014084507044,0.9530201342281879,0.2039296837047402,0.8166408534967424
39,71,7,117,0.35454545454545455,0.9401709401709402,0.21526935074910522,0.8264731264869101
55,165,5,225,0.25,0.9777777777777777,0.23150311698287146,0.8452765452903289
31,71,1,103,0.30392156862745096,0.9902912621359223,0.22422923969001882,0.9515993333052114
5,54,1,60,0.0847457627118644,0.9833333333333333,0.22490720579171378,0.9573046342935312
2,24,13,39,0.07692307692307693,0.6666666666666666,0.22168942909327408,0.9276289959222405
36,124,4,164,0.225,0.975609756097561,0.22526085766470264,0.9266956957729126
24,89,27,140,0.21238938053097345,0.8071428571428572,0.2153607490484031,0.9058560847607225
42,78,21,141,0.35,0.851063829787234,0.21471139839905246,0.8931264975630502
9,99,2,110,0.08333333333333333,0.9818181818181818,0.1909018745895286,0.8937036981402509
8,54,4,66,0.12903225806451613,0.9393939393939394,0.16591768736625223,0.8864326520342533
11,109,12,132,0.09166666666666666,0.9090909090909091,0.16690638793122398,0.8758265914281925
14,35,1,50,0.2857142857142857,0.98,0.1967337034728252,0.9205884961900974
28,70,1,99,0.2857142857142857,0.98989898989899,0.20540717286058033,0.9226298153045872
8,19,3,30,0.2962962962962963,0.9,0.21739387511276928,0.9358951214270361
19,66,11,96,0.2235294117647059,0.8854166666666666,0.19932664822201301,0.9408026695526696
27,28,1,56,0.4909090909090909,0.9821428571428571,0.25755175644712125,0.9408490517419087
0,4,57,61,0.0,0.06557377049180328,0.2391185767236189,0.8160175990416035
14,183,10,207,0.07106598984771574,0.9516908212560387,0.23617562289234023,0.8221033007794792
50,170,15,235,0.22727272727272727,0.9361702127659575,0.22782682882926045,0.8158419026031875
46,100,4,150,0.3150684931506849,0.9733333333333334,0.23202028703446034,0.8134753802366651
6,52,7,65,0.10344827586206896,0.8923076923076924,0.20447056982957074,0.812376479137764
42,182,6,230,0.1875,0.9739130434782609,0.19932351100604132,0.8250188186822774
1,10,55,66,0.09090909090909091,0.16666666666666666,0.14218065386318415,0.7085222200428217
6,7,2,15,0.46153846153846156,0.8666666666666667,0.2081147197972501,0.8229640623535165
28,55,5,88,0.3373493975903614,0.9431818181818182,0.24615520661762805,0.8217484904857707
1,61,3,65,0.016129032258064516,0.9538461538461539,0.21599182161553337,0.8242736249257988
44,96,3,143,0.3142857142857143,0.9790209790209791,0.21587999606339472,0.8250861457383196
16,106,473,595,0.13114754098360656,0.20504201680672268,0.21983703393790008,0.7269053349524667
1,49,9,59,0.02,0.847457627118644,0.19590846250932864,0.7088402754725215
21,66,20,107,0.2413793103448276,0.8130841121495327,0.2174042081430053,0.8011856248272166
2,0,0,2,1.0,1.0,0.29432728506608224,0.8202332438748358
10,6,1,17,0.625,0.9411764705882353,0.3354202282674592,0.8199467656471809
19,82,4,105,0.18811881188118812,0.9619047619047619,0.35999019678504823,0.8210979953698392
45,80,23,148,0.36,0.8445945945945946,0.3665208090299462,0.80189422616607
25,32,4,61,0.43859649122807015,0.9344262295081968,0.41044208763629814,0.9060919708377092
11,18,2,31,0.3793103448275862,0.9354838709677419,0.4617721368973819,0.9186671485304375
2,21,1,24,0.08695652173913043,0.9583333333333334,0.4527501533552082,0.9367508896890527
34,59,24,117,0.3655913978494624,0.7948717948717948,0.3621203530479885,0.9074468603850233
22,88,2,112,0.2,0.9821428571428571,0.3014060673337028,0.913299201321398
0,1,0,1,0.0,1.0,0.2762883279302491,0.9193142389153829
33,84,3,120,0.28205128205128205,0.975,0.26068074710527694,0.9395523341534782
146,234,33,413,0.38421052631578945,0.9200968523002422,0.2466024479090104,0.9373541886295496
27,55,25,107,0.32926829268292684,0.7663551401869159,0.2354397172340846,0.9138285682621632
0,33,7,40,0.0,0.825,0.22301735698563743,0.8947809492145442
0,13,1,14,0.0,0.9285714285714286,0.17079001443571423,0.9138808968859203
2,12,1,15,0.14285714285714285,0.9333333333333333,0.1626267491295918,0.9069081077702741
36,178,56,270,0.16822429906542055,0.7925925925925926,0.1866587918532233,0.8772784781406445
42,107,22,171,0.28187919463087246,0.8713450292397661,0.18663420793602192,0.8624706251748968
3,23,0,26,0.11538461538461539,1.0,0.1482305063744256,0.8738853605605765
12,39,75,126,0.23529411764705882,0.40476190476190477,0.13480562422644446,0.8222291840712892
4,46,3,53,0.08,0.9433962264150944,0.14623419565501591,0.8391429307020168
19,160,27,206,0.10614525139664804,0.8689320388349514,0.1613978029973942,0.8306230178825204
33,132,3,168,0.2,0.9821428571428571,0.16956106830351667,0.8375958069981665
34,108,7,149,0.23943661971830985,0.9530201342281879,0.17973425696821513,0.860514027231823
40,67,10,117,0.37383177570093457,0.9145299145299145,0.19287033997822403,0.866683296558987
54,166,5,225,0.24545454545454545,0.9777777777777777,0.21145175855964257,0.8635086933843839
31,71,1,103,0.30392156862745096,0.9902912621359223,0.22125568012827004,0.9471557444378149
10,49,1,60,0.1694915254237288,0.9833333333333333,0.23404018376023128,0.9528610454261349
2,24,13,39,0.07692307692307693,0.6666666666666666,0.229865587406864,0.9239659922592368
37,123,4,164,0.23125,0.975609756097561,0.2343298731211497,0.9230326921099089
24,90,26,140,0.21052631578947367,0.8142857142857143,0.23019982970274452,0.903213489260984
42,80,19,141,0.3442622950819672,0.8652482269503546,0.2259756181857492,0.8961732481781899
11,97,2,110,0.10185185185185185,0.9818181818181818,0.20546094767107867,0.8967504487553905
8,54,4,66,0.12903225806451613,0.9393939393939394,0.1804767604478023,0.8894794026493928
11,109,12,132,0.09166666666666666,0.9090909090909091,0.16935892348250767,0.8788733420433322
13,36,1,50,0.2653061224489796,0.98,0.1962707871290652,0.923635246805237
27,71,1,99,0.2755102040816326,0.98989898989899,0.2025936734264413,0.9256765659197269
9,18,3,30,0.3333333333333333,0.9,0.2201375330755641,0.9379214638789106
19,71,6,96,0.2111111111111111,0.9375,0.20111593536544184,0.9482431457431456
26,29,1,56,0.4727272727272727,0.9821428571428571,0.2540981383476448,0.9482895279323849
0,4,57,61,0.0,0.06557377049180328,0.23566495862414247,0.8234580752320797
14,183,10,207,0.07106598984771574,0.9516908212560387,0.23272200479286378,0.8295437769699553
48,173,14,235,0.2171945701357466,0.9404255319148936,0.22584892589097333,0.8238902815292259
44,102,4,150,0.3013698630136986,0.9733333333333334,0.2295431628812685,0.8215237591627036
8,50,7,65,0.13793103448275862,0.8923076923076924,0.20162854875975783,0.8204248580638025
36,188,6,230,0.16071428571428573,0.9739130434782609,0.19442900227449703,0.8256267214178398
6,45,15,66,0.11764705882352941,0.7727272727272727,0.14370325743110515,0.7957102093584706
6,7,2,15,0.46153846153846156,0.8666666666666667,0.2096373233651711,0.9101520516691654
27,56,5,88,0.3253012048192771,0.9431818181818182,0.24595663978967983,0.9089364798014196
2,60,3,65,0.03225806451612903,0.9538461538461539,0.21953713898687735,0.9108537115058855
47,93,3,143,0.3357142857142857,0.9790209790209791,0.22444348508696121,0.911666232318406
16,107,472,595,0.13008130081300814,0.20672268907563024,0.22332209456271115,0.8137255175709687
1,49,9,59,0.02,0.847457627118644,0.20322005374638463,0.7956604580910235
23,64,20,107,0.26436781609195403,0.8130841121495327,0.22418016192758813,0.801425720865632
2,0,0,2,1.0,1.0,0.30110323885066503,0.820473339913251
10,6,1,17,0.625,0.9411764705882353,0.34391735244791116,0.8201868616855963
17,84,4,105,0.16831683168316833,0.9619047619047619,0.36335431918605965,0.8213380914082545
47,78,23,148,0.376,0.8445945945945946,0.36910942122687596,0.8021343222044853
27,31,4,62,0.46551724137931033,0.9354838709677419,0.41702884130777634,0.9062430624747871
11,18,2,31,0.3793103448275862,0.9354838709677419,0.46835889056886,0.9188182401675152
2,19,1,22,0.09523809523809523,0.9545454545454546,0.45262691543271005,0.9375063186039762
33,54,27,114,0.3793103448275862,0.7631578947368421,0.3639569646937938,0.9036717321378107
18,76,2,96,0.19148936170212766,0.9791666666666666,0.3020268735083835,0.909098903006158
0,1,0,1,0.0,1.0,0.2718681433496533,0.9151779303617812
33,70,3,106,0.32038834951456313,0.9716981132075472,0.26315848867982095,0.9335837832689817
137,205,34,376,0.40058479532163743,0.9095744680851063,0.25634547914448835,0.9298824400000337
26,46,25,97,0.3611111111111111,0.7422680412371134,0.24973172253073175,0.9029158054969614
0,26,7,33,0.0,0.7878787878787878,0.236126280353861,0.8791062816874374
0,12,2,14,0.0,0.8571428571428571,0.1819390882356344,0.8925327048882968
0,9,2,11,0.0,0.8181818181818182,0.15458346513533044,0.8695348693904613
35,147,60,242,0.19230769230769232,0.7520661157024794,0.18205599260785793,0.8341157430622441
41,93,22,156,0.30597014925373134,0.8589743589743589,0.17999624971345338,0.81801234960036
3,18,4,25,0.14285714285714285,0.84,0.143178013647097,0.8080731398739164
9,21,92,122,0.3,0.2459016393442623,0.13444785491693825,0.7371636538892233
3,43,3,49,0.06521739130434782,0.9387755102040817,0.14376462510327367,0.7587203285071223
16,146,26,188,0.09876543209876543,0.8617021276595744,0.15787397254595445,0.7593716528666535
27,104,3,134,0.20610687022900764,0.9776119402985075,0.1873178111500984,0.782147384597609
35,100,8,143,0.25925925925925924,0.9440559440559441,0.19688232071460796,0.8095745029338183
35,60,11,106,0.3684210526315789,0.8962264150943396,0.20580387834001473,0.8148962252366727
54,166,5,225,0.24545454545454545,0.9777777777777777,0.22046065013964372,0.8345787649192123
23,59,1,83,0.2804878048780488,0.9879518072289156,0.21767319369365065,0.940585931759877
5,48,1,54,0.09433962264150944,0.9814814814814815,0.22183351245610233,0.9466867847995057
2,22,12,36,0.08333333333333333,0.6666666666666666,0.21962892691818345,0.9188245760862331
43,112,4,159,0.27741935483870966,0.9748427672955975,0.22981642471956945,0.9184289799429602
23,82,26,131,0.21904761904761905,0.8015267175572519,0.22407190468933516,0.8980676618717186
34,67,23,124,0.33663366336633666,0.8145161290322581,0.21953084908001483,0.8863947638628498
10,91,2,103,0.09900990099009901,0.9805825242718447,0.19861018558509388,0.8867954419334307
8,52,4,64,0.13333333333333333,0.9375,0.1775881182215631,0.8795880409007285
10,98,12,120,0.09259259259259259,0.9,0.17733854250028927,0.8679478292605168
14,32,1,47,0.30434782608695654,0.9787234042553191,0.2089120414650926,0.9125273632017529
27,67,1,95,0.2872340425531915,0.9894736842105263,0.21031413971001858,0.9146174941896
9,17,3,29,0.34615384615384615,0.896551724137931,0.22847217215376528,0.9281924951296968
16,53,11,80,0.2318840579710145,0.8625,0.21350794281157645,0.9350473338393742
28,24,1,53,0.5384615384615384,0.9811320754716981,0.2762867481646392,0.9351258411536391
0,2,57,59,0.0,0.03389830508474576,0.2572391291170201,0.8060398847371743
12,157,10,179,0.07100591715976332,0.9441340782122905,0.2541553183409017,0.8123447530532157
48,139,15,202,0.25668449197860965,0.9257425742574258,0.24734627061113784,0.8047760630535167
42,94,3,139,0.3088235294117647,0.9784172661870504,0.25043048301950543,0.8031965747644488
7,49,7,63,0.125,0.8888888888888888,0.21883707642609881,0.8021018840145855
39,165,6,210,0.19117647058823528,0.9714285714285714,0.21302170679998753,0.8176631085043814
1,10,55,66,0.09090909090909091,0.16666666666666666,0.1490856428639236,0.7013109072465198
6,6,2,14,0.5,0.8571428571428571,0.22051421429249501,0.81891727182625
26,46,5,77,0.3611111111111111,0.935064935064935,0.26195781342840185,0.8176216799480563
1,60,3,64,0.01639344262295082,0.953125,0.22763052066330774,0.8215334550541383
44,76,3,123,0.36666666666666664,0.975609756097561,0.2358938259854366,0.8211323821842113
15,81,411,507,0.15625,0.1893491124260355,0.2403581116997223,0.7211981284038037
1,43,9,53,0.022727272727272728,0.8301886792452831,0.21629394057672766,0.7010210009490482
21,60,20,101,0.25925925925925924,0.801980198019802,0.24034396462675173,0.7917800768566389
2,0,0,2,1.0,1.0,0.3117725360553231,0.8121882401219451
10,6,1,17,0.625,0.9411764705882353,0.3494709487537358,0.8130613166252737
16,75,4,95,0.17582417582417584,0.9578947368421052,0.3722467677824822,0.8137427076027173
45,70,23,138,0.391304347826087,0.8333333333333334,0.3757664365195423,0.7934175043506847
28,30,4,62,0.4827586206896552,0.9354838709677419,0.422410525189493,0.9000081841423571
11,16,2,29,0.4074074074074074,0.9310344827586207,0.477364830143798,0.9144147275014054
1,20,1,22,0.047619047619047616,0.9545454545454546,0.4141801847666912,0.939323013662943
34,57,23,114,0.37362637362637363,0.7982456140350878,0.3246982381418874,0.9105009585250984
19,77,2,98,0.19791666666666666,0.9795918367346939,0.2726149048085541,0.9159888679745926
0,1,0,1,0.0,1.0,0.2485696431395301,0.9214310448453409
33,70,3,106,0.32038834951456313,0.9716981132075472,0.24259587529740356,0.9392926800654665
138,206,35,379,0.4011627906976744,0.9076517150395779,0.23586543653007624,0.9353166577900146
26,46,25,97,0.3611111111111111,0.7422680412371134,0.2431177627479197,0.9077143963999248
0,26,7,33,0.0,0.7878787878787878,0.23631504165948433,0.8839048725904011
0,12,2,14,0.0,0.8571428571428571,0.18293984542714523,0.8923187644629395
1,8,2,11,0.1111111111111111,0.8181818181818182,0.1705390517763516,0.8692601903839572
33,152,60,245,0.1783783783783784,0.7551020408163265,0.19602167725897707,0.8342747676434323
41,94,21,156,0.3037037037037037,0.8653846153846154,0.1936381564288543,0.8190871250972994
3,18,4,25,0.14285714285714285,0.84,0.15673734959449265,0.8094225943773596
8,23,91,122,0.25806451612903225,0.2540983606557377,0.14201640745419566,0.7396840685800203
3,43,3,49,0.06521739130434782,0.9387755102040817,0.15133317764053106,0.7612407431979193
15,147,27,189,0.09259259259259259,0.8571428571428571,0.1645606908680443,0.7612407431979193
28,103,3,134,0.21374045801526717,0.9776119402985075,0.17922202614006658,0.784016474928875
29,106,8,143,0.21481481481481482,0.9440559440559441,0.18442723134527178,0.8110098896773918
37,57,11,105,0.39361702127659576,0.8952380952380953,0.1972719909985421,0.8152746725136032
54,166,5,225,0.24545454545454545,0.9777777777777777,0.21192876279817102,0.8349572121961428
23,59,1,83,0.2804878048780488,0.9879518072289156,0.2151320897623163,0.9397934188494539
5,47,1,53,0.09615384615384616,0.9811320754716981,0.21955158331224459,0.9458443567448278
2,22,12,36,0.08333333333333333,0.6666666666666666,0.21822883198949325,0.9186334723910863
43,111,4,158,0.2792207792207792,0.9746835443037974,0.2275831635902807,0.9182151301061277
23,82,26,131,0.21904761904761905,0.8015267175572519,0.2281878499092527,0.8978538120348859
35,67,22,124,0.3431372549019608,0.8225806451612904,0.2209764547128763,0.8874741763096282
9,92,2,103,0.0891089108910891,0.9805825242718447,0.19864136406095398,0.8878748543802092
8,52,4,64,0.13333333333333333,0.9375,0.17761929669742318,0.880667453347507
10,98,12,120,0.09259259259259259,0.9,0.17711054618867267,0.86907715685155
15,31,1,47,0.32608695652173914,0.9787234042553191,0.21178963521558783,0.9136566907927861
27,67,1,95,0.2872340425531915,0.9894736842105263,0.21293438712021812,0.9157695679223189
8,18,3,29,0.3076923076923077,0.896551724137931,0.22559791406945937,0.9293445688624159
16,52,12,80,0.23529411764705882,0.85,0.21019175160447337,0.93326161955366
28,24,1,53,0.5384615384615384,0.9811320754716981,0.27438498411453754,0.9333401268679248
0,2,57,59,0.0,0.03389830508474576,0.2553373650669185,0.80425417045146
12,157,10,179,0.07100591715976332,0.9441340782122905,0.25225355429080004,0.8105590387675013
46,140,15,201,0.24731182795698925,0.9253731343283582,0.24099996449583577,0.8029375716350785
43,93,4,140,0.3161764705882353,0.9714285714285714,0.24513459707227062,0.8003596983805135
6,50,7,63,0.10714285714285714,0.8888888888888888,0.2164846755652062,0.7992650076306502
33,172,6,211,0.16097560975609757,0.9715639810426541,0.20586774586649748,0.8166312906367438
1,10,55,66,0.09090909090909091,0.16666666666666666,0.14193168193043354,0.7002790893788821
6,6,2,14,0.5,0.8571428571428571,0.21336025335900496,0.8178854539586122
27,45,5,77,0.375,0.935064935064935,0.2567879794790388,0.8165898620804187
1,60,3,64,0.01639344262295082,0.953125,0.22379963871703332,0.8205544143192246
43,77,3,123,0.35833333333333334,0.975609756097561,0.22982204768061873,0.8211517264147945
15,78,412,505,0.16129032258064516,0.18415841584158416,0.237557399886017,0.7204759445508939
1,43,9,53,0.022727272727272728,0.8301886792452831,0.21780763745332776,0.7002794728655551
20,61,20,101,0.24691358024691357,0.801980198019802,0.24009399307301674,0.7910385487731458
2,0,0,2,1.0,1.0,0.31152256450158816,0.8114467120384521
10,6,1,17,0.625,0.9411764705882353,0.34723685021587386,0.8123197885417807
19,71,4,94,0.2111111111111111,0.9574468085106383,0.37505365999989676,0.8129371897575861
45,73,22,140,0.3813559322033898,0.8428571428571429,0.37834260269561915,0.7939725307232407
26,32,4,62,0.4482758620689655,0.9354838709677419,0.41934053690823625,0.9013047385984061
11,16,2,29,0.4074074074074074,0.9310344827586207,0.4742948418625413,0.9157112819574543
1,22,1,24,0.043478260869565216,0.9583333333333334,0.41258487959832324,0.9389117582516876
35,56,26,117,0.38461538461538464,0.7777777777777778,0.3246727916862353,0.9071657265056559
17,92,2,111,0.1559633027522936,0.9819819819819819,0.26659612065084864,0.9129950852761911
0,1,0,1,0.0,1.0,0.24396528613882604,0.9184372621469394
33,83,3,119,0.28448275862068967,0.9747899159663865,0.2324514852161581,0.9376929644278518
137,242,35,414,0.36147757255936674,0.9154589371980676,0.22005172957192973,0.9348322596036126
25,57,25,107,0.3048780487804878,0.7663551401869159,0.21927076117111272,0.9106710123492088
0,33,7,40,0.0,0.825,0.21305958104688913,0.8916233933015898
0,12,2,14,0.0,0.8571428571428571,0.15811452610183416,0.9029612617823154
3,11,2,16,0.21428571428571427,0.875,0.1664462991780371,0.8876781214991751
35,174,60,269,0.1674641148325359,0.7769516728624535,0.19036974415411367,0.8558140747652399
39,112,21,172,0.2582781456953642,0.877906976744186,0.18662622802192433,0.8419736548763541
3,19,4,26,0.13636363636363635,0.8461538461538461,0.15446709427967711,0.8320729275843226
7,21,98,126,0.25,0.2222222222222222,0.14662737302532172,0.7543396535893664
4,45,3,52,0.08163265306122448,0.9423076923076923,0.15828918060549665,0.771097895347608
16,161,28,205,0.0903954802259887,0.8634146341463415,0.17120282063778075,0.771993863490963
28,137,3,168,0.1696969696969697,0.9821428571428571,0.16483299998224582,0.7872999859399427
29,113,8,150,0.20422535211267606,0.9466666666666667,0.1700846053079801,0.8115449850548301
38,63,13,114,0.37623762376237624,0.8859649122807017,0.18693595931755327,0.8126961187029039
54,166,5,225,0.24545454545454545,0.9777777777777777,0.20252037490196886,0.8314995375063227
27,72,1,100,0.2727272727272727,0.99,0.2057671281487221,0.9411820771888622
6,53,1,60,0.1016949152542373,0.9833333333333333,0.20863316560486678,0.9470428830496681
1,25,13,39,0.038461538461538464,0.6666666666666666,0.20121403106708818,0.9189360305525718
44,115,4,163,0.27672955974842767,0.9754601226993865,0.2165044010744393,0.9179813542035046
23,91,26,140,0.20175438596491227,0.8142857142857143,0.21615140591047305,0.8990697895776542
38,78,25,141,0.3275862068965517,0.8226950354609929,0.20920120350106952,0.8900312357462672
9,99,2,110,0.08333333333333333,0.9818181818181818,0.1860410303408964,0.8906084363234678
8,54,4,66,0.12903225806451613,0.9393939393939394,0.16551317110335972,0.8833789990940305
12,106,13,131,0.1016949152542373,0.9007633587786259,0.16551317110335972,0.8715832884433582
13,36,1,50,0.2653061224489796,0.98,0.19791954024442274,0.9163451932052629
24,74,1,99,0.24489795918367346,0.98989898989899,0.19337216873517216,0.9184078885194918
9,17,4,30,0.34615384615384615,0.8666666666666667,0.21400066304787702,0.9258908817167708
14,69,13,96,0.1686746987951807,0.8645833333333334,0.19129901903339544,0.9318749242699623
27,28,2,57,0.4909090909090909,0.9649122807017544,0.24952412725850365,0.9294597955390441
0,4,57,61,0.0,0.06557377049180328,0.23109094753500137,0.8046283428387389
11,186,10,207,0.05583756345177665,0.9516908212560387,0.224539897277507,0.8119036946212265
47,171,15,233,0.21559633027522937,0.9356223175965666,0.21743849839554266,0.8055640257064504
37,102,13,152,0.26618705035971224,0.9144736842105263,0.22047979713497678,0.7947889820366699
6,52,7,65,0.10344827586206896,0.8923076923076924,0.18580757280758003,0.7984519856996734
33,191,6,230,0.14732142857142858,0.9739130434782609,0.1827571056327583,0.8140705157203774
0,8,58,66,0.0,0.12121212121212122,0.11262723550288815,0.6935419215075728
5,8,2,15,0.38461538461538464,0.8666666666666667,0.1675722904479431,0.8079837638182674
28,55,5,88,0.3373493975903614,0.9431818181818182,0.20778826675345521,0.8067681919505217
2,60,3,65,0.03225806451612903,0.9538461538461539,0.1815970859307266,0.8093715971290341
42,96,3,141,0.30434782608695654,0.9787234042553191,0.18704862532033292,0.8185501285640046
20,114,461,595,0.14925373134328357,0.22521008403361345,0.1935922618176493,0.723250470239136
1,49,9,59,0.02,0.847457627118644,0.1754034863074452,0.7051854107591907
20,67,20,107,0.22988505747126436,0.8130841121495327,0.20824420880334013,0.8040242666073923
2,0,0,2,1.0,1.0,0.29615629671542804,0.8230718856550114
9,7,1,17,0.5625,0.9411764705882353,0.32832066848823355,0.8227854074273567
17,84,4,105,0.16831683168316833,0.9619047619047619,0.347757635226382,0.8239366371500151
46,81,23,150,0.36220472440944884,0.8466666666666667,0.3560229064153095,0.8050713889230646
26,32,4,62,0.4482758620689655,0.9354838709677419,0.3987403536618355,0.9065390727707975
9,20,2,31,0.3103448275862069,0.9354838709677419,0.4402181861741508,0.9191142504635257
1,22,1,24,0.043478260869565216,0.9583333333333334,0.42361070508727605,0.9389117582516875
34,56,27,117,0.37777777777777777,0.7692307692307693,0.33472181619838715,0.9059447252846548
16,93,2,111,0.14678899082568808,0.9819819819819819,0.266405957744914,0.9117740840551899
0,1,0,1,0.0,1.0,0.2466039775468942,0.9172162609259382
33,83,3,119,0.28448275862068967,0.9747899159663865,0.23509017662422632,0.9364719632068506
132,247,35,414,0.3482849604221636,0.9154589371980676,0.22080576210325462,0.9336112583826114
27,55,25,107,0.32926829268292684,0.7663551401869159,0.21858300588554466,0.9094500111282077
0,33,7,40,0.0,0.825,0.21237182576132105,0.8904023920805886
0,12,2,14,0.0,0.8571428571428571,0.1584035717930671,0.9029612617823154
3,11,2,16,0.21428571428571427,0.875,0.16804596085878512,0.8876781214991752
35,174,60,269,0.1674641148325359,0.7769516728624535,0.1919694058348617,0.85581407476524
41,110,21,172,0.271523178807947,0.877906976744186,0.19011803729018412,0.8419736548763542
3,19,4,26,0.13636363636363635,0.8461538461538461,0.15984356242468026,0.8320729275843225
8,19,99,126,0.2962962962962963,0.21428571428571427,0.15513327722659015,0.7532058667412936
4,45,3,52,0.08163265306122448,0.9423076923076923,0.1667950848067651,0.7699641084995356
17,161,28,206,0.09550561797752809,0.8640776699029126,0.18043874451784053,0.7709547960366863
26,138,4,168,0.15853658536585366,0.9761904761904762,0.17247458324357476,0.7854105783496114
29,113,8,150,0.20422535211267606,0.9466666666666667,0.17772618856930905,0.809655577464499
38,68,8,114,0.3584905660377358,0.9298245614035088,0.19015010103070742,0.8170723752729737
54,166,5,225,0.24545454545454545,0.9777777777777777,0.20573451661512301,0.8358757940763926
26,73,1,100,0.26262626262626265,0.99,0.20092451180511822,0.9466921206070048
6,49,5,60,0.10909090909090909,0.9166666666666666,0.20484711980935888,0.943029116944001
2,25,12,39,0.07407407407407407,0.6923076923076923,0.201785470680294,0.9184905487161125
42,117,4,163,0.2641509433962264,0.9754601226993865,0.2168732361132044,0.9183862125030997
23,91,26,140,0.20175438596491227,0.8142857142857143,0.21652024094923816,0.8994746478772493
37,79,25,141,0.31896551724137934,0.8226950354609929,0.2108738054069015,0.8841704298854614
11,97,2,110,0.10185185185185185,0.9818181818181818,0.19035913489223102,0.8847476304626619
8,54,4,66,0.12903225806451613,0.9393939393939394,0.17127427709769577,0.8775181932332247
12,106,13,131,0.1016949152542373,0.9007633587786259,0.1702177065495998,0.8752462921063618
12,37,1,50,0.24489795918367346,0.98,0.19462111870811402,0.9163451932052629
21,77,1,99,0.21428571428571427,0.98989898989899,0.18749751454946945,0.918407888519492
8,19,3,30,0.2962962962962963,0.9,0.20100350173966713,0.9306527864786756
15,69,12,96,0.17857142857142858,0.875,0.1809472033582456,0.9381249242699623
26,29,2,57,0.4727272727272727,0.9649122807017544,0.2339294063404486,0.935709795539044
0,4,57,61,0.0,0.06557377049180328,0.21549622661694626,0.8108783428387388
12,185,10,207,0.06091370558375635,0.9516908212560387,0.20967033952116326,0.8181536946212263
45,173,15,233,0.20642201834862386,0.9356223175965666,0.20417377654472763,0.8118140257064503
35,104,13,152,0.2517985611510791,0.9144736842105263,0.20953275466835117,0.8010389820366698
6,52,7,65,0.10344827586206896,0.8923076923076924,0.18198303746346153,0.7999400809377687
31,193,6,230,0.13839285714285715,0.9739130434782609,0.17624324154509421,0.8140705157203774
1,8,57,66,0.1111111111111111,0.13636363636363635,0.12458378988564256,0.6957064236720748
7,6,2,15,0.5384615384615384,0.8666666666666667,0.20150686680871946,0.8101482659827697
28,55,5,88,0.3373493975903614,0.9431818181818182,0.2409976799525202,0.8089326941150239
2,60,3,65,0.03225806451612903,0.9538461538461539,0.21611711511930665,0.8115360992935362
42,97,3,142,0.302158273381295,0.9788732394366197,0.2233113597236232,0.8207360357544068
15,104,476,595,0.12605042016806722,0.2,0.22654023748162297,0.7218349368533079
1,49,9,59,0.02,0.847457627118644,0.20962697217550047,0.7037698773733625
19,68,20,107,0.21839080459770116,0.8130841121495327,0.22495264267358478,0.8004442310570621
2,0,0,2,1.0,1.0,0.2908867086076507,0.8194918501046811
9,7,1,17,0.5625,0.9411764705882353,0.3230510803804562,0.8192053718770264
16,85,4,105,0.15841584158415842,0.9619047619047619,0.3410736199616033,0.8203566015996848
46,80,24,150,0.36507936507936506,0.84,0.35006234734704184,0.8005175673944533
26,32,4,62,0.4482758620689655,0.9354838709677419,0.3960945533328845,0.9055866918184164
9,20,2,31,0.3103448275862069,0.9354838709677419,0.43757238584519975,0.9181618695111448
1,22,1,24,0.043478260869565216,0.9583333333333334,0.4299826101550125,0.9398641392040686
33,57,27,117,0.36666666666666664,0.7692307692307693,0.33950641967882195,0.9068971062370356
16,93,2,111,0.14678899082568808,0.9819819819819819,0.27119056122534885,0.9127264650075709
0,1,0,1,0.0,1.0,0.2457308723993234,0.9181686418783191
31,85,3,119,0.2672413793103448,0.9747899159663865,0.2310398208497326,0.9364719632068506
133,245,36,414,0.35185185185185186,0.9130434782608695,0.21726496224728778,0.9332661928201544
27,55,25,107,0.32926829268292684,0.7663551401869159,0.21504220602957783,0.9091049455657508
0,33,7,40,0.0,0.825,0.20883102590535424,0.8900573265181319
0,12,2,14,0.0,0.8571428571428571,0.15645007352440185,0.9026161962198586
4,10,2,16,0.2857142857142857,0.875,0.1762965442227729,0.8873330559367183
34,175,60,269,0.16267942583732056,0.7769516728624535,0.19953646219953303,0.855469009202783
41,109,22,172,0.2733333333333333,0.872093023255814,0.20040674134567424,0.8407980245298441
3,19,4,26,0.13636363636363635,0.8461538461538461,0.16962271056164344,0.8312423628002694
8,23,95,126,0.25806451612903225,0.24603174603174602,0.15945074248251562,0.7569104493495308
4,45,3,52,0.08163265306122448,0.9423076923076923,0.17111255006269058,0.7736686911077726
14,164,28,206,0.07865168539325842,0.8640776699029126,0.18234850511887032,0.7746593786449234
28,137,3,168,0.1696969696969697,0.9821428571428571,0.16577460283068235,0.789965501093903
31,111,8,150,0.21830985915492956,0.9466666666666667,0.17372180759034078,0.8142105002087906
36,63,15,114,0.36363636363636365,0.868421052631579,0.18662224049077367,0.813685932976757
54,166,5,225,0.24545454545454545,0.9777777777777777,0.20220665607518926,0.8324893517801757
26,73,1,100,0.26262626262626265,0.99,0.2028583341462222,0.9387705309184977
10,45,5,60,0.18181818181818182,0.9166666666666666,0.21717055254007325,0.9351075272554941
1,25,13,39,0.038461538461538464,0.6666666666666666,0.21142910297839895,0.9069059553646017
41,118,4,163,0.2578616352201258,0.9754601226993865,0.22402405519599267,0.9059512790155345
23,91,26,140,0.20175438596491227,0.8142857142857143,0.2216589875974188,0.8870397143896843
38,78,25,141,0.3275862068965517,0.8226950354609929,0.21650896520601706,0.8805074262224578
10,98,2,110,0.09259259259259259,0.9818181818181818,0.19467154336859524,0.8810846267996583
8,54,4,66,0.12903225806451613,0.9393939393939394,0.17558668557406001,0.873855189570221
12,107,12,131,0.10084033613445378,0.9083969465648855,0.164018421904956,0.8726738009842523
16,33,1,50,0.32653061224489793,0.98,0.2051711467311502,0.9174357057461571
24,74,1,99,0.24489795918367346,0.98989898989899,0.203319193011657,0.9194984010603863
8,19,3,30,0.2962962962962963,0.9,0.21682518020185473,0.9317432990195698
15,69,12,96,0.17857142857142858,0.875,0.19553735472683714,0.9392154368108565
27,28,2,57,0.4909090909090909,0.9649122807017544,0.25243971162919404,0.9368003080799383
0,4,57,61,0.0,0.06557377049180328,0.23400653190569173,0.8119688553796331
11,186,10,207,0.05583756345177665,0.9516908212560387,0.22757756437959503,0.8181536946212263
45,173,15,233,0.20642201834862386,0.9356223175965666,0.21041919382298443,0.8118140257064503
42,106,4,152,0.28378378378378377,0.9736842105263158,0.2159743116230002,0.8094976286532111
6,52,7,65,0.10344827586206896,0.8923076923076924,0.1884245944181106,0.80839872755431
33,191,6,230,0.14732142857142858,0.9739130434782609,0.18396030870382488,0.8225291623369186
0,10,56,66,0.0,0.15151515151515152,0.11383043857395474,0.7063295724531183
6,7,2,15,0.46153846153846156,0.8666666666666667,0.17976450450802067,0.8207714147638131
28,55,5,88,0.3373493975903614,0.9431818181818182,0.2199804808135328,0.8195558428960673
3,59,3,65,0.04838709677419355,0.9538461538461539,0.19740406344575703,0.8221592480745797
43,96,3,142,0.30935251798561153,0.9788732394366197,0.20105673976030383,0.822900537918909
19,115,461,595,0.1417910447761194,0.22521008403361345,0.20653427817659678,0.7276008795940406
1,49,9,59,0.02,0.847457627118644,0.1883455026663927,0.7095358201140952
20,67,20,107,0.22988505747126436,0.8130841121495327,0.2211862251622876,0.8040456716332925
2,0,0,2,1.0,1.0,0.2981093020853645,0.8230932906809115
10,6,1,17,0.625,0.9411764705882353,0.3392022452867414,0.8228068124532568
14,87,4,105,0.13861386138613863,0.9619047619047619,0.3520917830884479,0.8239580421759152
46,80,24,150,0.36507936507936506,0.84,0.3600527612446984,0.8041190079706837
26,32,4,62,0.4482758620689655,0.9354838709677419,0.4038363065722478,0.9055866918184163
10,19,2,31,0.3448275862068966,0.9354838709677419,0.45024024745894736,0.9181618695111446
1,22,1,24,0.043478260869565216,0.9583333333333334,0.42808210282950326,0.9400104342812392
34,59,24,117,0.3655913978494624,0.7948717948717948,0.3374523025222836,0.91070640497721
17,92,2,111,0.1559633027522936,0.9819819819819819,0.27044706005832553,0.916535763747745
0,1,0,1,0.0,1.0,0.25064507986030576,0.9219779406184934
34,81,3,118,0.2956521739130435,0.9745762711864406,0.2400127132539576,0.9402507412641755
136,241,36,413,0.36074270557029176,0.9128329297820823,0.2237507753087935,0.9368685974461963
26,56,25,107,0.3170731707317073,0.7663551401869159,0.21978585881233786,0.9127073501917925
0,33,7,40,0.0,0.825,0.21357467868811428,0.8936597311441734
0,12,2,14,0.0,0.8571428571428571,0.16134733613819105,0.9025555971828967
3,11,2,16,0.21428571428571427,0.875,0.16967910921439405,0.8872724568997565
34,174,59,267,0.16346153846153846,0.7790262172284644,0.19303075756604238,0.8557047736466801
41,109,22,172,0.2733333333333333,0.872093023255814,0.18984235176894093,0.8410643096565904
3,19,4,26,0.13636363636363635,0.8461538461538461,0.15778819902513302,0.831538726281128
11,23,92,126,0.3235294117647059,0.2698412698412698,0.15871051917270423,0.7606081733746073
4,45,3,52,0.08163265306122448,0.9423076923076923,0.17037232675287917,0.777366415132849
16,162,28,206,0.0898876404494382,0.8640776699029126,0.18321341824565604,0.7783571026699997
42,123,3,168,0.2545454545454545,0.9821428571428571,0.18896480971133323,0.7936632251189792
28,114,8,150,0.19718309859154928,0.9466666666666667,0.1937821754441919,0.8176118607530084
37,66,12,115,0.3592233009708738,0.8956521739130435,0.20605217082098343,0.820977453704041
54,166,5,225,0.24545454545454545,0.9777777777777777,0.221636586405399,0.8397808725074599
27,72,1,100,0.2727272727272727,0.99,0.21437913797147998,0.9426606911015643
5,50,5,60,0.09090909090909091,0.9166666666666666,0.21570434337831804,0.9389976874385605
3,23,13,39,0.11538461538461539,0.6666666666666666,0.21934676836905762,0.9107961155476682
42,116,4,162,0.26582278481012656,0.9753086419753086,0.22095781554972507,0.9098197990951613
23,91,26,140,0.20175438596491227,0.8142857142857143,0.22161085660306262,0.8909082344693109
39,77,25,141,0.33620689655172414,0.8226950354609929,0.2183227988288984,0.880485786119018
10,98,2,110,0.09259259259259259,0.9818181818181818,0.19648537699147656,0.8810629866962186
8,54,4,66,0.12903225806451613,0.9393939393939394,0.17595751775393992,0.8738335494667814
12,107,12,131,0.10084033613445378,0.9083969465648855,0.17737626707184886,0.8726521608808125
15,34,1,50,0.30612244897959184,0.98,0.20462452901398837,0.9174140656427173
28,70,1,99,0.2857142857142857,0.98989898989899,0.20746617200029682,0.919498401060386
9,18,3,30,0.3333333333333333,0.9,0.22626316448149986,0.9317432990195699
15,69,12,96,0.17857142857142858,0.875,0.20374381191288618,0.9392154368108566
28,28,1,57,0.5,0.9824561403508771,0.26194487011394435,0.9393065737440986
0,4,57,61,0.0,0.06557377049180328,0.2435116903904421,0.8144751210437935
12,185,10,207,0.06091370558375635,0.9516908212560387,0.23780788602605676,0.8206599602853869
46,172,15,233,0.21100917431192662,0.9356223175965666,0.2242202753592474,0.8143202913706107
44,103,4,151,0.29931972789115646,0.9735099337748344,0.22616390995594324,0.8119789976385885
8,50,7,65,0.13793103448275862,0.8923076923076924,0.1982492958344326,0.8108800965396874
40,184,6,230,0.17857142857142858,0.9739130434782609,0.1982492958344326,0.8250105313222961
0,11,55,66,0.0,0.16666666666666666,0.12682072440586115,0.7084691779388376
6,7,2,15,0.46153846153846156,0.8666666666666667,0.1927547903399271,0.8229110202495322
28,55,5,88,0.3373493975903614,0.9431818181818182,0.23224560348372783,0.8216954483817863
2,60,3,65,0.03225806451612903,0.9538461538461539,0.20670973065575673,0.8242988535602989
44,95,3,142,0.31654676258992803,0.9788732394366197,0.20917073561272406,0.825065040083411
20,112,462,594,0.15151515151515152,0.2222222222222222,0.21111132376020877,0.7293385443569153
1,49,9,59,0.02,0.847457627118644,0.18845826253571898,0.7112734848769701
20,67,20,107,0.22988505747126436,0.8130841121495327,0.22129898503161388,0.8036188342316651
2,0,0,2,1.0,1.0,0.2982220619546908,0.8226664532792842
10,6,1,17,0.625,0.9411764705882353,0.3393150051560677,0.8223799750516295
18,83,4,105,0.1782178217821782,0.9619047619047619,0.36016639905121767,0.8235312047742879
47,80,23,150,0.3700787401574803,0.8466666666666667,0.3678138244180108,0.8046445515214373
26,32,4,62,0.4482758620689655,0.9354838709677419,0.4102082116399842,0.9065390727707975
10,19,2,31,0.3448275862068966,0.9354838709677419,0.4566121525266837,0.9191142504635257
1,22,1,24,0.043478260869565216,0.9583333333333334,0.4399323710488046,0.9359767373135951
35,60,22,117,0.3684210526315789,0.811965811965812,0.34970680713903013,0.9091147104515683
19,88,2,109,0.17757009345794392,0.981651376146789,0.28578824906159356,0.914896839817076
0,1,0,1,0.0,1.0,0.257216820490165,0.9209758671726991
34,81,3,118,0.2956521739130435,0.9745762711864406,0.2423099881920283,0.942009887414133
136,240,37,413,0.3617021276595745,0.910411622276029,0.2310277255574397,0.9382818425238605
25,57,25,107,0.3048780487804878,0.7663551401869159,0.2216716796160279,0.9147562221564741
0,33,7,40,0.0,0.825,0.2154604994918043,0.8957086031088551
0,13,1,14,0.0,0.9285714285714286,0.16282892054443585,0.9123665483382288
4,11,1,16,0.26666666666666666,0.9375,0.17555700243139624,0.9060592088886875
34,171,60,265,0.16585365853658537,0.7735849056603774,0.19925038222233704,0.8737141954115987
41,110,21,172,0.271523178807947,0.877906976744186,0.19580338292160895,0.8599042962055623
4,22,0,26,0.15384615384615385,1.0,0.16610967237683458,0.8727026358804153
15,40,71,126,0.2727272727272727,0.4365079365079365,0.16151670436923243,0.8255816067834182
4,45,3,52,0.08163265306122448,0.9423076923076923,0.17317851194940737,0.84233984854166
16,162,28,206,0.0898876404494382,0.8640776699029126,0.18601960344218424,0.8331264544461578
41,124,3,168,0.24848484848484848,0.9821428571428571,0.18342220084478167,0.8395040054665658
34,108,8,150,0.23943661971830985,0.9466666666666667,0.19393405244217085,0.8642299713246071
40,64,11,115,0.38461538461538464,0.9043478260869565,0.21009008184323338,0.8680072355164316
53,167,5,225,0.2409090909090909,0.9777777777777777,0.2225276442807958,0.8648326323418284
27,72,1,100,0.2727272727272727,0.99,0.2225276442807958,0.9439029271264089
4,55,1,60,0.06779661016949153,0.9833333333333333,0.22055106672483396,0.9497637329872147
3,23,13,39,0.11538461538461539,0.6666666666666666,0.22419349171557354,0.9215621610963224
36,122,4,162,0.22784810126582278,0.9753086419753086,0.2212453849699985,0.9205858446438155
23,91,26,140,0.20175438596491227,0.8142857142857143,0.2158622087195131,0.9016742800179652
38,79,24,141,0.3247863247863248,0.8297872340425532,0.20731520017250454,0.8910227668687647
10,98,2,110,0.09259259259259259,0.9818181818181818,0.18612712898443334,0.8915999674459653
8,54,4,66,0.12903225806451613,0.9393939393939394,0.1655992697468967,0.884370530216528
11,108,12,131,0.09243697478991597,0.9083969465648855,0.16911932183552875,0.8736653321067498
14,35,1,50,0.2857142857142857,0.98,0.19345213188262456,0.9184272368686547
29,69,1,99,0.29591836734693877,0.98989898989899,0.20317645560849826,0.9205115722863234
10,16,4,30,0.38461538461538464,0.8666666666666667,0.2292994554157086,0.9279945654836022
15,74,7,96,0.16853932584269662,0.9270833333333334,0.2069784555666188,0.941894008239428
28,28,1,57,0.5,0.9824561403508771,0.265179513767677,0.9419851451726702
0,4,57,61,0.0,0.06557377049180328,0.24674633404417473,0.817153692472365
11,186,10,207,0.05583756345177665,0.9516908212560387,0.24151784671015483,0.8233385317139582
48,171,13,232,0.2191780821917808,0.9439655172413793,0.23201267477836843,0.8181907484627269
46,102,3,151,0.3108108108108108,0.9801324503311258,0.2341401667017787,0.8167955285244605
9,49,7,65,0.15517241379310345,0.8923076923076924,0.20136259944145282,0.8204585321874642
37,187,6,230,0.16517857142857142,0.9739130434782609,0.20088249166800637,0.8271484907795966
9,55,1,65,0.140625,0.9846153846153847,0.14954320595372067,0.8274569542459549
5,8,2,15,0.38461538461538464,0.8666666666666667,0.20448826089877561,0.9418987965566498
28,55,5,88,0.3373493975903614,0.9431818181818182,0.24470423720428772,0.9406832246889039
3,59,3,65,0.04838709677419355,0.9538461538461539,0.22030552500177522,0.9420947442038716
43,96,3,142,0.30935251798561153,0.9788732394366197,0.22009719745531822,0.941914856933228
25,109,460,594,0.1865671641791045,0.2255892255892256,0.2245821617961755,0.8466693616877327
1,49,9,59,0.02,0.847457627118644,0.20384236587780816,0.8286043022077874
20,67,20,107,0.22988505747126436,0.8130841121495327,0.21659380265941736,0.8040998347126658
2,0,0,2,1.0,1.0,0.30450589057150523,0.8231474537602848
10,6,1,17,0.625,0.9411764705882353,0.3455988337728822,0.82286097553263
14,87,4,105,0.13861386138613863,0.9619047619047619,0.3584883715745887,0.8240122052552883
47,80,23,150,0.3700787401574803,0.8466666666666667,0.36716354617056984,0.805125552002438
28,31,4,63,0.4745762711864407,0.9365079365079365,0.40830770431447505,0.9066853678479679
10,19,2,31,0.3448275862068966,0.9354838709677419,0.45471164520117463,0.9192605455406964
1,20,1,22,0.047619047619047616,0.9545454545454546,0.4390711275093843,0.9376526136811467
31,59,24,114,0.34444444444444444,0.7894736842105263,0.3454203338585907,0.9075774257112219
18,76,2,96,0.19148936170212766,0.9791666666666666,0.28349024267318035,0.9130045965795693
0,1,0,1,0.0,1.0,0.2549188141017518,0.9190836239351924
32,70,3,105,0.3137254901960784,0.9714285714285714,0.24404666863339494,0.937450970873968
134,207,36,377,0.39296187683284456,0.9045092838196287,0.23723008445213065,0.9328797347756382
24,48,25,97,0.3333333333333333,0.7422680412371134,0.23193907916112533,0.9059131002725657
0,27,7,34,0.0,0.7941176470588235,0.22513635807268997,0.8829948420601899
0,12,2,14,0.0,0.8571428571428571,0.17593000886634075,0.8926618667648086
2,7,2,11,0.2222222222222222,0.8181818181818182,0.18032041751206856,0.869664031266973
33,149,60,242,0.1813186813186813,0.7520661157024794,0.20622308627188016,0.8342449049387558
40,95,22,157,0.2962962962962963,0.8598726114649682,0.20373320142905418,0.8183083392296696
3,18,4,25,0.14285714285714285,0.84,0.16800395371823962,0.809092727255437
10,20,92,122,0.3333333333333333,0.2459016393442623,0.16800395371823962,0.738183241270744
3,42,3,48,0.06666666666666667,0.9375,0.17752776324204914,0.7586664345480549
13,148,28,189,0.08074534161490683,0.8518518518518519,0.18906281204417869,0.7579105766493398
39,96,3,138,0.28888888888888886,0.9782608695652174,0.1985866215679882,0.780779012561254
31,104,8,143,0.22962962962962963,0.9440559440559441,0.2054881856124094,0.8082061308974632
36,57,14,107,0.3870967741935484,0.8691588785046729,0.218459682454874,0.8095327404745639
53,167,5,225,0.2409090909090909,0.9777777777777777,0.23246710360515227,0.8292152801571036
23,59,1,83,0.2804878048780488,0.9879518072289156,0.2249177423972545,0.9352224469977684
5,43,5,53,0.10416666666666667,0.9056603773584906,0.23027488525439735,0.9306739294775527
3,21,12,36,0.125,0.6666666666666666,0.23659697930941068,0.9042189030225263
44,109,4,157,0.2875816993464052,0.9745222929936306,0.23641023794619873,0.9036848206551567
22,83,26,131,0.20952380952380953,0.8015267175572519,0.23353797793108153,0.883323502583915
35,65,25,125,0.35,0.8,0.22823843876057465,0.8734436627975332
10,91,2,103,0.09900990099009901,0.9805825242718447,0.20796712591500438,0.8738443408681142
9,51,4,64,0.15,0.9375,0.18932601093242596,0.866636939835412
10,97,13,120,0.09345794392523364,0.8916666666666667,0.18779619339793555,0.8646378383080087
15,31,1,47,0.32608695652173914,0.9787234042553191,0.2165229014724697,0.9092173722492446
27,67,1,95,0.2872340425531915,0.9894736842105263,0.2164732362162963,0.9113532852802297
9,17,3,29,0.34615384615384615,0.896551724137931,0.2359918128777301,0.9249282862203267
13,56,11,80,0.18840579710144928,0.8625,0.21290692674936573,0.9338568576488981
27,25,1,53,0.5192307692307693,0.9811320754716981,0.27293847935517573,0.933935364963163
0,2,57,59,0.0,0.03389830508474576,0.2515099079266043,0.804849408546698
11,158,10,179,0.0650887573964497,0.9441340782122905,0.24745716699392092,0.8123447530532156
47,136,16,199,0.2568306010928962,0.9195979899497487,0.2375634019326576,0.8038982652952772
42,92,3,137,0.31343283582089554,0.9781021897810219,0.24130608668518677,0.8022737660910622
8,48,7,63,0.14285714285714285,0.8888888888888888,0.21226370049994342,0.801179075341199
42,172,6,220,0.19626168224299065,0.9727272727272728,0.21338596980587793,0.8169258285879523
1,9,55,65,0.1,0.15384615384615385,0.15349585991576806,0.6987421254985887
5,7,2,14,0.4166666666666667,0.8571428571428571,0.21301966943957756,0.8163484900783189
27,44,5,76,0.38028169014084506,0.9342105263157895,0.25804723126020546,0.8149308398073903
1,60,3,64,0.01639344262295082,0.953125,0.223699065764499,0.8197204126717119
41,78,3,122,0.3445378151260504,0.9754098360655737,0.22814263423666398,0.8193357907123621
21,86,398,505,0.19626168224299065,0.21188118811881188,0.23577185414892793,0.7226204048880654
1,43,9,53,0.022727272727272728,0.8301886792452831,0.21098122421811108,0.7022577486763525
20,61,20,101,0.24691358024691357,0.801980198019802,0.23196887853909878,0.7948483264154452
2,0,0,2,1.0,1.0,0.31530221187243207,0.8152564896807514
10,6,1,17,0.625,0.9411764705882353,0.3502619704237399,0.8162516245768149
18,72,4,94,0.2,0.9574468085106383,0.37649147862046123,0.8168690257926204
46,69,24,139,0.4,0.8273381294964028,0.3844146478881683,0.7957159248541675
26,33,4,63,0.4406779661016949,0.9365079365079365,0.41933125986798325,0.8992340317668995
10,17,2,29,0.37037037037037035,0.9310344827586207,0.4689945595312829,0.9136405751259479
1,20,1,22,0.047619047619047616,0.9545454545454546,0.4209092576083312,0.9385169277877328
32,59,23,114,0.3516483516483517,0.7982456140350878,0.32828759355809567,0.9096948726498881
16,78,2,96,0.1702127659574468,0.9791666666666666,0.26331798869487383,0.9151220435182356
0,1,0,1,0.0,1.0,0.2392727270258498,0.9205642203889839
33,72,3,108,0.3142857142857143,0.9722222222222222,0.22861513065396766,0.9394531092778726
132,208,37,377,0.38823529411764707,0.9018567639257294,0.22112332037053228,0.9345029417661289
26,46,25,97,0.3611111111111111,0.7422680412371134,0.23330175496275998,0.9069006803760391
0,27,7,34,0.0,0.7941176470588235,0.22649903387432463,0.8839824221636633
0,12,2,14,0.0,0.8571428571428571,0.17626355506741723,0.8923963140362016
2,7,2,11,0.2222222222222222,0.8181818181818182,0.18369347739095657,0.869398478538366
34,152,56,242,0.1827956989247312,0.768595041322314,0.20980714866591815,0.8363406272986966
41,94,22,157,0.3037037037037037,0.8598726114649682,0.20829543286848806,0.8202906829048034
3,18,4,25,0.14285714285714285,0.84,0.17324141125984463,0.8114540023439848
11,20,91,122,0.3548387096774194,0.2540983606557377,0.1723453539121744,0.7417154765466453
3,42,3,48,0.06666666666666667,0.9375,0.18186916343598392,0.7621986698239562
14,149,27,190,0.08588957055214724,0.8578947368421053,0.19413910208629065,0.7623060812095632
36,96,3,135,0.2727272727272727,0.9777777777777777,0.20135410930129788,0.785105504008986
30,106,7,143,0.22058823529411764,0.951048951048951,0.20675304306835307,0.8111703482556484
36,63,8,107,0.36363636363636365,0.9252336448598131,0.21531485163016165,0.8205076387406262
53,167,5,225,0.2409090909090909,0.9777777777777777,0.22932227278043996,0.8401901784231659
21,61,1,83,0.25609756097560976,0.9879518072289156,0.2152163943944671,0.9450263850764771
7,45,1,53,0.1346153846153846,0.9811320754716981,0.22492335410142683,0.9512595387152911
3,21,12,36,0.125,0.6666666666666666,0.23051055830826295,0.9239412429759427
43,111,4,158,0.2792207792207792,0.9746835443037974,0.2314382020930496,0.923499209622517
22,83,26,131,0.20952380952380953,0.8015267175572519,0.22985756984014843,0.9021388905522743
34,65,26,125,0.3434343434343434,0.792,0.22697156695414553,0.8831055127151581
11,90,2,103,0.10891089108910891,0.9805825242718447,0.20811468126557672,0.883506190785739
9,51,4,64,0.15,0.9375,0.19295788684048956,0.8762987897530368
10,98,12,120,0.09259259259259259,0.9,0.18695463083723357,0.86470849325708
14,32,1,47,0.30434782608695654,0.9787234042553191,0.21257574884965594,0.909288027198316
27,67,1,95,0.2872340425531915,0.9894736842105263,0.21372050075428625,0.9114009043278487
8,18,3,29,0.3076923076923077,0.896551724137931,0.22774457192121458,0.9249759052679458
12,56,12,80,0.17647058823529413,0.85,0.20389260689277894,0.93326161955366
28,23,2,53,0.5490196078431373,0.9622641509433962,0.266765280714783,0.9306447090781674
0,2,57,59,0.0,0.03389830508474576,0.2453367092862116,0.8015587526617026
12,157,10,179,0.07100591715976332,0.9441340782122905,0.24225289851009313,0.807863620977744
45,139,15,199,0.24456521739130435,0.9246231155778895,0.23371252583928565,0.8001350083095398
40,93,3,136,0.3007518796992481,0.9779411764705882,0.23564364543157948,0.7984875072038343
7,49,7,63,0.125,0.8888888888888888,0.20954474433267833,0.7973928164539712
42,172,6,220,0.19626168224299065,0.9727272727272728,0.21237204347663502,0.8149252839864387
0,9,56,65,0.0,0.13846153846153847,0.13394067092761539,0.6972391964890303
5,7,2,14,0.4166666666666667,0.8571428571428571,0.19346448045142492,0.8148455610687606
24,48,5,77,0.3333333333333333,0.935064935064935,0.23093982561907778,0.813549969190567
1,60,3,64,0.01639344262295082,0.953125,0.19834385779502725,0.8176216669651541
42,76,3,121,0.3559322033898305,0.9752066115702479,0.20622676117939617,0.8172310148365342
21,88,397,506,0.1926605504587156,0.21541501976284586,0.21589255410206984,0.7210204621042423
1,43,9,53,0.022727272727272728,0.8301886792452831,0.19110192417125302,0.7006578058925295
19,62,20,101,0.2345679012345679,0.801980198019802,0.22461162434761986,0.7954461858294243
2,0,0,2,1.0,1.0,0.3079449576809532,0.8158543490947304
10,6,1,17,0.625,0.9411764705882353,0.34961162434761983,0.8167274255980591
18,72,4,94,0.2,0.9574468085106383,0.37584113254434115,0.8173448268138646
46,72,22,140,0.3898305084745763,0.8428571428571429,0.3806837475564477,0.7984377598548497
26,33,4,63,0.4406779661016949,0.9365079365079365,0.4161148069340162,0.9014510336755767
10,17,2,29,0.37037037037037035,0.9310344827586207,0.46577810659731583,0.915857577034625
1,22,1,24,0.043478260869565216,0.9583333333333334,0.4255244653274325,0.9390580533288583
34,59,24,117,0.3655913978494624,0.7948717948717948,0.33489466502021287,0.909754024024829
16,94,2,112,0.14545454545454545,0.9821428571428571,0.26638817151371935,0.9156063649612036
0,1,0,1,0.0,1.0,0.24092848268769387,0.9210485418319518
34,85,3,122,0.2857142857142857,0.9754098360655737,0.2273230405108231,0.9403928041270337
134,246,36,416,0.3526315789473684,0.9134615384615384,0.2147449852030622,0.937100461548977
28,54,25,107,0.34146341463414637,0.7663551401869159,0.21919049763848214,0.9129392142945731
0,32,7,39,0.0,0.8205128205128205,0.21297931751425853,0.8932505696059285
0,12,2,14,0.0,0.8571428571428571,0.16075197496433533,0.9021464356446518
2,12,2,16,0.14285714285714285,0.875,0.16038091745042066,0.8868403131956721
36,173,60,269,0.1722488038277512,0.7769516728624535,0.18498788942581368,0.8549762664617369
40,111,21,172,0.26490066225165565,0.877906976744186,0.18201451464543797,0.8410472865586816
4,18,4,26,0.18181818181818182,0.8461538461538461,0.1576126007698399,0.8314319019432969
9,19,98,126,0.32142857142857145,0.2222222222222222,0.1547504803119006,0.7536986279483406
3,47,3,53,0.06,0.9433962264150944,0.16332190888332918,0.7712534002200941
11,167,28,206,0.06179775280898876,0.8640776699029126,0.1721501592846133,0.7722440877572448
36,129,3,168,0.21818181818181817,0.9821428571428571,0.18291082718813836,0.7875502102062244
30,113,7,150,0.2097902097902098,0.9533333333333334,0.18827388518277527,0.812747590273493
34,71,12,117,0.3238095238095238,0.8974358974358975,0.19668943683389933,0.8155374360865946
53,167,5,225,0.2409090909090909,0.9777777777777777,0.20513099527545778,0.8343408548900134
29,72,1,102,0.2871287128712871,0.9901960784313726,0.20023101548156,0.944051405777035
6,49,5,60,0.10909090909090909,0.9166666666666666,0.207244002494547,0.9402328972415451
2,24,13,39,0.07692307692307693,0.6666666666666666,0.20940476308227388,0.9120313253506529
43,115,4,162,0.2721518987341772,0.9753086419753086,0.21711477458975376,0.9110550088981461
23,91,26,140,0.20175438596491227,0.8142857142857143,0.21596679975756836,0.8911910633199147
36,80,25,141,0.3103448275862069,0.8226950354609929,0.21404327172566595,0.8805137973234997
7,101,2,110,0.06481481481481481,0.9818181818181818,0.1888869465693408,0.8810909979007003
8,54,4,66,0.12903225806451613,0.9393939393939394,0.16630173873980209,0.8738335494667814
11,110,12,133,0.09090909090909091,0.9097744360902256,0.16370433614239951,0.8728489450987185
12,36,2,50,0.25,0.96,0.18842961086767424,0.9147537070034802
28,70,1,99,0.2857142857142857,0.98989898989899,0.1903670947219754,0.916838042421149
10,17,3,30,0.37037037037037035,0.9,0.21445509249418374,0.9290829403803328
12,72,12,96,0.14285714285714285,0.875,0.19052828039003172,0.9365550781716195
27,28,2,57,0.4909090909090909,0.9649122807017544,0.2513988912606426,0.9341399494407012
0,4,57,61,0.0,0.06557377049180328,0.23296571153714027,0.8093084967403961
11,187,10,208,0.05555555555555555,0.9519230769230769,0.2279152064866352,0.815329731145089
46,176,13,235,0.2072072072072072,0.9446808510638298,0.2218019503733791,0.8131412812970648
36,101,14,151,0.26277372262773724,0.9072847682119205,0.2185247270753008,0.8013392496274835
7,51,7,65,0.1206896551724138,0.8923076923076924,0.18285605347559272,0.8002403485285823
37,188,6,231,0.16444444444444445,0.974025974025974,0.18593995370235006,0.8143869162465786
0,8,57,65,0.0,0.12307692307692308,0.11581008357247995,0.6941247223001741
5,8,2,15,0.38461538461538464,0.8666666666666667,0.1707551385175349,0.8085665646108688
25,58,5,88,0.30120481927710846,0.9431818181818182,0.20584789047775673,0.8073178133621176
2,60,3,65,0.03225806451612903,0.9538461538461539,0.18085515580760272,0.8086271423310211
39,101,3,143,0.2785714285714286,0.9790209790209791,0.18311197094241577,0.8188751724466009
19,121,454,594,0.1357142857142857,0.2356902356902357,0.18525834673411176,0.7250726786441072
1,49,9,59,0.02,0.847457627118644,0.1646234260991911,0.7069914862287742
21,66,20,107,0.2413793103448276,0.8130841121495327,0.19910618471988076,0.8055639418105757
2,0,0,2,1.0,1.0,0.2870182726319687,0.8246115608581948
10,6,1,17,0.625,0.9411764705882353,0.3332747270209532,0.8243250826305399
17,84,4,105,0.16831683168316833,0.9619047619047619,0.35271169375910166,0.8254763123531983
49,77,24,150,0.3888888888888889,0.84,0.3684713309473103,0.8056161724930584
26,33,4,63,0.4406779661016949,0.9365079365079365,0.41203757100265437,0.905732986895587
8,21,2,31,0.27586206896551724,0.9354838709677419,0.44858929514058543,0.9183081645883153
1,22,1,24,0.043478260869565216,0.9583333333333334,0.42906613997783205,0.9423233594513073
34,59,24,117,0.3655913978494624,0.7948717948717948,0.33843633967061243,0.913019330147278
15,95,2,112,0.13636363636363635,0.9821428571428571,0.2686311448654176,0.9188716710836525
0,1,0,1,0.0,1.0,0.2448216210558938,0.9229533037367137
33,86,3,122,0.2773109243697479,0.9754098360655737,0.22974996739442924,0.9403928041270337
133,247,36,416,0.35,0.9134615384615384,0.21679597223704425,0.9371004615489769
29,53,25,107,0.35365853658536583,0.7663551401869159,0.21805753657682558,0.9129392142945731
0,32,7,39,0.0,0.8205128205128205,0.21184635645260194,0.8932505696059285
0,12,2,14,0.0,0.8571428571428571,0.15961901390267874,0.9021464356446517
3,11,2,16,0.21428571428571427,0.875,0.17075073932011847,0.886840313195672
36,172,60,268,0.17307692307692307,0.7761194029850746,0.19547601404539322,0.8548573707649684
39,112,21,172,0.2582781456953642,0.877906976744186,0.19275704566333834,0.8409283908619132
4,18,4,26,0.18181818181818182,0.8461538461538461,0.16873107163736437,0.8313130062465285
10,18,98,126,0.35714285714285715,0.2222222222222222,0.169228831717006,0.7535797322515723
3,47,3,53,0.06,0.9433962264150944,0.17780026028843454,0.7711345045233257
10,168,28,206,0.056179775280898875,0.8640776699029126,0.18582594247142012,0.7721251920604765
37,128,3,168,0.22424242424242424,0.9821428571428571,0.18724832960809296,0.7874313145094561
33,109,8,150,0.2323943661971831,0.9466666666666667,0.1957222500538444,0.8117952093211119
35,70,12,117,0.3333333333333333,0.8974358974358975,0.20644441971641142,0.8145850551342136
52,168,5,225,0.23636363636363636,0.9777777777777777,0.2142366275086192,0.8333884739376325
29,72,1,102,0.2871287128712871,0.9901960784313726,0.20423460689839487,0.9430990248246539
8,47,5,60,0.14545454545454545,0.9166666666666666,0.2164423991061871,0.9392805162891642
2,24,13,39,0.07692307692307693,0.6666666666666666,0.21940572791221255,0.911078944398272
44,114,4,162,0.27848101265822783,0.9753086419753086,0.22715409768589878,0.910102627945765
23,91,26,140,0.20175438596491227,0.8142857142857143,0.2227769576527172,0.8911910633199148
37,79,25,141,0.31896551724137934,0.8226950354609929,0.22072441249672378,0.8805137973234999
7,101,2,110,0.06481481481481481,0.9818181818181818,0.19621743798974928,0.8810909979007003
8,54,4,66,0.12903225806451613,0.9393939393939394,0.17363223016021062,0.8738335494667814
11,110,12,133,0.09090909090909091,0.9097744360902256,0.1658400223680028,0.8728489450987185
11,37,2,50,0.22916666666666666,0.96,0.18758910661708708,0.9147537070034802
27,71,1,99,0.2755102040816326,0.98989898989899,0.18716470539185917,0.916838042421149
11,16,3,30,0.4074074074074074,0.9,0.21654370845507273,0.9290829403803327
11,72,13,96,0.13253012048192772,0.8645833333333334,0.18991008034657963,0.9350669829335241
26,29,2,57,0.4727272727272727,0.9649122807017544,0.24818328861978792,0.932651854202606
0,4,57,61,0.0,0.06557377049180328,0.22975010889628564,0.8078204015023008
11,187,10,208,0.05555555555555555,0.9519230769230769,0.22469960384578055,0.8138416359069938
46,175,14,235,0.2081447963800905,0.9404255319148936,0.22169647951912683,0.8110452833234072
36,102,13,151,0.2608695652173913,0.9139072847682119,0.21960495968137808,0.8001893254475819
7,51,7,65,0.1206896551724138,0.8923076923076924,0.1786452807906647,0.7990904243486806
35,190,6,231,0.15555555555555556,0.974025974025974,0.18193462865832583,0.8147250873047722
1,7,57,65,0.125,0.12307692307692308,0.13225930398300115,0.6944628933583677
5,8,2,15,0.38461538461538464,0.8666666666666667,0.1872043589280561,0.8089047356690625
25,58,5,88,0.30120481927710846,0.9431818181818182,0.22229711088827792,0.8076559844203113
2,60,3,65,0.03225806451612903,0.9538461538461539,0.19717043490771205,0.8095732161247771
40,100,3,143,0.2857142857142857,0.9790209790209791,0.20071968069298265,0.8188751724466009
18,124,452,594,0.1267605633802817,0.23905723905723905,0.20158695329410664,0.7255536791251076
1,49,9,59,0.02,0.847457627118644,0.18222187392902728,0.7074724867097748
21,66,20,107,0.2413793103448276,0.8130841121495327,0.19884748969257407,0.8060449422915761
2,0,0,2,1.0,1.0,0.286759577604662,0.8250925613391953
10,6,1,17,0.625,0.9411764705882353,0.3330160319936465,0.8248060831115405
18,83,4,105,0.1782178217821782,0.9619047619047619,0.3538674258887963,0.8259573128341987
48,78,24,150,0.38095238095238093,0.84,0.3674728680656671,0.8060971729740588
26,33,4,63,0.4406779661016949,0.9365079365079365,0.4123182113115833,0.9057329868955871
9,20,2,31,0.3103448275862069,0.9354838709677419,0.45379604382389854,0.9183081645883153
1,22,1,24,0.043478260869565216,0.9583333333333334,0.35652149712068926,0.9423233594513073
34,60,23,117,0.3617021276595745,0.8034188034188035,0.3367646582149142,0.9142403313682792
16,94,2,112,0.14545454545454545,0.9821428571428571,0.2682581647084207,0.9200926723046537
0,1,0,1,0.0,1.0,0.24444864089889684,0.9241743049577149
34,85,3,122,0.2857142857142857,0.9754098360655737,0.23169353885808053,0.941613805348035
136,243,37,416,0.35883905013192613,0.9110576923076923,0.22000226514811355,0.9379780561765717
29,53,25,107,0.35365853658536583,0.7663551401869159,0.22126382948789486,0.913816808922168
0,32,7,39,0.0,0.8205128205128205,0.2150526493636713,0.8941281642335231
0,12,2,14,0.0,0.8571428571428571,0.1633809168408749,0.9018030290512451
3,11,2,16,0.21428571428571427,0.875,0.17321394095961334,0.8864969066022655
36,172,60,268,0.17307692307692307,0.7761194029850746,0.19793921568488806,0.854513964171562
41,109,22,172,0.2733333333333333,0.872093023255814,0.19617050820189483,0.8397544194844534
3,19,4,26,0.13636363636363635,0.8461538461538461,0.16438830623499628,0.8304824414624753
9,24,93,126,0.2727272727272727,0.2619047619047619,0.15282669711241156,0.7584181017078818
4,46,3,53,0.08,0.9433962264150944,0.16425526854098302,0.7759728739796353
12,166,28,206,0.06741573033707865,0.8640776699029126,0.17388608716056567,0.7769635615167861
37,128,3,168,0.22424242424242424,0.9821428571428571,0.17530847429723856,0.7922696839657657
34,108,8,150,0.23943661971830985,0.9466666666666667,0.1847884309602938,0.8166335787774217
36,72,9,117,0.3333333333333333,0.9230769230769231,0.19335985953172233,0.82391699303758
52,168,5,225,0.23636363636363636,0.9777777777777777,0.20764557381743662,0.8427204118409989
29,72,1,102,0.2871287128712871,0.9901960784313726,0.2097029224094387,0.9467620284876576
7,52,1,60,0.11864406779661017,0.9833333333333333,0.21522350352324013,0.9524673294759775
3,23,13,39,0.11538461538461539,0.6666666666666666,0.22207620138717396,0.9242657575850852
42,116,4,162,0.26582278481012656,0.9753086419753086,0.2280162528968457,0.9232894411325783
23,91,26,140,0.20175438596491227,0.8142857142857143,0.22263307664636037,0.9043778765067279
35,81,25,141,0.3017241379310345,0.8226950354609929,0.21811747730317482,0.8900376068473094
6,102,2,110,0.05555555555555555,0.9818181818181818,0.19228775147344898,0.8906148074245099
9,53,4,66,0.14516129032258066,0.9393939393939394,0.17200669110934808,0.883357358990591
11,110,12,133,0.09090909090909091,0.9097744360902256,0.16804455155398818,0.8728489450987184
15,33,2,50,0.3125,0.96,0.19620389221332885,0.9147537070034801
29,69,1,99,0.29591836734693877,0.98989898989899,0.20050326114715913,0.916838042421149
10,17,3,30,0.37037037037037035,0.9,0.22459125891936743,0.9290829403803327
11,72,13,96,0.13253012048192772,0.8645833333333334,0.20042068499806648,0.9350669829335242
26,29,1,56,0.4727272727272727,0.9821428571428571,0.26001664459402607,0.9351133651227634
0,4,57,61,0.0,0.06557377049180328,0.239279317405086,0.8102819124224583
11,187,10,208,0.05555555555555555,0.9519230769230769,0.2342288123545809,0.8163031468271514
44,177,14,235,0.19909502262443438,0.9404255319148936,0.21802810130092867,0.8135067942435648
44,104,3,151,0.2972972972972973,0.9801324503311258,0.21822509129383705,0.8121115743052985
6,52,7,65,0.10344827586206896,0.8923076923076924,0.18009336350693683,0.8110126732063974
41,184,6,231,0.18222222222222223,0.974025974025974,0.18719223518412179,0.8266473361624888
0,10,55,65,0.0,0.15384615384615385,0.11965976765165424,0.7083192356915313
5,8,2,15,0.38461538461538464,0.8666666666666667,0.1746048225967092,0.822761078002226
25,58,5,88,0.30120481927710846,0.9431818181818182,0.20969757455693103,0.8215123267534749
2,60,3,65,0.03225806451612903,0.9538461538461539,0.18586372339860172,0.8234295584579405
40,100,3,143,0.2857142857142857,0.9790209790209791,0.18420900745817148,0.8232707768422053
14,111,469,594,0.112,0.21043771043771045,0.18543068233501875,0.7258607794322078
1,49,9,59,0.02,0.847457627118644,0.1622560791604156,0.7077795870168752
20,67,20,107,0.22988505747126436,0.8130841121495327,0.19509680165631052,0.8019564382030719
2,0,0,2,1.0,1.0,0.28300888956839837,0.821004057250691
10,6,1,17,0.625,0.9411764705882353,0.32926534395738294,0.8207175790230364
17,85,3,105,0.16666666666666666,0.9714285714285714,0.34846657283603116,0.8232293529633817
49,79,22,150,0.3828125,0.8533333333333334,0.36233774630541893,0.8052739750080038
26,33,4,63,0.4406779661016949,0.9365079365079365,0.40929174146280384,0.9089982930180361
10,19,2,31,0.3448275862068966,0.9354838709677419,0.4556956823495034,0.9215734707107643
1,22,1,24,0.043478260869565216,0.9583333333333334,0.42748892386183807,0.9413709784989264
35,60,22,117,0.3684210526315789,0.811965811965812,0.3372633599520637,0.9145089516368994
18,92,2,112,0.16363636363636364,0.9821428571428571,0.2802828404715442,0.920361292573274
0,1,0,1,0.0,1.0,0.2564733166620204,0.9244429252263353
34,85,3,122,0.2857142857142857,0.9754098360655737,0.23767209538610845,0.9428348065690362
134,246,36,416,0.3526315789473684,0.9134615384615384,0.22267273257229428,0.9395424639909794
29,53,25,107,0.35365853658536583,0.7663551401869159,0.2239342969120756,0.9153812167365756
0,31,7,38,0.0,0.8157894736842105,0.21772311678785197,0.8950178082152724
0,12,2,14,0.0,0.8571428571428571,0.16509153784048358,0.9014716718119932
3,11,2,16,0.21428571428571427,0.875,0.17232715936181936,0.8861655493630135
37,172,60,269,0.17703349282296652,0.7769516728624535,0.19761765833652886,0.8543015026290783
41,109,22,172,0.2733333333333333,0.872093023255814,0.19584895085353568,0.8395419579419698
3,19,4,26,0.13636363636363635,0.8461538461538461,0.16495353048443112,0.8299265733265851
9,24,93,126,0.2727272727272727,0.2619047619047619,0.15339192136184637,0.7578622335719917
4,46,3,53,0.08,0.9433962264150944,0.16482049279041777,0.7760917696764037
15,162,28,205,0.0847457627118644,0.8634146341463415,0.1769270303206841,0.7769877378197586
36,129,3,168,0.21818181818181817,0.9821428571428571,0.17748361659155612,0.7922938602687383
31,112,7,150,0.21678321678321677,0.9533333333333334,0.1831621485858776,0.8174912403360067
38,70,8,116,0.35185185185185186,0.9310344827586207,0.1943790798028088,0.8259114488364077
52,168,5,225,0.23636363636363636,0.9777777777777777,0.20866479408852306,0.8447148676398265
29,72,1,102,0.2871287128712871,0.9901960784313726,0.21072214268052517,0.9487564842864852
6,49,5,60,0.10909090909090909,0.9166666666666666,0.2148779868363693,0.9449379757509956
3,23,13,39,0.11538461538461539,0.6666666666666666,0.21925496578961945,0.9168311232538991
40,118,4,162,0.25316455696202533,0.9753086419753086,0.2242524999010776,0.9158548068013922
23,90,27,140,0.20353982300884957,0.8071428571428572,0.22236058650473942,0.8949704530598955
34,82,25,141,0.29310344827586204,0.8226950354609929,0.21396795742245517,0.8794933891602346
8,100,2,110,0.07407407407407407,0.9818181818181818,0.190783734238232,0.880070589737435
9,53,4,66,0.14516129032258066,0.9393939393939394,0.17050267387413107,0.8728131413035161
11,110,12,133,0.09090909090909091,0.9097744360902256,0.16790527127672844,0.871828536935453
15,34,1,50,0.30612244897959184,0.98,0.19515353321886794,0.9165904416973579
30,68,1,99,0.30612244897959184,0.98989898989899,0.20271894636423463,0.9186747771150265
10,16,4,30,0.38461538461538464,0.8666666666666667,0.22858688373659677,0.9271781784755707
11,73,12,96,0.13095238095238096,0.875,0.20542244554752803,0.9346503162668576
25,30,1,56,0.45454545454545453,0.9821428571428571,0.2597754999005824,0.9346966984560969
0,4,57,61,0.0,0.06557377049180328,0.23903817271164232,0.8098652457557918
11,187,10,208,0.05555555555555555,0.9519230769230769,0.23398766766113724,0.8158864801604847
45,176,14,235,0.20361990950226244,0.9404255319148936,0.21934444773580447,0.8102329847197552
43,105,3,151,0.2905405405405405,0.9801324503311258,0.21711846081593997,0.8088377647814889
6,52,7,65,0.10344827586206896,0.8923076923076924,0.17695173099403777,0.8125007684444926
36,187,6,229,0.16143497757847533,0.9737991266375546,0.18130638765490836,0.8266149293927146
0,10,55,65,0.0,0.15384615384615385,0.11637132271984345,0.7082868289217571
5,8,2,15,0.38461538461538464,0.8666666666666667,0.1713163776648984,0.8227286712324517
28,55,5,88,0.3373493975903614,0.9431818181818182,0.2115726408127278,0.8214799199837006
2,60,3,65,0.03225806451612903,0.9538461538461539,0.18709237724328018,0.8233971516881663
40,100,3,143,0.2857142857142857,0.9790209790209791,0.18640291226810093,0.8232383700724312
14,111,469,594,0.112,0.21043771043771045,0.18762458714494823,0.7258283726624336
1,49,9,59,0.02,0.847457627118644,0.16741959034802315,0.7077795870168752
21,66,20,107,0.2413793103448276,0.8130841121495327,0.2019023489687128,0.8019564382030719
1,1,0,2,0.5,1.0,0.2183858654522293,0.821004057250691
10,6,1,17,0.625,0.9411764705882353,0.2594788086536063,0.8207175790230364
17,85,3,105,0.16666666666666666,0.9714285714285714,0.2786800375322545,0.8232293529633817
48,80,22,150,0.375,0.8533333333333334,0.2914351395730708,0.8052739750080038
26,33,4,63,0.4406779661016949,0.9365079365079365,0.3383891347304558,0.9089982930180361
10,19,2,31,0.3448275862068966,0.9354838709677419,0.3847930756171553,0.9215734707107642
2,21,1,24,0.08695652173913043,0.9583333333333334,0.4383869044030642,0.9386930878979127
35,60,22,117,0.3684210526315789,0.811965811965812,0.34816134049328973,0.9118310610358858
18,92,2,112,0.16363636363636364,0.9821428571428571,0.29118082101277026,0.9176834019722604
0,1,0,1,0.0,1.0,0.2629233641838849,0.9222426724889778
32,84,3,119,0.27586206896551724,0.9747899159663865,0.2412821701288977,0.9421106196678494
131,251,34,416,0.34293193717277487,0.9182692307692307,0.2297397592165338,0.9395050902766057
27,55,25,107,0.32926829268292684,0.7663551401869159,0.22386803383261333,0.9159794699092192
0,31,7,38,0.0,0.8157894736842105,0.2114456735841661,0.8956160613879159
0,13,1,14,0.0,0.9285714285714286,0.15881409463679771,0.9122740066172899
3,12,1,16,0.2,0.9375,0.16400889983160288,0.9058964555968816
37,172,60,269,0.17703349282296652,0.7769516728624535,0.18929939880631239,0.8740324088629464
41,109,22,172,0.2733333333333333,0.872093023255814,0.18893815085885754,0.8593614241900074
3,23,0,26,0.11538461538461539,1.0,0.15643139060340622,0.8710372483658316
15,41,70,126,0.26785714285714285,0.4444444444444444,0.14765836919972278,0.8250500061169072
4,46,3,53,0.08,0.9433962264150944,0.1590869406282942,0.8432795422213192
14,162,27,203,0.07954545454545454,0.8669950738916257,0.17045057699193059,0.8344829201242044
39,126,3,168,0.23636363636363636,0.9821428571428571,0.17564538218673578,0.8408604711446125
35,108,7,150,0.24475524475524477,0.9533333333333334,0.18531991817706123,0.8660578512118812
36,67,13,116,0.34951456310679613,0.8879310344827587,0.19620295100184162,0.8683204242443018
52,168,5,225,0.23636363636363636,0.9777777777777777,0.2134856682845589,0.8651458210696986
29,72,1,102,0.2871287128712871,0.9901960784313726,0.21623874971515095,0.9431103402106883
5,54,1,60,0.0847457627118644,0.9833333333333333,0.21691671581684585,0.9488156411990082
4,22,13,39,0.15384615384615385,0.6666666666666666,0.22753110143123148,0.9201972973097284
41,117,4,162,0.25949367088607594,0.9753086419753086,0.23083539207729425,0.9192209808572215
23,91,26,140,0.20175438596491227,0.8142857142857143,0.2246924122501039,0.89935703527899
35,81,25,141,0.3017241379310345,0.8226950354609929,0.21786520865356657,0.8900376068473094
8,100,2,110,0.07407407407407407,0.9818181818181818,0.19468098546934337,0.8906148074245099
9,53,4,66,0.14516129032258066,0.9393939393939394,0.17439992510524244,0.883357358990591
11,110,12,133,0.09090909090909091,0.9097744360902256,0.17528040056198907,0.8728489450987184
14,35,1,50,0.2857142857142857,0.98,0.19411870511457932,0.9176108498606231
29,69,1,99,0.29591836734693877,0.98989898989899,0.1993222331804169,0.9196951852782919
9,17,4,30,0.34615384615384615,0.8666666666666667,0.21995072749312175,0.9271781784755708
12,77,7,96,0.1348314606741573,0.9270833333333334,0.19610891645642495,0.9420907924573337
24,32,1,57,0.42857142857142855,0.9824561403508771,0.24675139567033275,0.9421819293905759
0,4,57,61,0.0,0.06557377049180328,0.22601406848139266,0.8173504766902707
12,186,10,208,0.06060606060606061,0.9519230769230769,0.22168506415238834,0.8233717110949639
46,176,13,235,0.2072072072072072,0.9446808510638298,0.21046976722280572,0.8183261183897965
44,104,3,151,0.2972972972972973,0.9801324503311258,0.21066675721571407,0.8169308984515303
8,55,2,65,0.12698412698412698,0.9692307692307692,0.1793567973343256,0.8315829131035449
34,189,6,229,0.15246636771300448,0.9737991266375546,0.18187606976844664,0.8382565978612908
9,55,1,65,0.140625,0.9846153846153847,0.14074086568681402,0.838565061327649
5,8,2,15,0.38461538461538464,0.8666666666666667,0.19568592063186893,0.9530069036383438
28,54,5,87,0.34146341463414637,0.9425287356321839,0.23580839977873835,0.951664854882502
2,60,3,65,0.03225806451612903,0.9538461538461539,0.21081566510858432,0.9529741838514055
42,98,3,143,0.3,0.9790209790209791,0.2112017654946847,0.9528154022356701
15,113,466,594,0.1171875,0.21548821548821548,0.2098022473540951,0.8451378945581624
1,49,9,59,0.02,0.847457627118644,0.1908784805379516,0.8270891089126039
21,66,20,107,0.2413793103448276,0.8130841121495327,0.20527195344435553,0.8025846414174822
2,0,0,2,1.0,1.0,0.29318404135644344,0.8216322604651012
9,7,1,17,0.5625,0.9411764705882353,0.32476069640870825,0.821439079744537
17,85,3,105,0.16666666666666666,0.9714285714285714,0.34396192528735653,0.8239508536848825
53,74,23,150,0.41732283464566927,0.8466666666666667,0.3607223302367379,0.8050430947771235
27,32,4,63,0.4576271186440678,0.9365079365079365,0.40935656147160465,0.9080459120656552
10,19,2,31,0.3448275862068966,0.9354838709677419,0.4557605023583042,0.9206210897583834
1,20,1,22,0.047619047619047616,0.9545454545454546,0.4295724122945049,0.9371315541935219
35,57,21,113,0.3804347826086957,0.8141592920353983,0.34106309552431846,0.9105828816271503
17,77,2,96,0.18085106382978725,0.9791666666666666,0.28654181892857383,0.9160100524954976
0,1,0,1,0.0,1.0,0.25671450338697255,0.920569323012215
32,70,3,105,0.3137254901960784,0.9714285714285714,0.23995607587803794,0.940977486277521
129,211,38,378,0.37941176470588234,0.8994708994708994,0.23362506889897514,0.9356864809865159
25,47,25,97,0.3472222222222222,0.7422680412371134,0.2356091958831021,0.9087198464834432
0,25,8,33,0.0,0.7575757575757576,0.22880647479466676,0.880581318344915
0,12,2,14,0.0,0.8571428571428571,0.17445864870771022,0.8867218276459807
2,7,2,11,0.2222222222222222,0.8181818181818182,0.1803688141923438,0.8637239921481452
35,147,60,242,0.19230769230769232,0.7520661157024794,0.20784134166487125,0.8283048658199279
40,95,21,156,0.2962962962962963,0.8653846153846154,0.20535145682204523,0.8131557292422199
3,18,4,25,0.14285714285714285,0.84,0.17155793941508243,0.804659886460663
8,22,92,122,0.26666666666666666,0.2459016393442623,0.16005000290714594,0.7337504004759697
3,43,3,49,0.06521739130434782,0.9387755102040817,0.16936677309348136,0.7596360794228733
10,149,27,186,0.06289308176100629,0.8548387096774194,0.1783514990593394,0.7593069154992393
22,109,3,134,0.16793893129770993,0.9776119402985075,0.1705967432129805,0.7820826472301948
35,101,7,143,0.25735294117647056,0.951048951048951,0.17988892162280593,0.8105087665654053
35,59,12,106,0.3723404255319149,0.8867924528301887,0.19075236865646578,0.8135670290576299
52,168,5,225,0.23636363636363636,0.9777777777777777,0.2041104391573934,0.8332495687401696
22,60,1,83,0.2682926829268293,0.9879518072289156,0.20434272719455948,0.9392567355808344
4,48,1,53,0.07692307692307693,0.9811320754716981,0.2060149679972351,0.9453076734762081
3,21,12,36,0.125,0.6666666666666666,0.2148873848885199,0.9184259530461006
37,118,4,159,0.23870967741935484,0.9748427672955975,0.2249974914773263,0.9180303569028279
22,82,27,131,0.21153846153846154,0.7938931297709924,0.21845256581475359,0.8955795252916907
34,66,25,125,0.34,0.8,0.21383250502448004,0.8831806034588068
8,93,2,103,0.07920792079207921,0.9805825242718447,0.1913816885142576,0.8835812815293878
9,51,4,64,0.15,0.9375,0.17448273381042484,0.8763738804966855
9,99,12,120,0.08333333333333333,0.9,0.17539848472617575,0.8647835840007286
14,32,1,47,0.30434782608695654,0.9787234042553191,0.20101960273859812,0.9093631179419647
28,67,1,96,0.29473684210526313,0.9895833333333334,0.20902348340801358,0.9114689130902126
9,16,4,29,0.36,0.8620689655172413,0.2302322746168048,0.9212083181968198
8,60,12,80,0.11764705882352941,0.85,0.19846756873445184,0.9283511753396768
22,30,1,53,0.4230769230769231,0.9811320754716981,0.24759171191800095,0.9284296826539415
0,2,57,59,0.0,0.03389830508474576,0.22616314048942954,0.7993437262374766
12,157,10,179,0.07100591715976332,0.9441340782122905,0.22440208103606238,0.8056485945535182
44,141,14,199,0.23783783783783785,0.9296482412060302,0.21490065414333115,0.7986378569750483
43,92,3,138,0.31851851851851853,0.9782608695652174,0.21829803648808194,0.7970203621510318
8,48,7,63,0.14285714285714285,0.8888888888888888,0.1872776283248166,0.8008517797755529
37,170,6,213,0.178743961352657,0.971830985915493,0.19600575725754915,0.818256206334909
0,10,55,65,0.0,0.15384615384615385,0.1355661968179887,0.7000725032455455
6,6,2,14,0.5,0.8571428571428571,0.2069947682465601,0.8176788678252758
27,45,5,77,0.375,0.935064935064935,0.2504224943665939,0.816383275947082
1,60,3,64,0.01639344262295082,0.953125,0.21878758076446722,0.8197370986319348
43,75,3,121,0.3644067796610169,0.9752066115702479,0.225343046641967,0.819300776061225
14,79,413,506,0.15053763440860216,0.18379446640316205,0.22644025972074688,0.7185730014204068
1,43,9,53,0.022727272727272728,0.8301886792452831,0.20415216134569197,0.6983383861818054
19,62,20,101,0.2345679012345679,0.801980198019802,0.23766186152205884,0.7909289639208981
2,0,0,2,1.0,1.0,0.30909043295063027,0.8113371271862041
9,7,1,17,0.5625,0.9411764705882353,0.33587614723634457,0.8122102036895329
18,73,3,94,0.1978021978021978,0.9680851063829787,0.3617916836905227,0.814347361744244
50,67,23,140,0.42735042735042733,0.8357142857142857,0.3707836333604385,0.7944198866219637
25,34,4,63,0.423728813559322,0.9365079365079365,0.40981094466768414,0.9019503823512173
10,17,2,29,0.37037037037037035,0.9310344827586207,0.4594742443309839,0.9163569257102654
1,20,1,22,0.047619047619047616,0.9545454545454546,0.4122026026463578,0.9406828411329365
34,56,23,113,0.37777777777777777,0.7964601769911505,0.32331371375746887,0.9116057235602437
14,80,2,96,0.14893617021276595,0.9791666666666666,0.2642331666450069,0.9170328944285913
0,1,0,1,0.0,1.0,0.24602588373184162,0.9211145270816524
30,72,3,105,0.29411764705882354,0.9714285714285714,0.2313533480509026,0.9390846681582172
130,212,38,380,0.38011695906432746,0.9,0.22270177561699295,0.9338692486570833
25,47,25,97,0.3472222222222222,0.7422680412371134,0.2279699748507094,0.9062669872669936
0,25,8,33,0.0,0.7575757575757576,0.22116725376227406,0.8781284591284655
0,12,2,14,0.0,0.8571428571428571,0.16719899979402011,0.8867974134358522
2,7,2,11,0.2222222222222222,0.8181818181818182,0.17766843579537098,0.8637995779380166
37,145,60,242,0.2032967032967033,0.7520661157024794,0.20671082198061427,0.8283804516097995
42,94,22,158,0.3088235294117647,0.8607594936708861,0.20881166231674872,0.8125705833587016
3,18,4,25,0.14285714285714285,0.84,0.17491740285857954,0.803999154787273
7,22,93,122,0.2413793103448276,0.23770491803278687,0.1597969868760946,0.7319187086152263
3,43,3,49,0.06521739130434782,0.9387755102040817,0.16911375706242998,0.7578043875621299
10,149,27,186,0.06289308176100629,0.8548387096774194,0.17809848302828804,0.7574752236384958
20,111,3,134,0.15267175572519084,0.9776119402985075,0.16816270210014064,0.7802509553694514
32,103,8,143,0.23703703703703705,0.9440559440559441,0.17298274977733122,0.8076780737056606
37,57,12,106,0.39361702127659576,0.8867924528301887,0.18509610575802135,0.8113970678712753
52,168,5,225,0.23636363636363636,0.9777777777777777,0.19845417625894898,0.831079607553815
23,59,1,83,0.2804878048780488,0.9879518072289156,0.20404110404940917,0.9382577345818335
4,48,1,53,0.07692307692307693,0.9811320754716981,0.20571334485208476,0.9443086724772073
4,20,12,36,0.16666666666666666,0.6666666666666666,0.2205381426957505,0.9174269520470997
31,124,4,159,0.2,0.9748427672955975,0.2272993204492947,0.9170313559038269
22,82,27,131,0.21153846153846154,0.7938931297709924,0.22365666680664106,0.8955795252916908
33,67,25,125,0.33,0.8,0.21456852090998454,0.8831806034588067
9,92,2,103,0.0891089108910891,0.9805825242718447,0.1935321315567635,0.8835812815293876
9,51,4,64,0.15,0.9375,0.1748910165741851,0.8763738804966854
9,99,12,120,0.08333333333333333,0.9,0.17580676748993598,0.8647835840007286
15,31,1,47,0.32608695652173914,0.9787234042553191,0.19858109461208923,0.9093631179419647
29,66,1,96,0.30526315789473685,0.9895833333333334,0.2136186885970516,0.9114689130902126
9,16,4,29,0.36,0.8620689655172413,0.23482747980584281,0.9212083181968197
10,58,12,80,0.14705882352941177,0.85,0.2086930260243302,0.9283511753396769
23,29,1,53,0.4423076923076923,0.9811320754716981,0.25914999479813067,0.9284296826539417
0,2,58,60,0.0,0.03333333333333333,0.23772142336955923,0.799263015987275
8,162,10,180,0.047058823529411764,0.9444444444444444,0.2325393505404276,0.8056122223364813
44,141,14,199,0.23783783783783785,0.9296482412060302,0.21993233358558453,0.7986014847580113
44,93,3,140,0.32116788321167883,0.9785714285714285,0.22220443720229058,0.7970283555063107
7,49,7,63,0.125,0.8888888888888888,0.18863300863086194,0.8008597731308319
36,170,6,212,0.17475728155339806,0.9716981132075472,0.19258993120571716,0.8182452178747671
0,9,56,65,0.0,0.13846153846153847,0.12940311801890397,0.6978637125876014
7,5,2,14,0.5833333333333334,0.8571428571428571,0.21273645135223734,0.8155507874175333
27,45,5,77,0.375,0.935064935064935,0.2595851908480356,0.8142108575061748
1,60,3,64,0.01639344262295082,0.953125,0.2279502772459089,0.8175646801910278
42,77,3,122,0.35294117647058826,0.9754098360655737,0.2324893191400388,0.8171130241187629
14,81,412,507,0.14736842105263157,0.1873767258382643,0.23568480786184334,0.7168970008258163
1,43,9,53,0.022727272727272728,0.8301886792452831,0.21396623517239685,0.6966813674026359
20,61,20,101,0.24691358024691357,0.801980198019802,0.2492396037790988,0.7914697473395307
2,0,0,2,1.0,1.0,0.3087634133029083,0.8118779106048368
9,7,1,17,0.5625,0.9411764705882353,0.3355491275886226,0.8127509871081654
19,72,3,94,0.2087912087912088,0.9680851063829787,0.3630345227555166,0.8148881451628766
50,66,24,140,0.43103448275862066,0.8285714285714286,0.3741907093680927,0.7939112298065701
25,34,4,63,0.423728813559322,0.9365079365079365,0.413670765440477,0.900929974187952
9,18,2,29,0.3333333333333333,0.9310344827586207,0.4580430598127713,0.9153365175470001
1,22,1,24,0.043478260869565216,0.9583333333333334,0.4230739801828796,0.9412239666740623
36,59,22,117,0.37894736842105264,0.811965811965812,0.3343521756716014,0.9143619398120354
15,94,2,111,0.13761467889908258,0.9819819819819819,0.2647257012286132,0.9201912985825705
0,1,0,1,0.0,1.0,0.24511785809135836,0.9242729312356318
33,83,3,119,0.28448275862068967,0.9747899159663865,0.22793512292832757,0.9427232643890273
123,257,36,416,0.3236842105263158,0.9134615384615384,0.211221729274702,0.9394309218109704
26,55,25,106,0.32098765432098764,0.7641509433962265,0.21274213309395643,0.914954789300754
0,31,8,39,0.0,0.7948717948717948,0.2065309529697328,0.8916031409491055
0,12,2,14,0.0,0.8571428571428571,0.15239561462386814,0.8980570045458264
2,12,2,16,0.14285714285714285,0.875,0.15314453804644818,0.882773864262686
38,172,60,270,0.18095238095238095,0.7777777777777778,0.1789948781825026,0.8510278325166543
41,110,21,172,0.271523178807947,0.877906976744186,0.17714350963782508,0.8371874126277685
3,19,4,26,0.13636363636363635,0.8461538461538461,0.15038342761458517,0.8275720280123838
6,18,102,126,0.25,0.19047619047619047,0.14024233414015835,0.7456184918809503
4,46,3,53,0.08,0.9433962264150944,0.15167090556872978,0.7668362678157072
11,167,28,206,0.06179775280898876,0.8640776699029126,0.1604991559700139,0.7678269553528582
22,143,3,168,0.13333333333333333,0.9821428571428571,0.15913861175232683,0.7831330778018376
32,110,8,150,0.22535211267605634,0.9466666666666667,0.16548143056999473,0.8072600619288217
38,64,15,117,0.37254901960784315,0.8717948717948718,0.1799136935414085,0.8063869040789198
52,168,5,225,0.23636363636363636,0.9777777777777777,0.19419940782712278,0.8251903228823386
30,71,1,102,0.297029702970297,0.9901960784313726,0.20091793682287948,0.9394360211616503
6,49,5,60,0.10909090909090909,0.9166666666666666,0.2050737809787236,0.9356175126261606
5,21,13,39,0.19230769230769232,0.6666666666666666,0.22371805804996697,0.9074159407352684
37,122,4,163,0.23270440251572327,0.9754601226993865,0.23791392507602271,0.9064612643862011
24,90,26,140,0.21052631578947367,0.8142857142857143,0.23579595409222517,0.8875496997603508
36,80,25,141,0.3103448275862069,0.8226950354609929,0.22690964094627716,0.8805354374269394
9,99,2,110,0.08333333333333333,0.9818181818181818,0.20504816908480525,0.8811126380041401
8,54,4,66,0.12903225806451613,0.9393939393939394,0.18104853409826518,0.873855189570221
10,111,12,133,0.08264462809917356,0.9097744360902256,0.17727049395658864,0.872870585202158
12,37,1,50,0.24489795918367346,0.98,0.18478338922458598,0.9176324899640628
24,74,1,99,0.24489795918367346,0.98989898989899,0.18652532589143597,0.9196951852782919
9,17,4,30,0.34615384615384615,0.8666666666666667,0.2059006873720606,0.9271781784755708
12,72,11,95,0.14285714285714285,0.8842105263157894,0.1819738752679086,0.9359661057405416
22,33,2,57,0.4,0.9649122807017544,0.22721197050600386,0.9335509770096235
0,4,58,62,0.0,0.06451612903225806,0.20877879078250156,0.8085684326722404
7,191,10,208,0.03535353535353535,0.9519230769230769,0.2020229203902675,0.8145896670769336
43,177,14,234,0.19545454545454546,0.9401709401709402,0.19495957557182067,0.8088998013870679
37,102,13,152,0.26618705035971224,0.9144736842105263,0.19800087431125477,0.7981247577172874
8,50,7,65,0.13793103448275862,0.8923076923076924,0.16825475835824227,0.801787761380291
32,192,6,230,0.14285714285714285,0.9739130434782609,0.1682547583582423,0.8146024066892154
0,7,58,65,0.0,0.1076923076923077,0.11111190121538513,0.6921424105450088
6,7,2,15,0.46153846153846156,0.8666666666666667,0.17704596714945106,0.8067353444927815
28,55,5,88,0.3373493975903614,0.9431818181818182,0.22018823318328337,0.8054865932440302
2,60,3,65,0.03225806451612903,0.9538461538461539,0.19687445019208102,0.8074401951976321
42,98,3,143,0.3,0.9790209790209791,0.20170487156926495,0.8166612373134111
15,109,472,596,0.12096774193548387,0.2080536912751678,0.19928154406251145,0.7189106657373363
1,49,9,59,0.02,0.847457627118644,0.1817305236543482,0.700845606257391
20,67,20,107,0.22988505747126436,0.8130841121495327,0.2145712461502431,0.8016158640369946
2,0,0,2,1.0,1.0,0.29149432307331996,0.8206634830846136
9,7,1,17,0.5625,0.9411764705882353,0.3236586948461255,0.8203770048569589
13,89,3,105,0.12745098039215685,0.9714285714285714,0.33725768282841523,0.8228887787973042
50,76,23,149,0.3968253968253968,0.8456375838926175,0.3510898823749004,0.8038340080646812
26,33,4,63,0.4406779661016949,0.9365079365079365,0.3967627715415021,0.9078989002407909
9,20,2,31,0.3103448275862069,0.9354838709677419,0.4382406040538173,0.9204740779335191
1,22,1,24,0.043478260869565216,0.9583333333333334,0.41880967446059075,0.9402651939032088
36,57,24,117,0.3870967741935484,0.7948717948717948,0.3312520707739548,0.9109611645991794
15,94,2,111,0.13761467889908258,0.9819819819819819,0.270554167759538,0.9167905233697148
0,1,0,1,0.0,1.0,0.2467446439500142,0.9208721560227761
33,83,3,119,0.28448275862068967,0.9747899159663865,0.22909932375296987,0.9402812619470249
128,252,36,416,0.3368421052631579,0.9134615384615384,0.21426562934746457,0.936988919368968
25,56,25,106,0.30864197530864196,0.7641509433962265,0.2140223647363839,0.9125127868587516
0,31,8,39,0.0,0.7948717948717948,0.20781118461216025,0.8891611385071032
0,12,2,14,0.0,0.8571428571428571,0.15251164544165333,0.8980570045458264
2,12,2,16,0.14285714285714285,0.875,0.1532605688642334,0.882773864262686
36,174,60,270,0.17142857142857143,0.7777777777777778,0.1777503647826007,0.8510278325166543
40,111,21,172,0.26490066225165565,0.877906976744186,0.1749529224441673,0.8371874126277685
3,19,4,26,0.13636363636363635,0.8461538461538461,0.1463131411728071,0.8275720280123838
8,22,96,126,0.26666666666666666,0.23809523809523808,0.14031666850966776,0.7524212129693855
4,46,3,53,0.08,0.9433962264150944,0.15174523993823916,0.7736389889041426
12,167,28,207,0.0670391061452514,0.8647342995169082,0.16132225510184653,0.7747234806718643
21,144,3,168,0.12727272727272726,0.9821428571428571,0.1590959100183586,0.7900296031208438
32,110,8,150,0.22535211267605634,0.9466666666666667,0.16679927305371356,0.8141565872478279
38,65,14,117,0.36893203883495146,0.8803418803418803,0.18166089827989867,0.8145044306189272
52,168,5,225,0.23636363636363636,0.9777777777777777,0.19594661256561294,0.833307849422346
29,72,1,102,0.2871287128712871,0.9901960784313726,0.19886976202341589,0.9407508266132224
5,50,5,60,0.09090909090909091,0.9166666666666666,0.20042820358185745,0.9369323180777326
5,21,13,39,0.19230769230769232,0.6666666666666666,0.2183237158907776,0.9086369419562695
37,122,4,163,0.23270440251572327,0.9754601226993865,0.23338538378263415,0.9076822656072023
24,90,26,140,0.21052631578947367,0.8142857142857143,0.23126741279883664,0.888770700981352
35,81,25,141,0.3017241379310345,0.8226950354609929,0.22166628409827707,0.8805354374269394
8,100,2,110,0.07407407407407407,0.9818181818181818,0.19848206091405388,0.8811126380041401
8,54,4,66,0.12903225806451613,0.9393939393939394,0.17589685308451516,0.873855189570221
10,110,13,133,0.08333333333333333,0.9022556390977443,0.1748146020022641,0.8717964713460893
14,35,1,50,0.2857142857142857,0.98,0.18815840106034884,0.9165583761079941
24,74,1,99,0.24489795918367346,0.98989898989899,0.18990033772719886,0.918621071422223
10,16,4,30,0.38461538461538464,0.8666666666666667,0.214770204702329,0.9261040646195021
11,73,11,95,0.13095238095238096,0.8842105263157894,0.19037423941966422,0.9348919918844729
23,32,2,57,0.41818181818181815,0.9649122807017544,0.23953248857791337,0.9324768631535546
0,4,58,62,0.0,0.06451612903225806,0.2210993088544111,0.8074943188161717
9,189,10,208,0.045454545454545456,0.9519230769230769,0.2156880534431557,0.8145896670769336
43,178,13,234,0.19457013574660634,0.9444444444444444,0.20266746059063004,0.8095103019975683
39,100,13,152,0.2805755395683453,0.9144736842105263,0.2077642577884403,0.7987352583277879
7,51,7,65,0.1206896551724138,0.8923076923076924,0.1700605821537302,0.8023982619907917
33,191,6,230,0.14732142857142858,0.9739130434782609,0.17239901752787984,0.8152129072997161
0,7,58,65,0.0,0.1076923076923077,0.1126587577876201,0.6927529111555095
6,7,2,15,0.46153846153846156,0.8666666666666667,0.17859282372168606,0.807345845103282
28,55,5,88,0.3373493975903614,0.9431818181818182,0.22029208831251693,0.8060970938545308
2,60,3,65,0.03225806451612903,0.9538461538461539,0.19710464956530588,0.8074401951976322
42,98,3,143,0.3,0.9790209790209791,0.19987957248411364,0.8166612373134112
14,111,471,596,0.112,0.20973154362416108,0.19863819317376885,0.7191503589300495
1,49,9,59,0.02,0.847457627118644,0.18044941766356476,0.7010852994501043
20,67,20,107,0.22988505747126436,0.8130841121495327,0.21329014015945966,0.8018555572297077
2,0,0,2,1.0,1.0,0.29021321708253656,0.820903176277327
10,6,1,17,0.625,0.9411764705882353,0.3313061602839135,0.8206166980496722
14,88,3,105,0.13725490196078433,0.9714285714285714,0.34630570849029285,0.8231284719900175
51,75,23,149,0.40476190476190477,0.8456375838926175,0.3612716948848507,0.8040737012573944
26,33,4,63,0.4406779661016949,0.9365079365079365,0.40822569004223563,0.9078989002407908
9,20,2,31,0.3103448275862069,0.9354838709677419,0.449703522554551,0.9204740779335191
1,22,1,24,0.043478260869565216,0.9583333333333334,0.4147919950724513,0.9412239666740622
36,58,23,117,0.3829787234042553,0.8034188034188035,0.32664609841591635,0.913140938591034
19,90,2,111,0.1743119266055046,0.9819819819819819,0.2711906593595598,0.9189702973615693
0,1,0,1,0.0,1.0,0.24738113555003602,0.9230519300146306
33,83,3,119,0.28448275862068967,0.9747899159663865,0.2313321872350779,0.9415022631680261
125,254,37,416,0.32981530343007914,0.9110576923076923,0.2179159715023289,0.9378665139965625
26,55,25,106,0.32098765432098764,0.7641509433962265,0.2194363753215833,0.9133903814863461
0,31,8,39,0.0,0.7948717948717948,0.21322519519735966,0.8900387331346977
0,12,2,14,0.0,0.8571428571428571,0.15851394899675178,0.8977135979524198
2,12,2,16,0.14285714285714285,0.875,0.15402040846127152,0.8824304576692795
33,177,60,270,0.15714285714285714,0.7777777777777778,0.17646938805310824,0.8506844259232478
42,108,22,172,0.28,0.872093023255814,0.17582899396443832,0.8360134412503087
3,19,4,26,0.13636363636363635,0.8461538461538461,0.14819304152637505,0.8267414632283306
8,24,94,126,0.25,0.25396825396825395,0.13805194805194823,0.7538582218814776
4,46,3,53,0.08,0.9433962264150944,0.14948051948051969,0.7750759978162346
12,168,28,208,0.06666666666666667,0.8653846153846154,0.1590043290043292,0.7762533918507716
22,143,3,168,0.13333333333333333,0.9821428571428571,0.15764378478664212,0.791559514299751
33,109,8,150,0.2323943661971831,0.9466666666666667,0.16839400036583152,0.8156864984267351
38,68,11,117,0.3584905660377358,0.905982905982906,0.17960693837122238,0.8205279102448912
52,168,5,225,0.23636363636363636,0.9777777777777777,0.19389265265693667,0.8393313290483101
29,72,1,102,0.2871287128712871,0.9901960784313726,0.199196754495692,0.9445067325430413
4,55,1,60,0.06779661016949153,0.9833333333333333,0.1974534130913336,0.9502120335313612
4,22,13,39,0.15384615384615385,0.6666666666666666,0.20990762554554607,0.9218237551430827
32,127,4,163,0.20125786163522014,0.9754601226993865,0.21961112958867274,0.9208690787940155
23,90,27,140,0.20353982300884957,0.8071428571428572,0.2154890519903394,0.9009371060048998
35,80,26,141,0.30434782608695654,0.8156028368794326,0.20775437485451378,0.8880256675615466
10,98,2,110,0.09259259259259259,0.9818181818181818,0.18721565431579323,0.8886028681387471
8,54,4,66,0.12903225806451613,0.9393939393939394,0.16463044648625452,0.881345419704828
9,112,12,133,0.0743801652892562,0.9097744360902256,0.16557095436050662,0.8708370058129555
15,34,1,50,0.30612244897959184,0.98,0.18732471080814062,0.9155989105748603
28,70,1,99,0.2857142857142857,0.98989898989899,0.19938991424800712,0.9176616058890895
9,17,4,30,0.34615384615384615,0.8666666666666667,0.21976334612586376,0.9261650072496337
13,71,11,95,0.15476190476190477,0.8842105263157894,0.1983939287937135,0.9359661057405418
23,33,1,57,0.4107142857142857,0.9824561403508771,0.2438398849539554,0.9360572426737839
0,4,58,62,0.0,0.06451612903225806,0.2254067052304531,0.8110746983364008
10,188,10,208,0.050505050505050504,0.9519230769230769,0.22199597454699513,0.8170959327410939
43,178,13,234,0.19457013574660634,0.9444444444444444,0.20605992979942575,0.8120165676617288
46,103,3,152,0.3087248322147651,0.9802631578947368,0.2093471507280657,0.8106400202325499
6,52,7,65,0.10344827586206896,0.8923076923076924,0.17467492640066898,0.8143030238955535
34,190,6,230,0.15178571428571427,0.9739130434782609,0.17424975633264175,0.8271176692044779
0,9,56,65,0.0,0.13846153846153847,0.11557628694488664,0.7065470117917154
6,7,2,15,0.46153846153846156,0.8666666666666667,0.18151035287895256,0.821139945739488
28,55,5,88,0.3373493975903614,0.9431818181818182,0.2224881167482827,0.8198911944907367
2,60,3,65,0.03225806451612903,0.9538461538461539,0.1993006780010717,0.8212342958338381
43,97,3,143,0.30714285714285716,0.9790209790209791,0.19907468156222766,0.8210568417090156
13,113,470,596,0.10317460317460317,0.21140939597315436,0.19903558546401826,0.7237856565183672
1,49,9,59,0.02,0.847457627118644,0.18020905485177338,0.7057205970384219
21,66,20,107,0.2413793103448276,0.8130841121495327,0.21469181347246305,0.8020952504224211
2,0,0,2,1.0,1.0,0.29161489039553995,0.8211428694700402
9,7,1,17,0.5625,0.9411764705882353,0.32377926216834546,0.8208563912423854
17,85,3,105,0.16666666666666666,0.9714285714285714,0.3429804910469937,0.8233681651827308
51,74,24,149,0.408,0.8389261744966443,0.3573886543122998,0.8033546216792544
26,33,4,63,0.4406779661016949,0.9365079365079365,0.40560342044474146,0.9069401274699376
9,20,2,31,0.3103448275862069,0.9354838709677419,0.44708125295705675,0.919515305162666
1,22,1,24,0.043478260869565216,0.9583333333333334,0.41433839052832344,0.9389046496855219
36,58,23,117,0.3829787234042553,0.8034188034188035,0.3261924938717885,0.9108216216024936
19,90,2,111,0.1743119266055046,0.9819819819819819,0.270737054815432,0.916650980373029
0,1,0,1,0.0,1.0,0.24669179314640793,0.9220931572437773
34,82,3,119,0.29310344827586204,0.9747899159663865,0.23256371432867393,0.9415022631680261
126,252,37,415,0.3333333333333333,0.9108433734939759,0.21965007429638983,0.9378358970231746
26,55,25,106,0.32098765432098764,0.7641509433962265,0.22117047811564425,0.9133597645129582
0,33,6,39,0.0,0.8461538461538461,0.21495929799142063,0.8973341234873171
0,12,2,14,0.0,0.8571428571428571,0.16024805179081272,0.9050089883050391
2,12,2,16,0.14285714285714285,0.875,0.15575451125533246,0.8897258480218987
34,175,60,269,0.16267942583732056,0.7769516728624535,0.17899442923209255,0.8578618012879635
42,108,22,172,0.28,0.872093023255814,0.17712250804982657,0.8431908166150246
3,19,4,26,0.13636363636363635,0.8461538461538461,0.14898397991129841,0.8339494555664346
7,20,99,126,0.25925925925925924,0.21428571428571427,0.14016563775962293,0.7553972799792187
4,46,3,53,0.08,0.9433962264150944,0.15159420918819433,0.7692890485879682
10,170,28,208,0.05555555555555555,0.8653846153846154,0.15953071712470226,0.7704664426225053
23,142,3,168,0.1393939393939394,0.9821428571428571,0.15903597377281606,0.7857725650714847
34,108,8,150,0.23943661971830985,0.9466666666666667,0.17000128718438598,0.8100175641863725
37,67,13,117,0.3557692307692308,0.8888888888888888,0.18082546300856178,0.8124169735625258
52,168,5,225,0.23636363636363636,0.9777777777777777,0.19511117729427613,0.8312203923659448
29,72,1,102,0.2871287128712871,0.9901960784313726,0.19909252781028006,0.9420647301010387
3,52,5,60,0.05454545454545454,0.9166666666666666,0.19545616417391645,0.9382462215655493
5,21,13,39,0.19230769230769232,0.6666666666666666,0.21499218370993597,0.9098579431772708
34,125,4,163,0.2138364779874214,0.9754601226993865,0.22562683208043338,0.9089032668282035
23,90,27,140,0.20353982300884957,0.8071428571428572,0.22049871826479622,0.8889712940390879
38,78,25,141,0.3275862068965517,0.8226950354609929,0.21647257199727063,0.8795150292636743
12,96,2,110,0.1111111111111111,0.9818181818181818,0.19857935410405275,0.8800922298408748
8,54,4,66,0.12903225806451613,0.9393939393939394,0.17599414627451404,0.8728347814069558
10,110,13,133,0.08333333333333333,0.9022556390977443,0.18010670038706816,0.8707760631828239
12,37,1,50,0.24489795918367346,0.98,0.18761959565506545,0.9155379679447287
28,70,1,99,0.2857142857142857,0.98989898989899,0.19788785390176034,0.9176006632589578
8,18,4,30,0.3076923076923077,0.8666666666666667,0.2127667802851115,0.9261040646195021
12,72,11,95,0.14285714285714285,0.8842105263157894,0.18637691399376738,0.9348919918844729
23,33,1,57,0.4107142857142857,0.9824561403508771,0.22917736750850662,0.9349831288177152
0,4,58,62,0.0,0.06451612903225806,0.2107441877850043,0.8100005844803321
11,187,10,208,0.05555555555555555,0.9519230769230769,0.20677593381675033,0.8170959327410939
44,176,14,234,0.2,0.9401709401709402,0.20036193964765414,0.8114060670512282
46,103,3,152,0.3087248322147651,0.9802631578947368,0.20364916057629404,0.8100295196220493
7,51,7,65,0.1206896551724138,0.8923076923076924,0.1769344959305949,0.8136925232850528
35,189,6,230,0.15625,0.9739130434782609,0.17884776123671736,0.8265071685939773
0,10,55,65,0.0,0.15384615384615385,0.12017429184896226,0.7081343133790169
6,7,2,15,0.46153846153846156,0.8666666666666667,0.18610835778302823,0.8227272473267896
29,53,5,87,0.35365853658536583,0.9425287356321839,0.22869449793014396,0.8213851985709477
2,60,3,65,0.03225806451612903,0.9538461538461539,0.20473136428959096,0.8233388005245497
41,99,3,143,0.29285714285714287,0.9790209790209791,0.20246455152421636,0.8231613463997272
14,112,470,596,0.1111111111111111,0.21140939597315436,0.20109618808688742,0.7258901612090788
1,49,9,59,0.02,0.847457627118644,0.1816319023726017,0.7078251017291335
21,66,20,107,0.2413793103448276,0.8130841121495327,0.21611466099329135,0.8020019529153306
2,0,0,2,1.0,1.0,0.2930377379163683,0.8210495719629496
9,7,1,17,0.5625,0.9411764705882353,0.32287223268988746,0.8208563912423854
17,85,3,105,0.16666666666666666,0.9714285714285714,0.34207346156853563,0.8233681651827308
50,76,23,149,0.3968253968253968,0.8456375838926175,0.35692606927828624,0.8043133944501077
25,34,4,63,0.423728813559322,0.9365079365079365,0.40158574105660205,0.9078989002407909
9,20,2,31,0.3103448275862069,0.9354838709677419,0.4430635735689173,0.9204740779335191
1,22,1,24,0.043478260869565216,0.9583333333333334,0.4261404896721774,0.9371733310590071
36,60,21,117,0.375,0.8205128205128205,0.33685477538646313,0.9115323054179815
18,91,2,111,0.1651376146788991,0.9819819819819819,0.2800887203405916,0.9173616641885166
0,1,0,1,0.0,1.0,0.2578664981183694,0.9234406915441397
32,84,3,119,0.27586206896551724,0.9747899159663865,0.2362253040633822,0.9433086387230113
128,253,34,415,0.3359580052493438,0.9180722891566265,0.22368661716195676,0.9406749748156812
23,58,25,106,0.2839506172839506,0.7641509433962265,0.21134093814961105,0.9168344691924821
0,32,7,39,0.0,0.8205128205128205,0.20512975802538747,0.8971458245038374
0,13,1,14,0.0,0.9285714285714286,0.1515583294539589,0.91258276851221
2,13,1,16,0.13333333333333333,0.9375,0.14701486069030664,0.9062281996576411
37,172,60,269,0.17703349282296652,0.7769516728624535,0.17230535966501614,0.8743641529237058
43,107,22,172,0.2866666666666667,0.872093023255814,0.1738488736223232,0.8596931682507669
3,23,0,26,0.11538461538461539,1.0,0.14233838935593343,0.8713971269426775
13,42,71,126,0.23636363636363636,0.4365079365079365,0.13554024922445998,0.8245909831014931
4,46,3,53,0.08,0.9433962264150944,0.14696882065303143,0.8421457553732464
14,166,28,208,0.07777777777777778,0.8653846153846154,0.15807993176414253,0.8331190677751303
24,141,3,168,0.14545454545454545,0.9821428571428571,0.15981153349574423,0.8394966187955385
31,111,8,150,0.21830985915492956,0.9466666666666667,0.16570815725745325,0.8637416179104261
35,65,17,117,0.35,0.8547008547008547,0.1747557763050723,0.8612570224025748
53,167,5,225,0.2409090909090909,0.9777777777777777,0.19268784423714022,0.8580824192279717
30,71,1,102,0.297029702970297,0.9901960784313726,0.2013544251809489,0.9371807252170339
3,56,1,60,0.05084745762711865,0.9833333333333333,0.19718977627053727,0.9428860262053539
3,25,11,39,0.10714285714285714,0.717948717948718,0.20138478760840575,0.9218237551430828
31,128,4,163,0.1949685534591195,0.9754601226993865,0.2084582173233449,0.9208690787940156
23,91,26,140,0.20175438596491227,0.8142857142857143,0.20609314972477102,0.9019575141681652
36,80,25,141,0.3103448275862069,0.8226950354609929,0.2004281250942291,0.8973852542767563
13,95,2,110,0.12037037037037036,0.9818181818181818,0.18320830787441195,0.8979624548539569
7,55,4,66,0.11290322580645161,0.9393939393939394,0.156904525422434,0.8907050064200378
10,111,12,133,0.08264462809917356,0.9097744360902256,0.16144697834701324,0.8801965925281653
13,36,1,50,0.2653061224489796,0.98,0.1840417305336022,0.9176324899640628
27,71,1,99,0.2755102040816326,0.98989898989899,0.19554768062253267,0.9196951852782919
6,20,4,30,0.23076923076923078,0.8666666666666667,0.199692658451721,0.9271781784755707
13,76,6,95,0.14606741573033707,0.9368421052631579,0.1762244567580253,0.943484902733023
23,33,1,57,0.4107142857142857,0.9824561403508771,0.2177021589500132,0.9435760396662651
0,5,57,62,0.0,0.08064516129032258,0.2015731266919487,0.8208976427943199
11,187,10,208,0.05555555555555555,0.9519230769230769,0.19770325918571754,0.8269188771990129
46,175,13,234,0.2081447963800905,0.9444444444444444,0.18953735546159053,0.8218395121196478
44,103,4,151,0.29931972789115646,0.9735099337748344,0.19293871600580823,0.8194982183876256
7,56,2,65,0.1111111111111111,0.9692307692307692,0.17584469891179114,0.8341502330396402
33,191,6,230,0.14732142857142858,0.9739130434782609,0.17602384360337564,0.8394460813560835
9,55,1,65,0.140625,0.9846153846153847,0.13743965992990625,0.8397545448224417
6,7,2,15,0.46153846153846156,0.8666666666666667,0.2033737258639722,0.9520433313047766
28,54,5,87,0.34146341463414637,0.9425287356321839,0.2442177057323423,0.9507012825489348
2,60,3,65,0.03225806451612903,0.9538461538461539,0.21909102975177638,0.9520443838920362
43,96,3,142,0.30935251798561153,0.9788732394366197,0.22052428547955566,0.9528105704151483
15,112,469,596,0.11811023622047244,0.21308724832214765,0.2215241604951787,0.8447900674282024
1,49,9,59,0.02,0.847457627118644,0.20333538498497464,0.8267250079482571
20,67,20,107,0.22988505747126436,0.8130841121495327,0.21608682176658386,0.8022205404531354
2,0,0,2,1.0,1.0,0.2930098986896607,0.8212681595007544
9,7,1,17,0.5625,0.9411764705882353,0.3245865537419256,0.8210749787801903
17,84,4,105,0.16831683168316833,0.9619047619047619,0.344023520480074,0.8222262085028486
49,76,24,149,0.392,0.8389261744966443,0.3558303036249867,0.8022337706542808
25,34,4,63,0.423728813559322,0.9365079365079365,0.39949010038767946,0.9055795832522505
9,20,2,31,0.3103448275862069,0.9354838709677419,0.4409679328999947,0.9181547609449788
1,20,1,22,0.047619047619047616,0.9545454545454546,0.43059991416528964,0.9376526136811467
35,56,23,114,0.38461538461538464,0.7982456140350878,0.3426878262532017,0.9088305585433022
16,78,2,96,0.1702127659574468,0.9791666666666666,0.2866467928185513,0.9142577294116495
0,1,0,1,0.0,1.0,0.2612499674217259,0.9203367567672726
32,70,3,105,0.3137254901960784,0.9714285714285714,0.24432455318823593,0.9387041037060481
129,212,37,378,0.3782991202346041,0.9021164021164021,0.23783459699899048,0.9337910273644002
25,47,25,97,0.3472222222222222,0.7422680412371134,0.23452771869211217,0.9068243928613278
0,28,5,33,0.0,0.8484848484848485,0.22772499760367682,0.8916728777098127
0,12,2,14,0.0,0.8571428571428571,0.17277994265862187,0.9000867695823512
1,8,2,11,0.1111111111111111,0.8181818181818182,0.1643368491091453,0.8770889340845157
36,145,60,241,0.19889502762430938,0.7510373443983402,0.19275042448404664,0.8415228404271359
42,93,22,157,0.3111111111111111,0.8598726114649682,0.19237694175762274,0.8255862747180496
3,18,4,25,0.14285714285714285,0.84,0.1587423735608426,0.816712502987135
8,22,92,122,0.26666666666666666,0.2459016393442623,0.1472344370529061,0.745803017002442
3,42,3,48,0.06666666666666667,0.9375,0.1567582465767156,0.7585194672188921
10,151,27,188,0.062111801242236024,0.8563829787234043,0.1656313610398922,0.7584109131589702
20,111,3,134,0.15267175572519084,0.9776119402985075,0.17156859598476068,0.781186644889926
29,106,8,143,0.21481481481481482,0.9440559440559441,0.17384285129769003,0.8087607305552978
35,61,10,106,0.3645833333333333,0.9056603773584906,0.18148174018657895,0.8153018399686582
53,167,5,225,0.2409090909090909,0.9777777777777777,0.19548916133685726,0.834984379651198
22,60,1,83,0.2682926829268293,0.9879518072289156,0.19572144937402333,0.9409915464918627
4,44,5,53,0.08333333333333333,0.9056603773584906,0.1981024017549757,0.936443028971647
4,20,12,36,0.16666666666666666,0.6666666666666666,0.21303881110132292,0.9093406986778275
35,119,4,158,0.22727272727272727,0.9746835443037974,0.223696092750971,0.9089223563928688
23,82,26,131,0.21904761904761905,0.8015267175572519,0.22430077906994303,0.888561038321627
36,65,25,126,0.3564356435643564,0.8015873015873016,0.22313682338866064,0.8736934560686
10,91,2,103,0.09900990099009901,0.9805825242718447,0.20286551054309035,0.874094134139181
7,53,4,64,0.11666666666666667,0.9375,0.18120465107735284,0.8668867331064788
9,99,12,120,0.08333333333333333,0.9,0.18120465107735284,0.8660781077695516
13,33,1,47,0.2826086956521739,0.9787234042553191,0.1977677980752824,0.9106576417107876
26,68,1,95,0.2765957446808511,0.9894736842105263,0.20481394341930012,0.9127705188403203
8,17,4,29,0.32,0.8620689655172413,0.21923571212678314,0.9214194114060331
10,58,12,80,0.14705882352941177,0.85,0.18932473783607673,0.9283355111792758
24,28,1,53,0.46153846153846156,0.9811320754716981,0.24111453220012852,0.9284140184935407
0,2,58,60,0.0,0.03333333333333333,0.22444786553346185,0.7992473518268739
11,158,10,179,0.0650887573964497,0.9441340782122905,0.22184149754247848,0.8055522201429154
44,142,14,200,0.23655913978494625,0.93,0.215262989561446,0.7985917338207269
44,91,3,138,0.32592592592592595,0.9782608695652174,0.22231015831074238,0.7969899031571115
6,55,2,63,0.09836065573770492,0.9682539682539683,0.19064739484470025,0.8121591892623581
35,172,6,213,0.16908212560386474,0.971830985915493,0.19379358085533638,0.8295636158217141
0,8,57,65,0.0,0.12307692307692308,0.12785951492127043,0.7069843083367464
6,6,2,14,0.5,0.8571428571428571,0.19928808634984185,0.8246713831666783
27,44,5,76,0.38028169014084506,0.9342105263157895,0.24431564817046977,0.8232537328957495
1,60,3,64,0.01639344262295082,0.953125,0.21286340571875612,0.826557304324321
43,75,3,121,0.3644067796610169,0.9752066115702479,0.21836067053805483,0.8261209817536113
15,80,411,506,0.15789473684210525,0.18774703557312253,0.2268655392672549,0.7146199913706333
1,43,9,53,0.022727272727272728,0.8301886792452831,0.20595770314202744,0.6943853761320318
21,60,20,101,0.25925925925925924,0.801980198019802,0.24299474017906447,0.7913715582667287
2,0,0,2,1.0,1.0,0.3144233116076359,0.8117797215320349
9,7,1,17,0.5625,0.9411764705882353,0.3404544987303723,0.8127748564280985
14,76,4,94,0.15555555555555556,0.9574468085106383,0.36033480057788736,0.8133922576439041
50,67,23,140,0.42735042735042733,0.8357142857142857,0.36932675024780304,0.7934647825216238
25,34,4,63,0.423728813559322,0.9365079365079365,0.4073030469216912,0.9004306255123115
10,17,2,29,0.37037037037037035,0.9310344827586207,0.45696634658499086,0.9148371688713597
1,20,1,22,0.047619047619047616,0.9545454545454546,0.40022326043718554,0.9385169277877328
34,56,24,114,0.37777777777777777,0.7894736842105263,0.31133437154829663,0.908441739817808
14,80,2,96,0.14893617021276595,0.9791666666666666,0.26118239586440606,0.9138689106861552
0,1,0,1,0.0,1.0,0.23996598850938483,0.9193110875569035
31,72,3,106,0.30097087378640774,0.9716981132075472,0.22740627206617328,0.9381251037294103
129,214,37,380,0.3760932944606414,0.9026315789473685,0.2181798904031656,0.9332856240779005
26,46,25,97,0.3611111111111111,0.7422680412371134,0.2303583249953933,0.9056833626878109
0,28,5,33,0.0,0.8484848484848485,0.22355560390695794,0.8905318475362957
0,12,2,14,0.0,0.8571428571428571,0.16958734993870397,0.9001988722409143
1,8,2,11,0.1111111111111111,0.8181818181818182,0.16418377006703896,0.8772010367430789
37,145,60,242,0.2032967032967033,0.7520661157024794,0.19322615625228234,0.8417819104148617
42,92,22,156,0.31343283582089554,0.8589743589743589,0.19500643654292343,0.8256785169529776
3,18,4,25,0.14285714285714285,0.84,0.1616869863138522,0.816731148531925
9,21,92,122,0.3,0.2459016393442623,0.15295682758369347,0.7458216625472319
3,43,3,49,0.06521739130434782,0.9387755102040817,0.1622735977700289,0.7587203285071223
10,152,27,189,0.06172839506172839,0.8571428571428571,0.17109193992170435,0.7587203285071223
21,110,3,134,0.16030534351145037,0.9776119402985075,0.17811968740746711,0.781496060238078
31,105,7,143,0.22794117647058823,0.951048951048951,0.18164032643230782,0.8099221795732882
33,61,12,106,0.35106382978723405,0.8867924528301887,0.18701618271321332,0.8138961929812639
53,167,5,225,0.2409090909090909,0.9777777777777777,0.20102360386349163,0.8335787326638037
22,60,1,83,0.2682926829268293,0.9879518072289156,0.19649398713875296,0.9395858995044684
2,50,1,53,0.038461538461538464,0.9811320754716981,0.19267172244692302,0.9456368373998422
3,21,12,36,0.125,0.6666666666666666,0.2017105231523904,0.9184259530461006
27,127,4,158,0.17532467532467533,0.9746835443037974,0.2038561419828511,0.9180076107611421
24,81,26,131,0.22857142857142856,0.8015267175572519,0.2039461779972569,0.8966472916908994
35,65,25,125,0.35,0.8,0.2037942023133663,0.8842483698580151
11,91,2,104,0.10784313725490197,0.9807692307692307,0.18478478036276785,0.8846757202853656
7,53,4,64,0.11666666666666667,0.9375,0.16312392089703034,0.8774683192526634
10,98,12,120,0.09259259259259259,0.9,0.1708569286300381,0.8658780227567066
13,34,1,48,0.2765957446808511,0.9791666666666666,0.1925134635844454,0.9105208798995638
27,67,1,95,0.2872340425531915,0.9894736842105263,0.20850051604566197,0.9126337570290964
8,17,4,29,0.32,0.8620689655172413,0.2215617405354579,0.9212826495948091
10,59,11,80,0.14492753623188406,0.8625,0.19226567428286992,0.9302112210233806
25,27,1,53,0.4807692307692308,0.9811320754716981,0.2455408304992026,0.9302630559808759
0,2,58,60,0.0,0.03333333333333333,0.22887416383253595,0.8010963893142093
9,160,10,179,0.05325443786982249,0.9441340782122905,0.2232544274435688,0.8074012576302508
43,144,14,201,0.22994652406417113,0.9303482587064676,0.21659025306975738,0.8004271993502223
45,92,3,140,0.3284671532846715,0.9785714285714285,0.22248069745996876,0.7988697342589226
6,55,2,63,0.09836065573770492,0.9682539682539683,0.19081793399392666,0.8140390203641693
36,173,6,215,0.1722488038277512,0.9720930232558139,0.19472097222190765,0.8296951665435713
0,10,55,65,0.0,0.15384615384615385,0.12603965354058896,0.7115114634542079
6,6,2,14,0.5,0.8571428571428571,0.1974682249691604,0.8291985382841398
27,45,5,77,0.375,0.935064935064935,0.2434318767020429,0.8279029464059462
1,60,3,64,0.01639344262295082,0.953125,0.2129242936390114,0.8311567665907366
42,76,3,121,0.3559322033898305,0.9752066115702479,0.21684787222546273,0.8306760784477107
15,79,412,506,0.1595744680851064,0.1857707509881423,0.22559270256080577,0.7188927616954499
1,43,9,53,0.022727272727272728,0.8301886792452831,0.204232483832166,0.6986207125510884
19,62,20,101,0.2345679012345679,0.801980198019802,0.23774218400853284,0.791211290290181
2,0,0,2,1.0,1.0,0.30917075543710426,0.811619453555487
9,7,1,17,0.5625,0.9411764705882353,0.3359564697228185,0.8124925300588158
16,74,4,94,0.17777777777777778,0.9574468085106383,0.35901137474493666,0.8131099312746212
51,67,22,140,0.4322033898305085,0.8428571428571429,0.36990725852217643,0.7942028643156062
25,34,4,63,0.423728813559322,0.9365079365079365,0.4076435935899214,0.9014510336755768
10,17,2,29,0.37037037037037035,0.9310344827586207,0.45730689325322116,0.9158575770346251
1,22,1,24,0.043478260869565216,0.9583333333333334,0.39969553338546626,0.9381056723764774
35,57,25,117,0.3804347826086957,0.7863247863247863,0.31118621661527995,0.9075806418514468
13,97,2,112,0.11818181818181818,0.9821428571428571,0.2566407620698254,0.9134329827878214
0,1,0,1,0.0,1.0,0.23259550040080137,0.9188751596585697
31,87,3,121,0.2627118644067797,0.9752066115702479,0.21984005245891275,0.9391427708352718
132,248,35,415,0.3473684210526316,0.9156626506024096,0.20893142495795697,0.9361648728487679
27,54,25,106,0.3333333333333333,0.7641509433962265,0.21221549720754648,0.9116887403385513
0,34,5,39,0.0,0.8717948717948718,0.20600431708332287,0.8993261029759141
0,12,2,14,0.0,0.8571428571428571,0.15165649099636633,0.9094429702356385
2,12,2,16,0.14285714285714285,0.875,0.15518153737855558,0.8941368477866588
37,172,60,269,0.17703349282296652,0.7769516728624535,0.18047203635326506,0.8622728010527236
41,110,21,172,0.271523178807947,0.877906976744186,0.18173079555343183,0.848372853220429
3,19,4,26,0.13636363636363635,0.8461538461538461,0.15158725488357536,0.8384430240134915
8,19,99,126,0.2962962962962963,0.21428571428571427,0.1462962495925701,0.7598908484262754
4,45,3,52,0.08163265306122448,0.9423076923076923,0.15795805717274503,0.7699641084995354
9,169,28,206,0.05056179775280899,0.8640776699029126,0.165181171137432,0.7709547960366863
20,145,3,168,0.12121212121212122,0.9821428571428571,0.16208902518814322,0.7862609184856658
27,116,7,150,0.1888111888111888,0.9533333333333334,0.16377155318646067,0.8114582985529344
36,64,17,117,0.36,0.8547008547008547,0.17641109907103966,0.8081431382610299
53,167,5,225,0.2409090909090909,0.9777777777777777,0.19134616400610457,0.8269465570644486
30,71,1,102,0.297029702970297,0.9901960784313726,0.19145093638810473,0.9377908947995428
4,51,5,60,0.07272727272727272,0.9166666666666666,0.1901787391975402,0.9341278911365392
3,23,13,39,0.11538461538461539,0.6666666666666666,0.19943914171636967,0.9059263192456468
30,128,4,162,0.189873417721519,0.9753086419753086,0.20924789836056937,0.90495000279314
25,89,26,140,0.21929824561403508,0.8142857142857143,0.21360319218954738,0.8850860572149086
39,77,25,141,0.33620689655172414,0.8226950354609929,0.21020417741122227,0.8805137973234999
9,99,2,110,0.08333333333333333,0.9818181818181818,0.18769335490039976,0.8810909979007003
8,54,4,66,0.12903225806451613,0.9393939393939394,0.1636937199138596,0.8738335494667814
10,111,12,133,0.08264462809917356,0.9097744360902256,0.16511048496698827,0.8728489450987184
10,39,1,50,0.20408163265306123,0.98,0.17778148743390915,0.9176108498606231
24,74,1,99,0.24489795918367346,0.98989898989899,0.1856421362142169,0.919695185278292
10,16,4,30,0.38461538461538464,0.8666666666666667,0.20925887035726687,0.9271781784755707
9,75,12,96,0.10714285714285714,0.875,0.17653543615600012,0.9346503162668575
23,32,2,57,0.41818181818181815,0.9649122807017544,0.22437093399149796,0.9322351875359393
0,4,58,62,0.0,0.06451612903225806,0.20593775426799568,0.8072526431985562
8,190,10,208,0.04040404040404041,0.9519230769230769,0.1999033845972624,0.8132738776032493
42,179,14,235,0.19004524886877827,0.9404255319148936,0.1978981869137934,0.80762038216252
34,105,13,152,0.2446043165467626,0.9144736842105263,0.19785623796566326,0.7968453384927392
7,56,2,65,0.1111111111111111,0.9692307692307692,0.1587841988936242,0.8114973531447539
38,186,6,230,0.16964285714285715,0.9739130434782609,0.16771277032219561,0.8256277879273627
0,8,57,65,0.0,0.12307692307692308,0.10797251058193587,0.7053655939809582
6,7,2,15,0.46153846153846156,0.8666666666666667,0.1739065765160018,0.8199585279287309
28,55,5,88,0.3373493975903614,0.9431818181818182,0.21632734182833338,0.8187097766799797
2,60,3,65,0.03225806451612903,0.9538461538461539,0.19378631549224062,0.8206270083844452
41,99,3,143,0.29285714285714287,0.9790209790209791,0.20067957639372352,0.8298480505002244
15,110,471,596,0.12,0.20973154362416108,0.20194941766356478,0.7213481611278517
1,49,9,59,0.02,0.847457627118644,0.18057186664315664,0.7032831016479063
21,66,20,107,0.2413793103448276,0.8130841121495327,0.2150546252638463,0.8018555572297078
2,0,0,2,1.0,1.0,0.29197770218692326,0.8209031762773268
8,8,1,17,0.5,0.9411764705882353,0.31521350253115726,0.8206166980496723
15,86,4,105,0.1485148514851485,0.9619047619047619,0.33182161495530293,0.8217679277723305
49,77,24,150,0.3888888888888889,0.84,0.34554043581698096,0.8019077879121906
26,33,4,63,0.4406779661016949,0.9365079365079365,0.39135157383150876,0.9057329868955871
8,21,2,31,0.27586206896551724,0.9354838709677419,0.4279032979694398,0.9183081645883153
1,22,1,24,0.043478260869565216,0.9583333333333334,0.4141250640015618,0.9400104342812393
35,57,25,117,0.3804347826086957,0.7863247863247863,0.3256157472313755,0.9094854037562088
16,94,2,112,0.14545454545454545,0.9821428571428571,0.2749663965820249,0.9153377446925832
0,1,0,1,0.0,1.0,0.25092113491300083,0.9207799215633315
31,87,3,121,0.2627118644067797,0.9752066115702479,0.2310835722354542,0.9391427708352716
133,246,36,415,0.35092348284960423,0.9132530120481928,0.2182615031994412,0.9358206387695941
26,55,25,106,0.32098765432098764,0.7641509433962265,0.21485579864431134,0.9113445062593776
0,34,5,39,0.0,0.8717948717948718,0.20864461852008773,0.8989818688967401
0,12,2,14,0.0,0.8571428571428571,0.15429679243313124,0.9090987361564646
2,12,2,16,0.14285714285714285,0.875,0.15392573491921654,0.8937926137074851
37,172,60,269,0.17703349282296652,0.7769516728624535,0.17921623389392607,0.8619285669735498
38,113,21,172,0.25165562913907286,0.877906976744186,0.17763677171282508,0.8480286191412553
3,19,4,26,0.13636363636363635,0.8461538461538461,0.14698536507197255,0.8384430240134915
9,20,97,126,0.3103448275862069,0.23015873015873015,0.14546496125271813,0.7621584221224206
3,46,3,52,0.061224489795918366,0.9423076923076923,0.15421131693784934,0.7722316821956807
9,169,28,206,0.05056179775280899,0.8640776699029126,0.16143443090253634,0.7732223697328313
20,145,3,168,0.12121212121212122,0.9821428571428571,0.1583422849532475,0.788528492181811
30,112,8,150,0.2112676056338028,0.9466666666666667,0.1632328724976527,0.8127734912966985
36,63,18,117,0.36363636363636365,0.8461538461538461,0.17923012028297997,0.8082373297837929
53,167,5,225,0.2409090909090909,0.9777777777777777,0.1941651852180449,0.8270407485872118
29,72,1,102,0.2871287128712871,0.9901960784313726,0.1908485974016278,0.9356175126261606
4,51,5,60,0.07272727272727272,0.9166666666666666,0.192491852106107,0.9319545089631569
1,25,13,39,0.038461538461538464,0.6666666666666666,0.19076324363592548,0.9037529370722648
26,133,4,163,0.16352201257861634,0.9754601226993865,0.1968075138311391,0.9027982607231975
25,89,26,140,0.21929824561403508,0.8142857142857143,0.19795474811402938,0.8838866960973472
37,79,25,141,0.31896551724137934,0.8226950354609929,0.19157319862903163,0.8805354374269394
9,99,2,110,0.08333333333333333,0.9818181818181818,0.16906237611820912,0.88111263800414
8,54,4,66,0.12903225806451613,0.9393939393939394,0.14647716828867044,0.873855189570221
10,111,12,133,0.08264462809917356,0.9097744360902256,0.1478939333417991,0.872870585202158
11,38,1,50,0.22448979591836735,0.98,0.17446939869277464,0.9176324899640628
23,75,1,99,0.23469387755102042,0.98989898989899,0.18463680797454668,0.9196951852782919
10,16,4,30,0.38461538461538464,0.8666666666666667,0.2082535421175966,0.9271781784755707
10,74,12,96,0.11904761904761904,0.875,0.17969384237563085,0.9346503162668576
23,32,2,57,0.41818181818181815,0.9649122807017544,0.2275293402111287,0.9322351875359394
0,4,58,62,0.0,0.06451612903225806,0.20909616048762641,0.8072526431985564
12,186,10,208,0.06060606060606061,0.9519230769230769,0.20594779370289595,0.8132738776032493
43,178,14,235,0.19457013574660634,0.9404255319148936,0.20167355653550154,0.8076203821625197
34,105,13,152,0.2446043165467626,0.9144736842105263,0.20308933353489328,0.7968453384927393
7,56,2,65,0.1111111111111111,0.9692307692307692,0.1640172944628542,0.8114973531447541
33,191,6,230,0.14732142857142858,0.9739130434782609,0.16805641010911268,0.8256277879273627
0,7,58,65,0.0,0.1076923076923077,0.10831615036885298,0.7031677917831559
6,7,2,15,0.46153846153846156,0.8666666666666667,0.17425021630291893,0.8177607257309286
28,55,5,88,0.3373493975903614,0.9431818181818182,0.2137849787292476,0.8165119744821775
2,60,3,65,0.03225806451612903,0.9538461538461539,0.19059753998203657,0.8184292061866432
42,98,3,143,0.3,0.9790209790209791,0.1985112090467848,0.8276502483024221
16,109,471,596,0.128,0.20973154362416108,0.20092390745948316,0.7191503589300495
1,49,9,59,0.02,0.847457627118644,0.1827351319492791,0.7010852994501041
20,67,20,107,0.22988505747126436,0.8130841121495327,0.215575854445174,0.8018555572297078
2,0,0,2,1.0,1.0,0.29249893136825095,0.8209031762773268
8,8,1,17,0.5,0.9411764705882353,0.31573473171248495,0.8206166980496722
17,84,4,105,0.16831683168316833,0.9619047619047619,0.3351716984506335,0.8217679277723305
44,81,25,150,0.352,0.8333333333333334,0.3426002698792049,0.8009554069598097
25,34,4,63,0.423728813559322,0.9365079365079365,0.38484724324482233,0.9047806059432062
9,20,2,31,0.3103448275862069,0.9354838709677419,0.42632507575713763,0.9173557836359344
1,22,1,24,0.043478260869565216,0.9583333333333334,0.4152499233941378,0.9400104342812393
35,59,23,117,0.3723404255319149,0.8034188034188035,0.325584269898697,0.9119274061982112
17,93,2,112,0.15454545454545454,0.9821428571428571,0.2762336205480477,0.9177797471345858
0,1,0,1,0.0,1.0,0.25218835887902363,0.9232219240053341
32,86,3,121,0.2711864406779661,0.9752066115702479,0.23243659056192767,0.9415847732772742
128,250,37,415,0.3386243386243386,0.9108433734939759,0.21785750092230535,0.9379184071324226
28,53,25,106,0.345679012345679,0.7641509433962265,0.2179791332278457,0.9134422746222061
0,34,5,39,0.0,0.8717948717948718,0.2117679531036221,0.9010796372595689
0,12,2,14,0.0,0.8571428571428571,0.15857646374191997,0.9087545020772908
2,12,2,16,0.14285714285714285,0.875,0.15690670492930403,0.8934483796283111
38,171,60,269,0.18181818181818182,0.7769516728624535,0.18288073090332999,0.8615843328943759
42,108,22,172,0.28,0.872093023255814,0.1841398108064777,0.8468538202780282
3,19,4,26,0.13636363636363635,0.8461538461538461,0.15524542476923453,0.8376124592294384
10,21,95,126,0.3225806451612903,0.24603174603174602,0.15194565802860757,0.7635954310345126
4,45,3,52,0.08163265306122448,0.9423076923076923,0.1636074656087825,0.7736686911077726
11,167,28,206,0.06179775280898876,0.8640776699029126,0.1724357160100666,0.7746593786449234
20,145,3,168,0.12121212121212122,0.9821428571428571,0.1693435700607778,0.789965501093903
28,114,8,150,0.19718309859154928,0.9466666666666667,0.17153855817125888,0.8142105002087906
33,70,14,117,0.32038834951456313,0.8803418803418803,0.17730832238762503,0.815388908363943
53,167,5,225,0.2409090909090909,0.9777777777777777,0.19224338732268992,0.8341923271673617
29,72,1,102,0.2871287128712871,0.9901960784313726,0.1871788255669752,0.9405015175101655
2,57,1,60,0.03389830508474576,0.9833333333333333,0.1803596329989068,0.9463623233709713
3,23,13,39,0.11538461538461539,0.6666666666666666,0.18801489908113922,0.9181607514800791
27,132,4,163,0.16981132075471697,0.9754601226993865,0.1949576418729386,0.9172060751310118
25,89,26,140,0.21929824561403508,0.8142857142857143,0.19811694859043655,0.8982945105051615
36,80,25,141,0.3103448275862069,0.8226950354609929,0.1966821597435285,0.8900592469507489
11,97,2,110,0.10185185185185185,0.9818181818181818,0.17681683987820868,0.8906364475279496
9,53,4,66,0.14516129032258066,0.9393939393939394,0.15653577951410774,0.8833789990940305
10,111,12,133,0.08264462809917356,0.9097744360902256,0.16349953994474026,0.8728705852021582
11,38,1,50,0.22448979591836735,0.98,0.17908599430670483,0.9176324899640628
27,71,1,99,0.2755102040816326,0.98989898989899,0.1941858347819785,0.9196951852782919
8,18,4,30,0.3076923076923077,0.8666666666666667,0.20681355793601744,0.9271781784755708
10,74,12,96,0.11904761904761904,0.875,0.17948538528764774,0.9346503162668576
23,33,1,57,0.4107142857142857,0.9824561403508771,0.2236085901251383,0.9347414532000996
0,4,58,62,0.0,0.06451612903225806,0.20287126293619823,0.8097589088627165
10,188,10,208,0.050505050505050504,0.9519230769230769,0.19827989470846635,0.8157801432674097
41,179,15,235,0.18636363636363637,0.9361702127659575,0.19283330048636196,0.809518745091118
44,103,5,152,0.29931972789115646,0.9671052631578947,0.19623466103057963,0.8062624984138187
7,51,7,65,0.1206896551724138,0.8923076923076924,0.1695199963848805,0.8099255020768222
39,185,6,230,0.17410714285714285,0.9739130434782609,0.1773856426433839,0.824055936859431
0,9,56,65,0.0,0.13846153846153847,0.11871217325562879,0.7034852794466683
6,7,2,15,0.46153846153846156,0.8666666666666667,0.18464623918969475,0.818078213394441
29,54,5,88,0.3493975903614458,0.9431818181818182,0.22734517345489405,0.8168294621456897
2,60,3,65,0.03225806451612903,0.9538461538461539,0.205330091762393,0.8193545965857177
42,98,3,143,0.3,0.9790209790209791,0.2054272734922278,0.8210568417090155
16,109,471,596,0.128,0.20973154362416108,0.20647160846759727,0.7235459633256539
1,49,9,59,0.02,0.847457627118644,0.18445630234514826,0.7054809038457085
21,66,20,107,0.2413793103448276,0.8130841121495327,0.21893906096583793,0.8018555572297078
2,0,0,2,1.0,1.0,0.29586213788891486,0.8209031762773268
8,8,1,17,0.5,0.9411764705882353,0.31737676783727975,0.8206166980496722
17,84,4,105,0.16831683168316833,0.9619047619047619,0.33681373457542824,0.8217679277723305
51,76,23,150,0.4015748031496063,0.8466666666666667,0.35132442073965764,0.8028601688645717
26,33,4,63,0.4406779661016949,0.9365079365079365,0.3959927016113284,0.9066853678479679
10,19,2,31,0.3448275862068966,0.9354838709677419,0.44239664249802785,0.9192605455406964
1,22,1,24,0.043478260869565216,0.9583333333333334,0.4124210690801349,0.9400104342812393
35,59,23,117,0.3723404255319149,0.8034188034188035,0.32275541558469417,0.9119274061982112
18,92,2,112,0.16363636363636364,0.9821428571428571,0.27470346753274616,0.9177797471345858
0,1,0,1,0.0,1.0,0.25348706017772493,0.9232219240053341
33,85,3,121,0.2796610169491525,0.9752066115702479,0.2349459456136556,0.9415847732772742
126,252,37,415,0.3333333333333333,0.9108433734939759,0.21961099807531823,0.9379184071324226
27,54,25,106,0.3333333333333333,0.7641509433962265,0.21796896195052348,0.9134422746222061
0,34,5,39,0.0,0.8717948717948718,0.21175778182629987,0.9010796372595689
0,12,2,14,0.0,0.8571428571428571,0.15856629246459772,0.9087545020772908
2,12,2,16,0.14285714285714285,0.875,0.1555978323532805,0.8934483796283111
37,173,59,269,0.1761904761904762,0.7806691449814126,0.1807679003804914,0.8621154003399415
43,107,22,172,0.2866666666666667,0.872093023255814,0.18176870748299342,0.8473848877235939
4,18,4,26,0.18181818181818182,0.8461538461538461,0.1601236858379718,0.8381435266750039
11,20,95,126,0.3548387096774194,0.24603174603174602,0.1631958824585555,0.7641264984800781
4,45,3,52,0.08163265306122448,0.9423076923076923,0.17485769003873042,0.7741997585533381
12,166,28,206,0.06741573033707865,0.8640776699029126,0.1844885086583131,0.775190446090489
21,144,3,168,0.12727272727272726,0.9821428571428571,0.18226216357482516,0.7904965685394686
27,115,8,150,0.19014084507042253,0.9466666666666667,0.18425507341481748,0.8142105002087906
37,67,13,117,0.3557692307692308,0.8888888888888888,0.19412686828661238,0.8166099095849441
53,167,5,225,0.2409090909090909,0.9777777777777777,0.2025684267281708,0.8354133283883629
29,72,1,102,0.2871287128712871,0.9901960784313726,0.19289557004158045,0.9417225187311667
3,56,1,60,0.05084745762711865,0.9833333333333333,0.18849768497956537,0.9475833245919726
2,24,13,39,0.07692307692307693,0.6666666666666666,0.18985587734899365,0.9193817527010802
31,128,4,163,0.1949685534591195,0.9754601226993865,0.1995267096613354,0.918427076352013
24,90,26,140,0.21052631578947367,0.8142857142857143,0.202438919764057,0.8995155117261627
37,79,25,141,0.31896551724137934,0.8226950354609929,0.19718124640293538,0.8900592469507489
9,99,2,110,0.08333333333333333,0.9818181818181818,0.17467042389211287,0.8906364475279496
10,52,4,66,0.16129032258064516,0.9393939393939394,0.15669351099344972,0.8833789990940305
10,111,12,133,0.08264462809917356,0.9097744360902256,0.161235963918029,0.872870585202158
13,36,1,50,0.2653061224489796,0.98,0.18814782756458653,0.9176324899640628
27,71,1,99,0.2755102040816326,0.98989898989899,0.19965377765351697,0.9196951852782919
8,18,4,30,0.3076923076923077,0.8666666666666667,0.21353463363963612,0.9271781784755708
10,74,12,96,0.11904761904761904,0.875,0.18497493389767034,0.9346503162668576
24,32,1,57,0.42857142857142855,0.9824561403508771,0.23429466178882682,0.9347414532000996
0,4,58,62,0.0,0.06451612903225806,0.21125318713444896,0.8097589088627167
10,188,10,208,0.050505050505050504,0.9519230769230769,0.2066618189067171,0.8157801432674097
42,179,14,235,0.19004524886877827,0.9404255319148936,0.19591026553811686,0.8101266478266803
44,104,4,152,0.2972972972972973,0.9736842105263158,0.19902270742606895,0.807810250773441
6,52,7,65,0.10344827586206896,0.8923076923076924,0.16984498859317773,0.8114732544364447
36,188,6,230,0.16071428571428573,0.9739130434782609,0.17579736954555872,0.8256036892190534
0,8,57,65,0.0,0.12307692307692308,0.11457287974964034,0.7028352296084887
6,7,2,15,0.46153846153846156,0.8666666666666667,0.1805069456837063,0.8174281635562612
29,54,5,88,0.3493975903614458,0.9431818181818182,0.2232058799489056,0.8161794123075099
2,60,3,65,0.03225806451612903,0.9538461538461539,0.20066485361281286,0.8180966440119757
42,98,3,143,0.3,0.9790209790209791,0.20105095399891323,0.8188590395112133
17,110,469,596,0.13385826771653545,0.21308724832214765,0.2053952385495513,0.7218275475132784
1,49,9,59,0.02,0.847457627118644,0.18529319773322478,0.7037624880333331
21,66,20,107,0.2413793103448276,0.8130841121495327,0.21977595635391442,0.8023349436151345
2,0,0,2,1.0,1.0,0.2966990332769913,0.8213825626627536
8,8,1,17,0.5,0.9411764705882353,0.3182136632253562,0.8210960844350988
17,84,4,105,0.16831683168316833,0.9619047619047619,0.33765062996350476,0.8222473141577572
52,75,23,150,0.4094488188976378,0.8466666666666667,0.3532861755203101,0.8033395552499982
26,33,4,63,0.4406779661016949,0.9365079365079365,0.39711756100390433,0.9066853678479682
10,19,2,31,0.3448275862068966,0.9354838709677419,0.4435215018906038,0.9192605455406964
2,21,1,24,0.08695652173913043,0.9583333333333334,0.43545923680896365,0.9370423939033052
35,60,22,117,0.3684210526315789,0.811965811965812,0.34523367289918916,0.9101803670412785
18,92,2,112,0.16363636363636364,0.9821428571428571,0.2971817248472411,0.916032707977653
0,1,0,1,0.0,1.0,0.2686102962758125,0.9221117353332761
33,87,3,123,0.275,0.975609756097561,0.24857397666322173,0.9419303529723401
127,250,36,413,0.33687002652519893,0.9128329297820823,0.23404162456281158,0.9388455958686094
29,52,25,106,0.35802469135802467,0.7641509433962265,0.22698695084147116,0.9150050902454101
0,34,5,39,0.0,0.8717948717948718,0.21456459059302396,0.9026424528827729
0,13,1,14,0.0,0.9285714285714286,0.16193301164565552,0.9193003981121467
2,13,1,16,0.13333333333333333,0.9375,0.1576040073166512,0.9129228470917384
38,171,60,269,0.18181818181818182,0.7769516728624535,0.18357803329067718,0.8810588003578033
42,108,22,172,0.28,0.872093023255814,0.18429231900496293,0.866270695666125
3,23,0,26,0.11538461538461539,1.0,0.15265154598487954,0.8787231342686848
14,45,67,126,0.23728813559322035,0.46825396825396826,0.13540346658990748,0.8364521378197908
4,45,3,52,0.08163265306122448,0.9423076923076923,0.14706527417008242,0.8465253978930508
12,167,27,206,0.0670391061452514,0.8689320388349514,0.15664228933368976,0.838005485073554
21,144,3,168,0.12727272727272726,0.9821428571428571,0.15577648846788889,0.8443830360939621
26,116,8,150,0.18309859154929578,0.9466666666666667,0.15595940414376233,0.8686280352088497
34,73,10,117,0.3177570093457944,0.9145299145299145,0.16135326262173294,0.874690448248007
53,167,5,225,0.2409090909090909,0.9777777777777777,0.17928533055380086,0.8715158450734038
29,72,1,102,0.2871287128712871,0.9901960784313726,0.1864054130220961,0.9460790036701759
2,57,1,60,0.03389830508474576,0.9833333333333333,0.17958622045402775,0.9519398095309818
2,24,13,39,0.07692307692307693,0.6666666666666666,0.18099821627943138,0.9230447563640839
29,130,4,163,0.18238993710691823,0.9754601226993865,0.18887210339860153,0.9220900800150167
23,91,26,140,0.20175438596491227,0.8142857142857143,0.19153721688654674,0.9031785153891665
35,81,25,141,0.3017241379310345,0.8226950354609929,0.18924680668443816,0.890059246950749
8,99,2,109,0.07476635514018691,0.981651376146789,0.16551213014602334,0.890612618146322
11,53,2,66,0.171875,0.9696969696969697,0.14904731402155375,0.8876841740414073
10,110,13,133,0.08333333333333333,0.9022556390977443,0.15610946091420907,0.8761016462934661
14,35,1,50,0.2857142857142857,0.98,0.18593677645581036,0.9208635510553708
27,71,1,99,0.2755102040816326,0.98989898989899,0.1992396717379124,0.9229262463695999
8,18,4,30,0.3076923076923077,0.8666666666666667,0.21437366055611176,0.9304092395668787
12,77,7,96,0.1348314606741573,0.9270833333333334,0.19053184951941501,0.9453218535486416
24,32,1,57,0.42857142857142855,0.9824561403508771,0.24107543143816382,0.9454368198635115
0,4,58,62,0.0,0.06451612903225806,0.2165218600095924,0.8161252711971241
12,186,10,208,0.06060606060606061,0.9519230769230769,0.21327510676283915,0.8232206194578858
43,179,13,235,0.19369369369369369,0.9446808510638298,0.20012930790275457,0.8181750267527187
44,104,4,152,0.2972972972972973,0.9736842105263158,0.20324174979070667,0.8158586296994796
7,56,2,65,0.1111111111111111,0.9692307692307692,0.1751587217076786,0.8305106443514942
37,187,6,230,0.16517857142857142,0.9739130434782609,0.17949402324402347,0.8372006029436267
9,55,1,65,0.140625,0.9846153846153847,0.13835881916239082,0.8375090664099849
6,7,2,15,0.46153846153846156,0.8666666666666667,0.20429288509645677,0.9521020003577576
29,53,5,87,0.35365853658536583,0.9425287356321839,0.2461575245220718,0.9507599516019158
2,60,3,65,0.03225806451612903,0.9538461538461539,0.22309529178241969,0.9520692805708192
42,98,3,143,0.3,0.9790209790209791,0.2234813921685201,0.9528316760700567
17,109,469,595,0.1349206349206349,0.21176470588235294,0.22688275271273775,0.8446222384488544
1,49,9,59,0.02,0.847457627118644,0.20614295679437042,0.8265571789689092
21,66,20,107,0.2413793103448276,0.8130841121495327,0.22053642970077436,0.8020527114737874
2,0,0,2,1.0,1.0,0.2974595066238513,0.8211003305214064
8,8,1,17,0.5,0.9411764705882353,0.31836542996879896,0.8209071498008423
15,86,4,105,0.1485148514851485,0.9619047619047619,0.33497354239294463,0.8220583795235008
52,75,23,150,0.4094488188976378,0.8466666666666667,0.3506090879497501,0.8031506206157418
26,33,4,63,0.4406779661016949,0.9365079365079365,0.3942887066899014,0.9066853678479682
10,19,2,31,0.3448275862068966,0.9354838709677419,0.440692647576601,0.9192605455406964
1,20,1,22,0.047619047619047616,0.9545454545454546,0.4279670514871318,0.9366523599992577
34,55,25,114,0.38202247191011235,0.7807017543859649,0.3396845474742908,0.9053240391972527
14,80,2,96,0.14893617021276595,0.9791666666666666,0.28953257179040015,0.9107512100655999
0,1,0,1,0.0,1.0,0.25937384163167004,0.9168302374212232
34,71,3,108,0.3238095238095238,0.9722222222222222,0.25115292614683205,0.9361649216495243
123,217,36,376,0.36176470588235293,0.9042553191489362,0.2387941895487445,0.9317036999611235
25,47,25,97,0.3472222222222222,0.7422680412371134,0.2301963059508609,0.9047370654580511
0,28,5,33,0.0,0.8484848484848485,0.22339358486242553,0.8895855503065359
0,12,2,14,0.0,0.8571428571428571,0.16881894601812375,0.9005057078432347
1,8,2,11,0.1111111111111111,0.8181818181818182,0.1634153661464588,0.8775078723453993
38,143,60,241,0.20994475138121546,0.7510373443983402,0.19340747348663243,0.8419417786880193
39,98,21,158,0.2846715328467153,0.8670886075949367,0.18781633192051692,0.8269226908841214
3,18,4,25,0.14285714285714285,0.84,0.15654382291691551,0.8177433595771305
7,22,93,122,0.2413793103448276,0.23770491803278687,0.14142340693443053,0.7456629134050837
3,43,3,49,0.06521739130434782,0.9387755102040817,0.15074017712076596,0.7585615793649743
11,151,27,189,0.06790123456790123,0.8571428571428571,0.16044035348760896,0.7585615793649743
21,111,3,135,0.1590909090909091,0.9777777777777777,0.16729461034186582,0.7813610021643971
28,108,8,144,0.20588235294117646,0.9444444444444444,0.16671426770757455,0.808990587885269
29,61,16,106,0.32222222222222224,0.8490566037735849,0.17207865190407554,0.8064145873393616
53,167,5,225,0.2409090909090909,0.9777777777777777,0.18608607305435385,0.8260971270219013
21,61,1,83,0.25609756097560976,0.9879518072289156,0.18818868028732272,0.9332752540499197
4,48,1,53,0.07692307692307693,0.9811320754716981,0.18986092108999827,0.9393261919452937
1,23,12,36,0.041666666666666664,0.6666666666666666,0.18611312567553623,0.912115307591552
23,132,4,159,0.14838709677419354,0.9748427672955975,0.18458400963029112,0.9116960203798119
22,82,27,131,0.21153846153846154,0.7938931297709924,0.185392025144189,0.8901886897121761
33,66,26,125,0.3333333333333333,0.792,0.18697932673149056,0.8820377463159497
9,92,2,103,0.0891089108910891,0.9805825242718447,0.1652935867289189,0.8824384243865306
12,48,4,64,0.2,0.9375,0.1572796494466889,0.8752310233538283
10,99,13,122,0.09174311926605505,0.8934426229508197,0.15939679835282866,0.8627039587079885
12,35,1,48,0.2553191489361702,0.9791666666666666,0.1899185815341863,0.9073468158508458
26,69,1,96,0.2736842105263158,0.9895833333333334,0.20781816921306093,0.9094526109990938
8,17,4,29,0.32,0.8620689655172413,0.2233126747075664,0.9191920161057007
9,59,12,80,0.1323529411764706,0.85,0.19460119011372887,0.9274777303914149
24,27,1,52,0.47058823529411764,0.9807692307692307,0.24909823645701865,0.9275044027481844
0,2,58,60,0.0,0.03333333333333333,0.22052680788559012,0.7983377360815177
12,157,10,179,0.07100591715976332,0.9441340782122905,0.21756435044183414,0.8055793725474422
44,141,14,199,0.23783783783783785,0.9296482412060302,0.21506702028492955,0.7985053117673512
45,92,3,140,0.3284671532846715,0.9785714285714285,0.2228931549646946,0.7969321825156505
5,52,7,64,0.08771929824561403,0.890625,0.18971019757121094,0.8010116160131874
38,169,6,213,0.18357487922705315,0.971830985915493,0.1970276172927227,0.8184160425725436
0,9,56,65,0.0,0.13846153846153847,0.1298007265364202,0.6980863722428733
6,6,2,14,0.5,0.8571428571428571,0.20122929796499162,0.8157734470728053
28,43,5,76,0.39436619718309857,0.9342105263157895,0.24742362368261092,0.8143557968018765
1,60,3,64,0.01639344262295082,0.953125,0.21578871008048423,0.8177096194867294
41,78,3,122,0.3445378151260504,0.9754098360655737,0.2180845189149669,0.8172579634144644
16,77,413,506,0.17204301075268819,0.18379446640316205,0.23013076355883463,0.7162821729006305
1,44,9,54,0.022222222222222223,0.8333333333333334,0.20708038398671594,0.6964967939603219
20,61,20,101,0.24691358024691357,0.801980198019802,0.24235375259341788,0.7912851738972166
2,0,0,2,1.0,1.0,0.31378232402198936,0.8116933371625229
8,8,1,17,0.5,0.9411764705882353,0.32887286728154663,0.8126884720585865
18,72,4,94,0.2,0.9574468085106383,0.355102375478268,0.8133058732743921
49,69,23,141,0.4152542372881356,0.8368794326241135,0.365204721501423,0.7935158156398977
25,32,4,61,0.43859649122807015,0.9344262295081968,0.40328379014076327,0.9007489246549026
11,16,2,29,0.4074074074074074,0.9310344827586207,0.45831024516721824,0.914706231715658
1,20,1,22,0.047619047619047616,0.9545454545454546,0.411063061658687,0.9391732984441034
34,55,25,114,0.38202247191011235,0.7807017543859649,0.3227805576458459,0.9078449776420985
14,80,2,96,0.14893617021276595,0.9791666666666666,0.27262858196195533,0.9132721485104458
0,1,0,1,0.0,1.0,0.2485833202929313,0.9187143253811941
34,71,3,108,0.3238095238095238,0.9722222222222222,0.2411275379800061,0.9369468436137123
124,218,35,377,0.36257309941520466,0.9071618037135278,0.22996969988193608,0.9327545389287967
27,45,25,97,0.375,0.7422680412371134,0.2342800447095223,0.9051522775387069
0,28,5,33,0.0,0.8484848484848485,0.2274773236210869,0.8900007623871918
0,12,2,14,0.0,0.8571428571428571,0.17290268477678514,0.9009209199238908
1,8,2,11,0.1111111111111111,0.8181818181818182,0.16749910490512018,0.8779230844260552
36,144,61,241,0.2,0.7468879668049793,0.19607053347654874,0.8417642225410523
42,94,22,158,0.3088235294117647,0.8607594936708861,0.19392967713401174,0.825840975605147
3,18,4,25,0.14285714285714285,0.84,0.16254168334000288,0.8162464322175003
10,19,94,123,0.3448275862068966,0.23577235772357724,0.1582313385124167,0.7438899060012808
3,42,3,48,0.06666666666666667,0.9375,0.1677551480362262,0.7566063562177311
9,153,27,189,0.05555555555555555,0.8571428571428571,0.17569165597273415,0.7566063562177309
19,112,3,134,0.1450381679389313,0.9776119402985075,0.18053837837670844,0.7793820879486867
32,104,8,144,0.23529411764705882,0.9444444444444444,0.18558039518343114,0.8076044418971817
33,60,13,106,0.3548387096774194,0.8773584905660378,0.19215399236423897,0.8099757271679177
53,166,6,225,0.2420091324200913,0.9733333333333334,0.20631856230180304,0.8290233462155366
21,61,1,83,0.25609756097560976,0.9879518072289156,0.1936428444116192,0.9364775532877279
3,49,1,53,0.057692307692307696,0.9811320754716981,0.19236079312956791,0.9427107069265419
2,22,12,36,0.08333333333333333,0.6666666666666666,0.19632904709782187,0.9154998225728005
24,131,4,159,0.15483870967741936,0.9748427672955975,0.19772912448903446,0.9151042264295276
22,83,26,131,0.20952380952380953,0.8015267175572519,0.19404765189999887,0.8946874083027857
32,68,25,125,0.32,0.8,0.18907069337465318,0.8836361953647803
12,89,2,103,0.1188118811881188,0.9805825242718447,0.1714710860558,0.8846717940702821
14,46,4,64,0.23333333333333334,0.9375,0.1682190535354748,0.8774643930375797
10,100,12,122,0.09090909090909091,0.9016393442622951,0.17296430828072953,0.8661082885790936
14,33,1,48,0.2978723404255319,0.9791666666666666,0.20361273786532935,0.9107511457219507
27,67,2,96,0.2872340425531915,0.9791666666666666,0.2225263568475825,0.9113688456321034
9,16,4,29,0.36,0.8620689655172413,0.24402295548703828,0.9200177381978162
9,59,12,80,0.1323529411764706,0.85,0.21721623279796262,0.9271605953406733
24,28,1,53,0.46153846153846156,0.9811320754716981,0.2661771728480116,0.9272391026549381
0,3,58,61,0.0,0.04918032786885246,0.23284383951467827,0.8003362923504884
12,157,10,179,0.07100591715976332,0.9441340782122905,0.23000052897906006,0.8064069686290594
42,143,14,199,0.22702702702702704,0.9296482412060302,0.2198797699221308,0.7993329078489683
42,94,4,140,0.3088235294117647,0.9714285714285714,0.22296398233049844,0.7982274656720975
5,52,7,64,0.08771929824561403,0.890625,0.18406673922272895,0.8023068991696345
35,173,6,214,0.16826923076923078,0.9719626168224299,0.18919763773598045,0.8197301301442674
0,9,56,65,0.0,0.13846153846153847,0.1232635718019145,0.6993486248571017
6,6,2,14,0.5,0.8571428571428571,0.19469214323048595,0.8147718433248167
28,43,5,76,0.39436619718309857,0.9342105263157895,0.24088646894810525,0.8133541930538879
1,60,3,64,0.01639344262295082,0.953125,0.21079595689038008,0.8167080157387409
43,76,3,122,0.36134453781512604,0.9754098360655737,0.21829895809086025,0.8172767678297411
17,76,413,506,0.1827956989247312,0.18379446640316205,0.23188130104501983,0.7163009773159071
1,43,9,53,0.022727272727272728,0.8301886792452831,0.21108959275331154,0.696047557662029
20,61,20,101,0.24691358024691357,0.801980198019802,0.2463629613600135,0.7908359375989237
2,0,0,2,1.0,1.0,0.3177915327885849,0.8112441008642299
8,8,1,17,0.5,0.9411764705882353,0.33288207604814224,0.8122392357602937
19,71,4,94,0.2111111111111111,0.9574468085106383,0.3606988858321652,0.8128566369760991
45,73,23,141,0.3813559322033898,0.8368794326241135,0.36355765645906,0.7930665793416047
26,32,4,62,0.4482758620689655,0.9354838709677419,0.4014833940510934,0.9004507799936876
11,16,2,29,0.4074074074074074,0.9310344827586207,0.4564376990053984,0.9148573233527358
1,22,1,24,0.043478260869565216,0.9583333333333334,0.40241716065023353,0.939863422456375
34,59,24,117,0.3655913978494624,0.7948717948717948,0.3117873603430139,0.9105593931523457
12,97,2,111,0.11009174311926606,0.9819819819819819,0.2560861807886234,0.916388751922881
0,1,0,1,0.0,1.0,0.23345534627660072,0.9218309287936294
35,83,3,121,0.2966101694915254,0.9752066115702479,0.22140645892504995,0.9403407898904337
130,250,36,416,0.34210526315789475,0.9134615384615384,0.20974595172484603,0.9370484473123767
27,54,25,106,0.3333333333333333,0.7641509433962265,0.21303002397443555,0.9125723148021604
0,35,5,40,0.0,0.875,0.2068188438502119,0.9006675528973984
0,12,2,14,0.0,0.8571428571428571,0.1545915013002887,0.9095634189361216
1,13,2,16,0.07142857142857142,0.875,0.14906819105876093,0.8942802786529812
36,173,60,269,0.1722488038277512,0.7769516728624535,0.17367516303415395,0.862416231919046
40,109,21,170,0.2684563758389262,0.8764705882352941,0.16965319251235408,0.8483110857283384
3,19,4,26,0.13636363636363635,0.8461538461538461,0.14026153154174573,0.8386957011129538
7,19,100,126,0.2692307692307692,0.20634920634920634,0.13110402238423657,0.7590097386776652
4,46,3,53,0.08,0.9433962264150944,0.142532593812808,0.7687806281655358
9,170,28,207,0.05027932960893855,0.8647342995169082,0.1497153551855135,0.7698651199332573
22,142,3,167,0.13414634146341464,0.9820359281437125,0.15867503661906254,0.7851559668109306
28,113,8,149,0.19858156028368795,0.9463087248322147,0.16243685896991064,0.8093498313780394
34,74,8,116,0.3148148148148148,0.9310344827586207,0.1690594931093233,0.8171446734528003
53,166,6,225,0.2420091324200913,0.9733333333333334,0.18415170683167403,0.8353131716212985
29,72,1,102,0.2871287128712871,0.9901960784313726,0.18670855592317656,0.9472912962044651
5,50,5,60,0.09090909090909091,0.9166666666666666,0.18826699748161815,0.9434727876689754
2,24,13,39,0.07692307692307693,0.6666666666666666,0.19207324709792362,0.9151774115475124
23,137,4,164,0.14375,0.975609756097561,0.1934451983174358,0.9142593869694907
23,91,26,140,0.20175438596491227,0.8142857142857143,0.19389845912903927,0.8953989568914192
34,81,25,140,0.2956521739130435,0.8214285714285714,0.19116093900021477,0.879740969558555
13,95,2,110,0.12037037037037036,0.9818181818181818,0.1737839729931118,0.8809530907706762
13,49,4,66,0.20967741935483872,0.9393939393939394,0.16271950249076203,0.8736956423367571
10,111,12,133,0.08264462809917356,0.9097744360902256,0.16153886494648814,0.8727110379686941
12,37,1,50,0.24489795918367346,0.98,0.1855352766980019,0.9174729427305989
25,72,2,99,0.25773195876288657,0.9797979797979798,0.2018184136641286,0.9180712604020872
8,18,4,30,0.3076923076923077,0.8666666666666667,0.21695240248232792,0.9255542535993663
9,76,11,96,0.10588235294117647,0.8854166666666666,0.1898424280577755,0.9346954100619512
23,32,2,57,0.41818181818181815,0.9649122807017544,0.232386920602268,0.932280281331033
0,4,58,62,0.0,0.06451612903225806,0.20243300355157676,0.80729773699365
13,185,10,208,0.06565656565656566,0.9519230769230769,0.20000613748834709,0.8133189713983431
42,178,14,234,0.19090909090909092,0.9401709401709402,0.19229344202054957,0.8076291057084773
37,100,14,151,0.27007299270072993,0.9072847682119205,0.1940564468688129,0.7972700754818975
7,51,7,65,0.1206896551724138,0.8923076923076924,0.16734178222311377,0.8009330791449011
33,191,6,230,0.14732142857142858,0.9739130434782609,0.17326165017029266,0.8135754186894146
0,8,57,65,0.0,0.12307692307692308,0.11352139043003293,0.69331322474301
6,8,1,15,0.42857142857142855,0.9333333333333333,0.1747458802259513,0.8174299682145924
27,56,5,88,0.3253012048192771,0.9431818181818182,0.21183797153491007,0.8161812169658411
2,60,3,65,0.03225806451612903,0.9538461538461539,0.18917353919305838,0.8181348189194431
42,98,3,143,0.3,0.9790209790209791,0.19344882595009696,0.8283828490350229
14,79,413,506,0.15053763440860216,0.18379446640316205,0.19771282298383813,0.7271666739058044
1,49,9,59,0.02,0.847457627118644,0.17952404747363407,0.709101614425859
20,67,20,107,0.22988505747126436,0.8130841121495327,0.21236476996952897,0.8076740700076603
2,0,0,2,1.0,1.0,0.2939974230307535,0.8171978795314698
8,8,1,17,0.5,0.9411764705882353,0.31895439377085666,0.8169114013038151
17,84,4,105,0.16831683168316833,0.9619047619047619,0.33839136050900515,0.8180626310264734
47,78,23,148,0.376,0.8445945945945946,0.3492485033661481,0.7988588618227042
26,33,4,63,0.4406779661016949,0.9365079365079365,0.39069712217944697,0.9063893575519577
10,19,2,31,0.3448275862068966,0.9354838709677419,0.43710106306614654,0.918964535244686
1,22,1,24,0.043478260869565216,0.9583333333333334,0.40791423639461666,0.9389046496855217
34,58,25,117,0.3695652173913043,0.7863247863247863,0.3178521245933745,0.9083796191604913
13,96,2,111,0.11926605504587157,0.9819819819819819,0.26346156102849894,0.9142089779310264
0,1,0,1,0.0,1.0,0.24083072651647633,0.9196511548017747
34,87,3,124,0.2809917355371901,0.9758064516129032,0.22840097445036062,0.9392054801040975
131,249,36,416,0.3447368421052632,0.9134615384615384,0.2146950995937275,0.9359131375260407
27,54,25,106,0.3333333333333333,0.7641509433962265,0.21305306346893277,0.9114370050158241
0,35,5,40,0.0,0.875,0.20684188334470915,0.8995322431110623
0,12,2,14,0.0,0.8571428571428571,0.15404685228880854,0.9096491103707868
2,12,2,16,0.14285714285714285,0.875,0.15741700769041872,0.8943659700876464
35,174,60,269,0.1674641148325359,0.7769516728624535,0.18134045266649526,0.8625019233537111
41,108,21,170,0.2751677852348993,0.8764705882352941,0.180508459766168,0.8483110857283382
3,19,4,26,0.13636363636363635,0.8461538461538461,0.15074085894593559,0.8386957011129538
4,19,103,126,0.17391304347826086,0.18253968253968253,0.1279665318237824,0.7556083781334475
4,46,3,53,0.08,0.9433962264150944,0.13939510325235382,0.7653792676213181
10,169,28,207,0.055865921787709494,0.8647342995169082,0.1473759492220266,0.7664637593890397
21,144,3,168,0.12727272727272726,0.9821428571428571,0.1451496041385387,0.7817698818380192
27,115,8,150,0.19014084507042253,0.9466666666666667,0.14838913702966533,0.806014880952907
35,72,9,116,0.32710280373831774,0.9224137931034483,0.15580842538729653,0.8125781959340718
53,166,6,225,0.2420091324200913,0.9733333333333334,0.17090063910964726,0.8307466941025698
29,72,1,102,0.2871287128712871,0.9901960784313726,0.18707430616579382,0.9461261792299542
5,54,1,60,0.0847457627118644,0.9833333333333333,0.18775227226748875,0.9518314802182741
3,23,13,39,0.11538461538461539,0.6666666666666666,0.19625494278133246,0.923536104096811
23,136,5,164,0.14465408805031446,0.9695121951219512,0.19873799432098777,0.9217317238081103
23,91,26,140,0.20175438596491227,0.8142857142857143,0.2003970715916292,0.9028201591822598
35,80,25,140,0.30434782608695654,0.8214285714285714,0.19714636049857756,0.8883936989429918
10,98,2,110,0.09259259259259259,0.9818181818181818,0.17580114052322063,0.8896058201551129
13,49,4,66,0.20967741935483872,0.9393939393939394,0.16473667002087083,0.8823483717211938
10,111,12,133,0.08264462809917356,0.9097744360902256,0.16443650793334358,0.8718399578293213
12,37,1,50,0.24489795918367346,0.98,0.18293841419035187,0.9166018625912261
25,72,2,99,0.25773195876288657,0.9797979797979798,0.19909239572071932,0.9180712604020874
10,16,4,30,0.38461538461538464,0.8666666666666667,0.22521539552792966,0.9255542535993663
9,75,12,96,0.10714285714285714,0.875,0.19704325710734402,0.9332073148238561
24,31,2,57,0.43636363636363634,0.9649122807017544,0.24615340621749313,0.9307921860929379
0,4,58,62,0.0,0.06451612903225806,0.2161994891668019,0.8058096417555548
13,185,10,208,0.06565656565656566,0.9519230769230769,0.2137726231035722,0.8118308761602478
43,178,13,234,0.19457013574660634,0.9444444444444444,0.20658293404113404,0.8067515110808827
35,101,15,151,0.25735294117647056,0.9006622516556292,0.20652878867164604,0.795446407060547
7,51,7,65,0.1206896551724138,0.8923076923076924,0.1688251130369359,0.7991094107235506
34,190,6,230,0.15178571428571427,0.9739130434782609,0.17520266405734408,0.8132398455061594
0,8,57,65,0.0,0.12307692307692308,0.11286500171968175,0.6929776515597548
6,8,1,15,0.42857142857142855,0.9333333333333333,0.1740894915156001,0.8170943950313371
27,56,5,88,0.3253012048192771,0.9431818181818182,0.21118158282455887,0.8158456437825858
2,60,3,65,0.03225806451612903,0.9538461538461539,0.18799414407734782,0.8171887451256872
40,100,3,143,0.2857142857142857,0.9790209790209791,0.19204576472560714,0.8283828490350229
14,83,412,509,0.14432989690721648,0.1905697445972495,0.19542294211629324,0.7281345707906739
1,49,9,59,0.02,0.847457627118644,0.17659641150404834,0.7100695113107286
20,67,20,107,0.22988505747126436,0.8130841121495327,0.20943713399994324,0.8086419668925301
2,0,0,2,1.0,1.0,0.2910697870611677,0.8181657764163396
8,8,1,17,0.5,0.9411764705882353,0.31602675780127104,0.8178792981886848
16,85,4,105,0.15841584158415842,0.9619047619047619,0.33404929738241806,0.819030527911343
48,78,23,149,0.38095238095238093,0.8456375838926175,0.3476547395592888,0.7999757571787199
25,34,4,63,0.423728813559322,0.9365079365079365,0.3875688705095896,0.9065383560231038
9,20,2,31,0.3103448275862069,0.9354838709677419,0.42904670302190484,0.919113533715832
1,22,1,24,0.043478260869565216,0.9583333333333334,0.3367119733111655,0.9375441054678346
34,59,24,117,0.3655913978494624,0.7948717948717948,0.31751074443251726,0.9082400761638053
14,95,2,111,0.12844036697247707,0.9819819819819819,0.2644307968571568,0.9140694349343407
0,1,0,1,0.0,1.0,0.241573654000014,0.9208721560227761
34,87,3,124,0.2809917355371901,0.9758064516129032,0.22914390193389828,0.9404264813250987
125,255,36,416,0.32894736842105265,0.9134615384615384,0.2131823879795208,0.9371341387470418
29,52,25,106,0.35802469135802467,0.7641509433962265,0.21506768871539625,0.9126580062368255
0,35,5,40,0.0,0.875,0.20885650859117266,0.9007532443320635
0,12,2,14,0.0,0.8571428571428571,0.15662916604124946,0.9096491103707866
2,12,2,16,0.14285714285714285,0.875,0.15868870545334457,0.8943659700876463
37,172,60,269,0.17703349282296652,0.7769516728624535,0.18397920442805407,0.862501923353711
39,110,21,170,0.26174496644295303,0.8764705882352941,0.1812296659860202,0.8483110857283384
3,19,4,26,0.13636363636363635,0.8461538461538461,0.15371770426353218,0.8386957011129538
8,21,97,126,0.27586206896551724,0.23015873015873015,0.14198018677888824,0.7624110992218828
4,46,3,53,0.08,0.9433962264150944,0.15340875820745967,0.7721819887097535
9,170,28,207,0.05027932960893855,0.8647342995169082,0.16059151958016518,0.773266480477475
21,144,3,168,0.12727272727272726,0.9821428571428571,0.15836517449667722,0.7885726029264547
29,113,8,150,0.20422535211267606,0.9466666666666667,0.16224972582377858,0.8128176020413422
35,74,7,116,0.3211009174311927,0.9396551724137931,0.1707291473935271,0.8218439712096993
53,166,6,225,0.2420091324200913,0.9733333333333334,0.18582136111587785,0.8400124693781975
29,72,1,102,0.2871287128712871,0.9901960784313726,0.18743088167384497,0.9485892334171463
4,51,5,60,0.07272727272727272,0.9166666666666666,0.18639192063488388,0.9447707248816567
2,24,13,39,0.07692307692307693,0.6666666666666666,0.1901981702511894,0.9164753487601935
23,135,6,164,0.14556962025316456,0.9634146341463414,0.19281201210553758,0.9137998883321199
23,91,26,140,0.20175438596491227,0.8142857142857143,0.19245901694157133,0.8948883237062696
35,79,26,140,0.30701754385964913,0.8142857142857143,0.19044710643135082,0.876978401116544
9,99,2,110,0.08333333333333333,0.9818181818181818,0.16777913513324252,0.8781905223286653
11,51,4,66,0.1774193548387097,0.9393939393939394,0.15210636970001717,0.8709330738947462
10,111,12,133,0.08264462809917356,0.9097744360902256,0.15352313475314586,0.8699484695266833
13,36,1,50,0.2653061224489796,0.98,0.1804349983997034,0.9147103742885879
26,71,2,99,0.26804123711340205,0.9797979797979798,0.19793094366545158,0.9170508522388221
8,18,4,30,0.3076923076923077,0.8666666666666667,0.21306493248365094,0.9245338454361011
9,75,12,96,0.10714285714285714,0.875,0.18451140580982356,0.9332073148238561
24,31,2,57,0.43636363636363634,0.9649122807017544,0.23494430624272394,0.9307921860929379
0,4,58,62,0.0,0.06451612903225806,0.20959868412290827,0.8058096417555548
12,186,10,208,0.06060606060606061,0.9519230769230769,0.2064503173381779,0.8118308761602478
41,180,13,234,0.18552036199095023,0.9444444444444444,0.19505235155845937,0.8067515110808828
37,105,9,151,0.2605633802816901,0.9403973509933775,0.19398408629678626,0.8011228498230825
7,51,7,65,0.1206896551724138,0.8923076923076924,0.1672694216510871,0.8047858534860861
36,188,6,230,0.16071428571428573,0.9739130434782609,0.17492248287557693,0.8189162882686948
0,9,56,65,0.0,0.13846153846153847,0.11258482053791459,0.7008518965200924
6,7,2,15,0.46153846153846156,0.8666666666666667,0.17851888647198053,0.8154448304678652
30,53,5,88,0.3614457831325301,0.9431818181818182,0.2214959896900476,0.814196079219114
2,60,3,65,0.03225806451612903,0.9538461538461539,0.19960137576507314,0.8155391805622153
39,100,4,143,0.2805755395683453,0.972027972027972,0.20246025566316675,0.8200578407100145
16,81,412,509,0.16494845360824742,0.1905697445972495,0.20878294115400012,0.7198095624656656
1,49,9,59,0.02,0.847457627118644,0.18868090033767362,0.7017445029857203
19,68,20,107,0.21839080459770116,0.8130841121495327,0.21987958670877375,0.7981191563697195
2,0,0,2,1.0,1.0,0.29680266363185065,0.8171667754173385
8,8,1,17,0.5,0.9411764705882353,0.3165961231843463,0.8168802971896838
16,85,4,105,0.15841584158415842,0.9619047619047619,0.3346186627654934,0.818031526912342
46,79,24,149,0.368,0.8389261744966443,0.34710787139858695,0.7990169844078666
26,33,4,63,0.4406779661016949,0.9365079365079365,0.3864978017547937,0.9055795832522505
10,19,2,31,0.3448275862068966,0.9354838709677419,0.4329017426414933,0.9181547609449788
1,22,1,24,0.043478260869565216,0.9583333333333334,0.4145803642318902,0.9398634224563752
35,60,22,117,0.3684210526315789,0.811965811965812,0.3243548003221158,0.9130013955943482
14,95,2,111,0.12844036697247707,0.9819819819819819,0.27127485274675533,0.9188307543648835
0,1,0,1,0.0,1.0,0.24722959107773132,0.9242729312356318
35,86,3,124,0.2892561983471074,0.9758064516129032,0.23072877587561738,0.9428684837671011
129,252,35,416,0.33858267716535434,0.9158653846153846,0.21614373459899733,0.9399195477824509
28,53,25,106,0.345679012345679,0.7641509433962265,0.21626536690453765,0.9154434152722344
0,35,5,40,0.0,0.875,0.21005418678031407,0.9035386533674724
0,12,2,14,0.0,0.8571428571428571,0.15742260783294565,0.9099925169641931
2,12,2,16,0.14285714285714285,0.875,0.15948214724504076,0.894709376681053
36,173,60,269,0.1722488038277512,0.7769516728624535,0.18408911922043378,0.8628453299471178
42,108,20,170,0.28,0.8823529411764706,0.18276680517084704,0.8494948284561987
3,19,4,26,0.13636363636363635,0.8461538461538461,0.15387837077060157,0.8395360372474076
6,20,100,126,0.23076923076923078,0.20634920634920634,0.13746268768825184,0.759850074812119
4,46,3,53,0.08,0.9433962264150944,0.14889125911682327,0.7696209642999896
10,169,28,207,0.055865921787709494,0.8647342995169082,0.15687210508649604,0.7707054560677112
22,143,3,168,0.13333333333333333,0.9821428571428571,0.15551156086880896,0.7860115785166908
28,114,8,150,0.19718309859154928,0.9466666666666667,0.159073602977923,0.8102565776315782
34,72,10,116,0.32075471698113206,0.9137931034482759,0.164895705403799,0.8147480293846934
53,166,6,225,0.2420091324200913,0.9733333333333334,0.1799879191261497,0.8329165275531916
28,73,1,102,0.27722772277227725,0.9901960784313726,0.18662484655515635,0.9448946521363581
4,51,5,60,0.07272727272727272,0.9166666666666666,0.18558588551619531,0.9410761436008686
2,24,13,39,0.07692307692307693,0.6666666666666666,0.1885940505355335,0.9127807674794054
22,136,6,164,0.13924050632911392,0.9634146341463414,0.1894379323920736,0.9101053070513317
23,91,26,140,0.20175438596491227,0.8142857142857143,0.19009097344541118,0.8911937424254814
33,82,25,140,0.28695652173913044,0.8214285714285714,0.18526265983941093,0.8779988092798092
10,98,2,110,0.09259259259259259,0.9818181818181818,0.16391743986405397,0.8792109304919306
11,51,4,66,0.1774193548387097,0.9393939393939394,0.14965910158783,0.8719534820580116
10,110,13,133,0.08333333333333333,0.9022556390977443,0.15117425310298155,0.8698947638338798
10,39,1,50,0.20408163265306123,0.98,0.16933976106440787,0.9146566685957845
25,72,2,99,0.25773195876288657,0.9797979797979798,0.18626711141208968,0.9169971465460185
9,17,4,30,0.34615384615384615,0.8666666666666667,0.2068956057247945,0.9244801397432976
10,74,12,96,0.11904761904761904,0.875,0.18290861962600719,0.9321332009677873
25,30,2,57,0.45454545454545453,0.9649122807017544,0.2346161713335589,0.9297180722368691
0,5,57,62,0.0,0.08064516129032258,0.20927054921374322,0.8070396753649238
11,186,11,208,0.05583756345177665,0.9471153846153846,0.20534258208780656,0.8134482104388725
42,179,13,234,0.19004524886877827,0.9444444444444444,0.20333738440433757,0.8083688453595074
40,105,6,151,0.27586206896551724,0.9602649006622517,0.20592740014757052,0.8055784054829749
8,50,7,65,0.13793103448275862,0.8923076923076924,0.176181284194558,0.8092414091459784
34,190,6,230,0.15178571428571427,0.9739130434782609,0.1808581549428573,0.8233718439285872
0,9,56,65,0.0,0.13846153846153847,0.1159230900077924,0.7053074521799848
6,7,2,15,0.46153846153846156,0.8666666666666667,0.18185715594185833,0.8175962386623198
29,54,5,88,0.3493975903614458,0.9431818181818182,0.22379430264323963,0.8170343006003817
2,60,3,65,0.03225806451612903,0.9538461538461539,0.20125327630714687,0.8183774019434831
43,96,3,142,0.30935251798561153,0.9788732394366197,0.20603762616716037,0.821035736054107
13,83,412,508,0.13541666666666666,0.1889763779527559,0.20567843076486153,0.720559834003402
1,49,9,59,0.02,0.847457627118644,0.18685190015261663,0.7024947745234565
20,67,20,107,0.22988505747126436,0.8130841121495327,0.21969262264851155,0.7988694279074559
1,1,0,2,0.5,1.0,0.22518712814301703,0.8179170469550748
8,8,1,17,0.5,0.9411764705882353,0.2467017580913819,0.81763056872742
16,84,5,105,0.16,0.9523809523809523,0.26495060601764914,0.8174212542323913
46,79,24,149,0.368,0.8389261744966443,0.27332881773399037,0.7974288163838235
26,33,4,63,0.4406779661016949,0.9365079365079365,0.31693757479613727,0.9042190390345635
10,19,2,31,0.3448275862068966,0.9354838709677419,0.36334151568283674,0.9167942167272918
1,22,1,24,0.043478260869565216,0.9583333333333334,0.4198691480194799,0.9381937392222722
36,59,22,117,0.37894736842105264,0.811965811965812,0.33114734350820163,0.9113317123602453
17,92,2,111,0.1559633027522936,0.9819819819819819,0.2819992439013865,0.9171610711307807
0,1,0,1,0.0,1.0,0.25660241850456106,0.9232400984864038
35,86,3,124,0.2892561983471074,0.9758064516129032,0.23739204490281612,0.9422328568800838
133,248,35,416,0.34908136482939633,0.9158653846153846,0.2267281236556839,0.9392839208954336
28,58,20,106,0.32558139534883723,0.8113207547169812,0.22032969865260774,0.9221819597466279
0,35,5,40,0.0,0.875,0.2141185185283841,0.910277197841866
0,13,1,14,0.0,0.9285714285714286,0.15998318018251942,0.9269351430712398
2,13,1,16,0.13333333333333333,0.9375,0.15675032740838227,0.9205805742166709
37,175,57,269,0.17452830188679244,0.7881040892193308,0.18168294196363832,0.8903097298194326
43,105,22,170,0.2905405405405405,0.8705882352941177,0.18186641941984308,0.875278556059606
3,23,0,26,0.11538461538461539,1.0,0.14848116949916007,0.8872977868288368
9,41,76,126,0.18,0.3968253968253968,0.12768382730646904,0.8280841642728962
4,46,3,53,0.08,0.9433962264150944,0.13911239873504047,0.8378550537607667
12,167,28,207,0.0670391061452514,0.8647342995169082,0.14868941389864782,0.8287354638958353
23,142,3,168,0.1393939393939394,0.9821428571428571,0.1495552147644487,0.8351130149162433
33,109,8,150,0.2323943661971831,0.9466666666666667,0.15782179538021876,0.8577648116944342
34,73,9,116,0.3177570093457944,0.9224137931034483,0.16170986235239787,0.865168462810053
53,166,6,225,0.2420091324200913,0.9733333333333334,0.17979907907175158,0.8613589390005291
28,73,1,102,0.27722772277227725,0.9901960784313726,0.19368875375350547,0.9461261792299541
3,56,1,60,0.05084745762711865,0.9833333333333333,0.18952410484309384,0.9518314802182741
2,24,13,39,0.07692307692307693,0.6666666666666666,0.1909361006684975,0.923536104096811
24,136,4,164,0.15,0.975609756097561,0.19245125218364903,0.9226028039474831
23,92,25,140,0.2,0.8214285714285714,0.18782348558405146,0.9047116474848979
35,79,26,140,0.30701754385964913,0.8142857142857143,0.18628927622888783,0.8892647790823645
12,96,2,110,0.1111111111111111,0.9818181818181818,0.16758955889903351,0.8904769002944858
12,53,1,66,0.18461538461538463,0.9848484848484849,0.1543592248766203,0.8897129583540732
10,111,12,133,0.08264462809917356,0.9097744360902256,0.15890167780119954,0.8792045444622006
14,35,1,50,0.2857142857142857,0.98,0.18872899334280083,0.9239664492241053
27,71,1,99,0.2755102040816326,0.98989898989899,0.20665902249731977,0.9260077683385953
8,18,4,30,0.3076923076923077,0.8666666666666667,0.22204363788193512,0.9324703533726089
10,78,8,96,0.11363636363636363,0.9166666666666666,0.19441775499289432,0.9470962037127449
25,31,1,57,0.44642857142857145,0.9824561403508771,0.24232024932396015,0.9471873406459871
0,3,58,61,0.0,0.04918032786885246,0.21594662295033376,0.8135204610774682
13,185,10,208,0.06565656565656566,0.9519230769230769,0.21351975688710406,0.8195416954821612
44,177,13,234,0.19909502262443438,0.9444444444444444,0.20114557644569672,0.8144623304027963
42,105,4,151,0.2857142857142857,0.9735099337748344,0.20260330239321858,0.812121036670774
9,54,2,65,0.14285714285714285,0.9692307692307692,0.17905542170248073,0.8267730513227887
35,189,6,230,0.15625,0.9739130434782609,0.1851430840401431,0.8349511051530163
9,55,1,65,0.140625,0.9846153846153847,0.14145685955034715,0.8352595686193746
6,7,2,15,0.46153846153846156,0.8666666666666667,0.2073909254844131,0.9520433313047766
29,54,5,88,0.3493975903614458,0.9431818181818182,0.24792535758511028,0.9507945800560255
2,60,3,65,0.03225806451612903,0.9538461538461539,0.22409150642678094,0.9521376813991268
42,97,3,142,0.302158273381295,0.9788732394366197,0.22644064752206797,0.9529038679222389
19,92,397,508,0.17117117117117117,0.21850393700787402,0.23048550870978632,0.8456571776046824
1,49,9,59,0.02,0.847457627118644,0.2110212229955006,0.8275921181247373
19,68,20,107,0.21839080459770116,0.8130841121495327,0.22213062365231506,0.8030876506296155
2,0,0,2,1.0,1.0,0.299053700575392,0.8221352696772345
8,8,1,17,0.5,0.9411764705882353,0.3205683305237569,0.8218487914495798
17,84,4,105,0.16831683168316833,0.9619047619047619,0.3400052972619053,0.823000021172238
51,75,23,149,0.40476190476190477,0.8456375838926175,0.35466295888770677,0.8039663560945236
26,33,4,63,0.4406779661016949,0.9365079365079365,0.39316392959206725,0.9065383560231038
10,19,2,31,0.3448275862068966,0.9354838709677419,0.4395678704787668,0.919113533715832
1,20,1,22,0.047619047619047616,0.9545454545454546,0.4175510505520478,0.9378118263023654
34,55,24,113,0.38202247191011235,0.7876106194690266,0.3292685465392067,0.9074704862265122
16,78,2,96,0.1702127659574468,0.9791666666666666,0.2821560845331276,0.9128976570948595
0,1,0,1,0.0,1.0,0.25675925913630226,0.9189766844504825
35,72,3,110,0.32710280373831774,0.9727272727272728,0.2458651818792312,0.9373703475249967
133,210,36,379,0.3877551020408163,0.9050131926121372,0.24072608023373038,0.9328710983970253
30,43,25,98,0.410958904109589,0.7448979591836735,0.2465244421964759,0.9062801664577471
0,28,5,33,0.0,0.8484848484848485,0.23972172110804052,0.8911286513062321
0,12,2,14,0.0,0.8571428571428571,0.1851470822637388,0.9010618281167792
1,8,2,11,0.1111111111111111,0.8181818181818182,0.17670398871426227,0.8780639926189437
35,146,60,241,0.19337016574585636,0.7510373443983402,0.20432829810652745,0.8424978989615638
40,94,22,156,0.29850746268656714,0.8589743589743589,0.20024324938484878,0.8262474827111477
3,18,4,25,0.14285714285714285,0.84,0.165257826644324,0.8169598837665566
8,20,94,122,0.2857142857142857,0.22950819672131148,0.1473657383021378,0.7433327748433619
3,43,3,49,0.06521739130434782,0.9387755102040817,0.15668250848847323,0.7562314408032523
12,149,27,188,0.07453416149068323,0.8563829787234043,0.1673302458442851,0.7561228867433306
19,112,3,134,0.1450381679389313,0.9776119402985075,0.17217696824825943,0.7788986184742862
30,107,8,145,0.21897810218978103,0.9448275862068966,0.17583524488310578,0.8065829387326514
32,67,7,106,0.32323232323232326,0.9339622641509434,0.1793673678182138,0.8172954966150205
53,166,6,225,0.2420091324200913,0.9733333333333334,0.1935319377557779,0.8363431156626396
21,61,1,83,0.25609756097560976,0.9879518072289156,0.18930097707882418,0.9446922028780117
3,45,5,53,0.0625,0.9056603773584906,0.18891277832106024,0.9399614696143558
2,22,12,36,0.08333333333333333,0.6666666666666666,0.19016980287001023,0.9128591393205362
24,130,5,159,0.15584415584415584,0.9685534591194969,0.19171351542789944,0.9115650705806775
21,84,26,131,0.2,0.8015267175572519,0.18900235797221646,0.8910935179164425
33,67,25,125,0.33,0.8,0.1899691689390274,0.8719560516091649
11,90,2,103,0.10891089108910891,0.9805825242718447,0.1709551344631728,0.8729916503146665
11,49,4,64,0.18333333333333332,0.9375,0.16056024479999045,0.8657842492819643
9,99,12,120,0.08333333333333333,0.9,0.16353643527618092,0.8649756239450371
13,33,1,47,0.2826086956521739,0.9787234042553191,0.1920043441788724,0.9095551578862731
26,68,2,96,0.2765957446808511,0.9791666666666666,0.20925457115554316,0.9110713303930116
8,18,4,30,0.3076923076923077,0.8666666666666667,0.22463918654015855,0.9203770374086423
8,60,12,80,0.11764705882352941,0.85,0.19430305208637705,0.9275198945514995
26,26,1,53,0.5,0.9811320754716981,0.2501729247879329,0.9275984018657643
0,2,58,60,0.0,0.03333333333333333,0.22398244859745672,0.7984317351990976
12,157,10,179,0.07100591715976332,0.9441340782122905,0.22222138914408957,0.8047366035151391
43,143,14,200,0.23118279569892472,0.93,0.2148748320079111,0.7977761171929506
43,93,3,139,0.3161764705882353,0.9784172661870504,0.2205292214232517,0.7976690599815769
5,51,7,63,0.08928571428571429,0.8888888888888888,0.18932827950802406,0.80084366315618
37,172,6,215,0.17703349282296652,0.9720930232558139,0.19781205579365796,0.8182855236212963
0,10,55,65,0.0,0.15384615384615385,0.12638348436508653,0.7001018205319329
6,6,2,14,0.5,0.8571428571428571,0.19781205579365796,0.8177888953618648
28,43,5,76,0.39436619718309857,0.9342105263157895,0.24400638151127726,0.8163712450909361
1,60,3,64,0.01639344262295082,0.953125,0.21332218821470958,0.8196748165195075
42,76,3,121,0.3559322033898305,0.9752066115702479,0.2190015786149375,0.81921615157425
19,92,397,508,0.17117117117117117,0.21850393700787402,0.23069950102714556,0.7234468727341051
1,43,9,53,0.022727272727272728,0.8301886792452831,0.2086557552991893,0.7031748235897436
19,62,20,101,0.2345679012345679,0.801980198019802,0.24216545547555618,0.7957654013288361
2,0,0,2,1.0,1.0,0.3135940269041276,0.8161735645941423
8,8,1,17,0.5,0.9411764705882353,0.328684570163685,0.817168699490206
16,74,4,94,0.17777777777777778,0.9574468085106383,0.35173947518580306,0.8177861007060114
50,68,22,140,0.423728813559322,0.8428571428571429,0.36142470521001613,0.7988790337469964
25,34,4,63,0.423728813559322,0.9365079365079365,0.3975043684083234,0.9014510336755768
10,17,2,29,0.37037037037037035,0.9310344827586207,0.4471676680716231,0.9158575770346251
1,20,1,22,0.047619047619047616,0.9545454545454546,0.4045015529403943,0.9348434583999776
34,54,25,113,0.38636363636363635,0.7787610619469026,0.3168392152780566,0.9032378958209638
14,80,2,96,0.14893617021276595,0.9791666666666666,0.266687239594166,0.908665066689311
0,1,0,1,0.0,1.0,0.24071321362014003,0.9168283319954336
35,70,3,108,0.3333333333333333,0.9722222222222222,0.2357608326677591,0.9366696018367033
129,212,38,379,0.3782991202346041,0.899736147757256,0.22927087647851369,0.9314164891580347
27,46,25,98,0.3698630136986301,0.7448979591836735,0.23777347449457412,0.9041899303317393
0,28,5,33,0.0,0.8484848484848485,0.23097075340613876,0.889038415180224
0,12,2,14,0.0,0.8571428571428571,0.17577594821133355,0.900235814493932
1,8,2,11,0.1111111111111111,0.8181818181818182,0.1703723683396686,0.8772379789960965
36,148,60,244,0.1956521739130435,0.7540983606557377,0.1983226788986748,0.8421091733754874
43,91,22,156,0.3208955223880597,0.8589743589743589,0.19654584876363573,0.8259309071972213
3,18,4,25,0.14285714285714285,0.84,0.16291128056685555,0.8173971718033276
9,22,91,122,0.2903225806451613,0.2540983606557377,0.15154836155921717,0.7472829434421939
3,43,3,49,0.06521739130434782,0.9387755102040817,0.16086513174555256,0.7601816094020845
12,151,27,190,0.0736196319018405,0.8578947368421053,0.17138222201724407,0.7602890207876911
19,111,3,133,0.14615384615384616,0.9774436090225563,0.17638832702334906,0.783040705193511
29,107,8,144,0.21323529411764705,0.9444444444444444,0.1789002013382924,0.8102330028776119
34,65,7,106,0.3434343434343434,0.9339622641509434,0.18212003291633297,0.8209455607599813
52,166,7,225,0.23853211009174313,0.9688888888888889,0.19578788537841874,0.8393582591726795
21,61,1,83,0.25609756097560976,0.9879518072289156,0.19089859685419702,0.9441944658259906
4,48,1,53,0.07692307692307693,0.9811320754716981,0.19257083765687266,0.9502454037213646
3,21,12,36,0.125,0.6666666666666666,0.19991089024232403,0.922927107982016
23,131,5,159,0.14935064935064934,0.9685534591194969,0.20036757641329592,0.9216570865672933
21,84,26,131,0.2,0.8015267175572519,0.1984768201107749,0.9012402684405515
31,69,25,125,0.31,0.8,0.19370048533444012,0.8821028021332739
11,90,2,103,0.10891089108910891,0.9805825242718447,0.17518316833406375,0.8837733214736961
11,50,3,64,0.18032786885245902,0.953125,0.16435892660218512,0.8787980632981368
9,99,12,120,0.08333333333333333,0.9,0.16527467751793604,0.8672077668021798
12,34,1,47,0.2608695652173913,0.9787234042553191,0.1846846154061348,0.9117873007434161
25,70,1,96,0.2631578947368421,0.9895833333333334,0.20094279331844803,0.9147915684882497
8,17,4,29,0.32,0.8620689655172413,0.21808565046130515,0.9234404610539625
8,60,12,80,0.11764705882352941,0.85,0.19060665886466652,0.9305833181968197
26,26,1,53,0.5,0.9811320754716981,0.24647653156622237,0.9306618255110845
0,2,58,60,0.0,0.03333333333333333,0.22071540744444254,0.799263015987275
13,156,10,179,0.07692307692307693,0.9441340782122905,0.21979965652869163,0.8055678843033165
43,143,14,200,0.23118279569892472,0.93,0.21555868945462495,0.7986073979811279
42,94,3,139,0.3088235294117647,0.9784172661870504,0.22208235155104247,0.797012245531659
4,52,7,63,0.07142857142857142,0.8888888888888888,0.1865721474694098,0.80084366315618
36,172,6,214,0.17307692307692307,0.9719626168224299,0.1944906995056089,0.8182668941308128
0,9,56,65,0.0,0.13846153846153847,0.1230621280770375,0.6978853888436473
6,6,2,14,0.5,0.8571428571428571,0.1944906995056089,0.8155724636735792
28,43,5,76,0.39436619718309857,0.9342105263157895,0.23983971668561202,0.8141548134026504
1,60,3,64,0.01639344262295082,0.953125,0.2091555233890443,0.8174583848312219
42,76,3,121,0.3559322033898305,0.9752066115702479,0.21588533395733941,0.8169997198859643
23,86,398,507,0.21100917431192662,0.21499013806706113,0.23582542008353302,0.7207284697685604
1,43,9,53,0.022727272727272728,0.8301886792452831,0.21434689860501152,0.7004750501146823
20,61,20,101,0.24691358024691357,0.801980198019802,0.24962026721171346,0.7952634300515771
2,0,0,2,1.0,1.0,0.32104883864028494,0.8156715933168833
8,8,1,17,0.5,0.9411764705882353,0.3361393818998422,0.8166667282129468
16,74,4,94,0.17777777777777778,0.9574468085106383,0.35919428692196037,0.8172841294287524
48,71,22,141,0.40336134453781514,0.8439716312056738,0.3659698785145296,0.798536275090956
25,34,4,63,0.423728813559322,0.9365079365079365,0.3963583984070147,0.9016102462967954
10,17,2,29,0.37037037037037035,0.9310344827586207,0.44602169807031433,0.9160167896558438
1,22,1,24,0.043478260869565216,0.9583333333333334,0.4016909206101106,0.9390580533288582
35,56,26,117,0.38461538461538464,0.7777777777777778,0.31377883269802265,0.9073120215828265
12,97,2,111,0.11009174311926606,0.9819819819819819,0.2580776531436321,0.9131413803533618
0,1,0,1,0.0,1.0,0.23261796431760667,0.9185835572241101
33,88,3,124,0.2727272727272727,0.9758064516129032,0.2182910214192352,0.9379844788830962
130,246,38,414,0.34574468085106386,0.9082125603864735,0.20957173853839442,0.9339422822943159
27,54,25,106,0.3333333333333333,0.7641509433962265,0.2128558107879839,0.9094661497840992
0,35,5,40,0.0,0.875,0.20664463066376035,0.8975613878793374
0,12,2,14,0.0,0.8571428571428571,0.1516995757187054,0.9088992563600631
2,12,2,16,0.14285714285714285,0.875,0.15638034710983062,0.8936161160769228
38,174,56,268,0.1792452830188679,0.7910447761194029,0.18198681611252604,0.863765369808266
39,112,21,172,0.2582781456953642,0.877906976744186,0.1799226551079677,0.8497797305413065
4,18,4,26,0.18181818181818182,0.8461538461538461,0.156504583817556,0.8409141999366454
7,20,99,126,0.25925925925925924,0.21428571428571427,0.1459225732355454,0.7623620243494295
4,46,3,53,0.08,0.9433962264150944,0.15735114466411684,0.7721329138373001
13,167,28,208,0.07222222222222222,0.8653846153846154,0.16766860498157715,0.7733103078718369
22,143,3,168,0.13333333333333333,0.9821428571428571,0.16630806076389007,0.7886164303208165
29,113,8,150,0.20422535211267606,0.9466666666666667,0.1698766420630055,0.8108481289704256
35,72,10,117,0.32710280373831774,0.9145299145299145,0.1797087360691417,0.8160799772255297
52,166,7,225,0.23853211009174313,0.9688888888888889,0.18781072582250763,0.8336135547591071
28,72,1,101,0.28,0.9900990099009901,0.1907736887854706,0.9444440255612895
5,50,5,60,0.09090909090909091,0.9166666666666666,0.19233213034391214,0.9406255170257998
1,25,13,39,0.038461538461538464,0.6666666666666666,0.18750917552095733,0.9122372386375214
23,136,5,164,0.14465408805031446,0.9695121951219512,0.18912642619481176,0.9104328583488206
21,93,26,140,0.18421052631578946,0.8142857142857143,0.18626716536668514,0.8915212937229702
31,84,26,141,0.26956521739130435,0.8156028368794326,0.17804751017425463,0.8773888540586156
9,99,2,110,0.08333333333333333,0.9818181818181818,0.1558762563516247,0.8792358959056575
11,51,4,66,0.1774193548387097,0.9393939393939394,0.14122187847144033,0.8719923144046503
9,112,12,133,0.0743801652892562,0.9097744360902256,0.1388606033828925,0.8710077100365872
11,38,1,50,0.22448979591836735,0.98,0.16543606873386807,0.9157696147984921
23,75,1,99,0.23469387755102042,0.98989898989899,0.17829889580539748,0.9186820140523546
9,17,4,30,0.34615384615384615,0.8666666666666667,0.20143365578226272,0.9261650072496337
10,73,13,96,0.12048192771084337,0.8645833333333334,0.18013604297076832,0.9331622210287623
25,30,2,57,0.45454545454545453,0.9649122807017544,0.23316634600107133,0.930747092297844
0,4,58,62,0.0,0.06451612903225806,0.20782072388125566,0.8057645479604609
11,187,10,208,0.05555555555555555,0.9519230769230769,0.20513149391929844,0.8117857823651542
42,179,14,235,0.19004524886877827,0.9404255319148936,0.20021084434078573,0.8061322869244245
36,101,15,152,0.26277372262773724,0.9013157894736842,0.2042222507803167,0.7934775440065237
5,52,7,64,0.08771929824561403,0.890625,0.16730302965056923,0.7969001630541427
36,188,6,230,0.16071428571428573,0.9739130434782609,0.17305050936534672,0.8125186930748468
0,7,58,65,0.0,0.1076923076923077,0.10811544443028179,0.69005869693064
6,7,2,15,0.46153846153846156,0.8666666666666667,0.17404951036434774,0.8046516308784127
29,54,5,88,0.3493975903614458,0.9431818181818182,0.21602694390804636,0.8034028796296615
2,60,3,65,0.03225806451612903,0.9538461538461539,0.1934859175719536,0.8053201113341272
43,97,3,143,0.30714285714285716,0.9790209790209791,0.19982436535982787,0.8164208526980264
14,110,472,596,0.11290322580645161,0.2080536912751678,0.20342206929709036,0.7189106657373363
1,49,9,59,0.02,0.847457627118644,0.18332002848076384,0.7008456062573909
20,67,20,107,0.22988505747126436,0.8130841121495327,0.21616075097665874,0.8016158640369946
2,0,0,2,1.0,1.0,0.29308382789973564,0.8206634830846136
8,8,1,17,0.5,0.9411764705882353,0.31459845784810053,0.8203770048569589
18,81,6,105,0.18181818181818182,0.9428571428571428,0.3359641888912509,0.8188071461442429
46,79,25,150,0.368,0.8333333333333334,0.3446580664422714,0.7979946253317223
25,34,4,63,0.423728813559322,0.9365079365079365,0.3890617218355385,0.9020595175078319
9,20,2,31,0.3103448275862069,0.9354838709677419,0.4305395543478538,0.9146346952005603
1,22,1,24,0.043478260869565216,0.9583333333333334,0.41640006086470255,0.9409628152336202
35,57,25,117,0.3804347826086957,0.7863247863247863,0.3278907440945162,0.9104377847085897
12,97,2,111,0.11009174311926606,0.9819819819819819,0.2721895645401256,0.9162671434791249
0,1,0,1,0.0,1.0,0.24531544855709875,0.9217093203498733
34,87,3,124,0.2809917355371901,0.9758064516129032,0.22630533934812588,0.9392054801040974
130,245,39,414,0.3466666666666667,0.9057971014492754,0.22013907623271023,0.9348182179528602
27,54,25,106,0.3333333333333333,0.7641509433962265,0.21357093173353126,0.9103420854426437
0,35,5,40,0.0,0.875,0.2073597516093076,0.8984373235378816
0,12,2,14,0.0,0.8571428571428571,0.15301192552235113,0.9085541907976061
2,12,2,16,0.14285714285714285,0.875,0.15769269691347637,0.893271050514466
37,171,60,268,0.1778846153846154,0.7761194029850746,0.18310478482556428,0.8612881080837622
41,110,21,172,0.271523178807947,0.877906976744186,0.18175213386424385,0.8473024688168026
4,18,4,26,0.18181818181818182,0.8461538461538461,0.1582023503144603,0.8387820037745984
9,20,97,126,0.3103448275862069,0.23015873015873015,0.15491827806487082,0.7624974018835277
4,46,3,53,0.08,0.9433962264150944,0.16634684949344222,0.7722682913713983
11,169,28,208,0.06111111111111111,0.8653846153846154,0.17507700822360098,0.7734456854059351
21,144,3,168,0.12727272727272726,0.9821428571428571,0.17285066314011302,0.7887518078549147
27,115,8,150,0.19014084507042253,0.9466666666666667,0.17460155309522835,0.8131157026665707
35,74,8,117,0.3211009174311927,0.9316239316239316,0.1816840871842634,0.8207895533636772
52,166,7,225,0.23853211009174313,0.9688888888888889,0.18978607693762933,0.8383231308972547
29,71,1,101,0.29,0.9900990099009901,0.18687967299674263,0.9468860280032919
5,50,5,60,0.09090909090909091,0.9166666666666666,0.18843811455518417,0.9430675194678022
1,25,13,39,0.038461538461538464,0.6666666666666666,0.18520246131953094,0.9146792410795238
22,137,5,164,0.13836477987421383,0.9695121951219512,0.18678704026260046,0.9128748607908229
21,93,26,140,0.18421052631578946,0.8142857142857143,0.18593985186908144,0.8939632961649727
32,84,25,141,0.27586206896551724,0.8226950354609929,0.17947715923112778,0.8784020252845528
10,98,2,110,0.09259259259259259,0.9818181818181818,0.15862865673124918,0.8802490671315946
11,51,4,66,0.1774193548387097,0.9393939393939394,0.14254570742249342,0.8730054856305873
9,112,12,133,0.0743801652892562,0.9097744360902256,0.1401844323339456,0.8720208812625244
11,38,1,50,0.22448979591836735,0.98,0.16675989768492114,0.9167827860244291
24,74,1,99,0.24489795918367346,0.98989898989899,0.18197892330055823,0.919695185278292
9,17,4,30,0.34615384615384615,0.8666666666666667,0.20511368327742346,0.9271781784755707
10,73,13,96,0.12048192771084337,0.8645833333333334,0.1829165202410415,0.9331622210287623
25,30,2,57,0.45454545454545453,0.9649122807017544,0.23462407194859322,0.9307470922978441
0,4,58,62,0.0,0.06451612903225806,0.2092784498287775,0.805764547960461
13,185,10,208,0.06565656565656566,0.9519230769230769,0.20803222130982174,0.8117857823651541
43,179,13,235,0.19369369369369369,0.9446808510638298,0.20363277813486835,0.806740189659987
37,102,13,152,0.26618705035971224,0.9144736842105263,0.20667407687430245,0.7959651459902064
5,52,7,64,0.08771929824561403,0.890625,0.169754855744555,0.7993877650378255
35,188,6,229,0.15695067264573992,0.9737991266375546,0.17496467644954025,0.8149900212241427
0,7,58,65,0.0,0.1076923076923077,0.11002961151447531,0.6925300250799361
6,7,2,15,0.46153846153846156,0.8666666666666667,0.17596367744854127,0.8071229590277087
29,54,5,88,0.3493975903614458,0.9431818181818182,0.2164981095492384,0.8058742077789576
2,60,3,65,0.03225806451612903,0.9538461538461539,0.1934358768095863,0.8071835367478609
42,98,3,143,0.3,0.9790209790209791,0.19826629818677027,0.8164045788636399
14,112,470,596,0.1111111111111111,0.21140939597315436,0.20160798573898414,0.7193737782883762
1,49,9,59,0.02,0.847457627118644,0.18204360393244987,0.7013249926428176
20,67,20,107,0.22988505747126436,0.8130841121495327,0.2148843264283448,0.8020952504224211
2,0,0,2,1.0,1.0,0.2918074033514217,0.8211428694700401
8,8,1,17,0.5,0.9411764705882353,0.31332203329978664,0.8208563912423854
18,83,4,105,0.1782178217821782,0.9619047619047619,0.3341734271949365,0.8220076209650438
47,79,24,150,0.373015873015873,0.84,0.3446042661972041,0.8021474811049039
24,35,4,63,0.4067796610169492,0.9365079365079365,0.38684263046946665,0.905732986895587
9,20,2,31,0.3103448275862069,0.9354838709677419,0.42832046298178195,0.9183081645883153
0,23,1,24,0.0,0.9583333333333334,0.39959627736249403,0.9410141565248537
35,58,24,117,0.3763440860215054,0.7948717948717948,0.31050257536556625,0.9117101272208243
17,92,2,111,0.1559633027522936,0.9819819819819819,0.26135447575875104,0.9175394859913596
0,1,0,1,0.0,1.0,0.2361443917251376,0.9229303215708745
32,89,3,124,0.2644628099173554,0.9758064516129032,0.22370157885618838,0.9404264813250987
128,246,39,413,0.3422459893048128,0.9055690072639225,0.21690379040336502,0.9360066342902396
25,56,25,106,0.30864197530864196,0.7641509433962265,0.20680830904351583,0.911530501780023
0,35,5,40,0.0,0.875,0.20680830904351583,0.8996257398752612
0,12,2,14,0.0,0.8571428571428571,0.15304486818330076,0.9085216059139843
2,12,2,16,0.14285714285714285,0.875,0.1511725596268507,0.8932384656308441
39,173,56,268,0.18396226415094338,0.7910447761194029,0.17745288307698545,0.8633877193621873
41,110,21,172,0.271523178807947,0.877906976744186,0.17846150720421283,0.8494020800952278
3,19,4,26,0.13636363636363635,0.8461538461538461,0.14904974249833045,0.8409141999366454
10,21,95,126,0.3225806451612903,0.24603174603174602,0.1510409810487088,0.7668971717417196
4,46,3,53,0.08,0.9433962264150944,0.16246955247728026,0.7766680612295902
10,170,28,208,0.05555555555555555,0.8653846153846154,0.1704060604137882,0.7778454552641272
24,141,3,168,0.14545454545454545,0.9821428571428571,0.17077711792770284,0.7931515777131067
31,111,8,150,0.21830985915492956,0.9466666666666667,0.17568391721398657,0.8153832763627158
38,70,9,117,0.35185185185185186,0.9230769230769231,0.1871594419345444,0.8218361258388212
52,166,7,225,0.23853211009174313,0.9688888888888889,0.2017549381814168,0.8393697033723988
29,71,1,101,0.29,0.9900990099009901,0.1971005603012325,0.9456650267822908
4,51,5,60,0.07272727272727272,0.9166666666666666,0.19606159926227143,0.941846518246801
3,23,13,39,0.11538461538461539,0.6666666666666666,0.20460860780927997,0.9134582398585226
22,138,4,164,0.1375,0.975609756097561,0.20347224417291634,0.9125249397091946
22,91,27,140,0.19469026548672566,0.8071428571428572,0.20009801650603007,0.892592966920079
34,82,25,141,0.29310344827586204,0.8226950354609929,0.19170538742374582,0.8782526972606604
10,98,2,110,0.09259259259259259,0.9818181818181818,0.17085688492386716,0.8800997391077022
13,49,4,66,0.20967741935483872,0.9393939393939394,0.15938223054598696,0.872856157606695
8,113,12,133,0.06611570247933884,0.9097744360902256,0.15843772051056787,0.871871553238632
13,36,1,50,0.2653061224489796,0.98,0.17985507866261988,0.9166334580005367
25,73,1,99,0.25510204081632654,0.98989898989899,0.1966553702078094,0.9186747771150265
9,17,4,30,0.34615384615384615,0.8666666666666667,0.2182930245888266,0.9271781784755708
10,74,12,96,0.11904761904761904,0.875,0.193427906127649,0.9346503162668576
26,30,1,57,0.4642857142857143,0.9824561403508771,0.24652692351238073,0.9347414532000996
0,4,58,62,0.0,0.06451612903225806,0.2165730064616895,0.8097589088627165
13,185,10,208,0.06565656565656566,0.9519230769230769,0.21650741548700755,0.8157801432674098
42,179,14,235,0.19004524886877827,0.9404255319148936,0.2057558621184074,0.8101266478266801
44,104,4,152,0.2972972972972973,0.9736842105263158,0.21178375590140325,0.807810250773441
7,50,7,64,0.12280701754385964,0.890625,0.17987706609997658,0.81123286982106
38,185,6,229,0.17040358744394618,0.9737991266375546,0.18721363301373758,0.8253470307692822
0,10,55,65,0.0,0.15384615384615385,0.1208871024014927,0.7069741755543217
6,7,2,15,0.46153846153846156,0.8666666666666667,0.18682116833555865,0.8215671095020944
29,54,5,88,0.3493975903614458,0.9431818181818182,0.22735560043625577,0.8203183582533432
2,60,3,65,0.03225806451612903,0.9538461538461539,0.20481457410016304,0.822235589957809
42,98,3,143,0.3,0.9790209790209791,0.2052006744862634,0.8229979854570465
15,110,471,596,0.12,0.20973154362416108,0.20479967197999777,0.7257274916890696
1,49,9,59,0.02,0.847457627118644,0.18331344520229115,0.7076787060435107
19,68,20,107,0.21839080459770116,0.8130841121495327,0.21451213157339133,0.8018555572297078
2,0,0,2,1.0,1.0,0.29143520849646826,0.8209031762773268
8,8,1,17,0.5,0.9411764705882353,0.31294983844483315,0.8206166980496722
19,82,4,105,0.18811881188118812,0.9619047619047619,0.33521565949698445,0.8217679277723305
53,75,22,150,0.4140625,0.8533333333333334,0.3515103023541273,0.8038125498169525
23,36,4,63,0.3898305084745763,0.9365079365079365,0.39005751785049536,0.907637748800349
11,18,2,31,0.3793103448275862,0.9354838709677419,0.4413875671115791,0.9202129264930772
0,23,1,24,0.0,0.9583333333333334,0.40568350931586533,0.9400617755724728
35,59,23,117,0.3723404255319149,0.8034188034188035,0.3160178558204246,0.9119787474894447
16,93,2,111,0.14678899082568808,0.9819819819819819,0.26555914022409427,0.91780810625998
0,1,0,1,0.0,1.0,0.24174961641457046,0.9231989418394947
33,88,3,124,0.2727272727272727,0.9758064516129032,0.2278422639245408,0.9416474825460999
124,246,42,412,0.33513513513513515,0.8980582524271845,0.21518602414965696,0.936154670534564
27,54,25,106,0.3333333333333333,0.7641509433962265,0.208617879650478,0.9116785380243474
0,35,5,40,0.0,0.875,0.208617879650478,0.8997737761195854
0,12,2,14,0.0,0.8571428571428571,0.15542639028877586,0.9074486409373075
2,12,2,16,0.14285714285714285,0.875,0.15486469772184083,0.8921655006541672
41,166,60,267,0.19806763285024154,0.7752808988764045,0.1831600738433039,0.8600627719222249
43,108,21,172,0.2847682119205298,0.877906976744186,0.1848802080137692,0.8460771326552654
3,19,4,26,0.13636363636363635,0.8461538461538461,0.1564842796178408,0.8386622174733598
9,24,93,126,0.2727272727272727,0.2619047619047619,0.14782627095983214,0.7669127629745793
4,46,3,53,0.08,0.9433962264150944,0.15925484238840357,0.7766836524624499
11,169,28,208,0.06111111111111111,0.8653846153846154,0.16798500111856232,0.7778610464969867
25,140,3,168,0.15151515151515152,0.9821428571428571,0.16922185949827787,0.7931671689459663
32,110,8,150,0.22535211267605634,0.9466666666666667,0.1731196423305371,0.8176508500588611
38,73,6,117,0.34234234234234234,0.9487179487179487,0.18134451810508173,0.8277667031979699
52,166,7,225,0.23853211009174313,0.9688888888888889,0.19594001435195413,0.8453002807315474
29,71,1,101,0.29,0.9900990099009901,0.1984075468194866,0.9493280304452943
3,56,1,60,0.05084745762711865,0.9833333333333333,0.19424289790907495,0.9550333314336142
4,22,13,39,0.15384615384615385,0.6666666666666666,0.20749076115693824,0.9266450530453357
20,140,4,164,0.125,0.975609756097561,0.20370288236905942,0.9257117528960077
18,95,27,140,0.1592920353982301,0.8071428571428572,0.19426572847222712,0.9057797801068921
35,81,25,141,0.3017241379310345,0.8226950354609929,0.18846312784204028,0.88777650678447
10,98,2,110,0.09259259259259259,0.9818181818181818,0.16761462534216162,0.8896235486315117
13,49,4,66,0.20967741935483872,0.9393939393939394,0.15613997096428145,0.8823799671305045
8,113,12,133,0.06611570247933884,0.9097744360902256,0.15832114880031292,0.871871553238632
14,35,1,50,0.2857142857142857,0.98,0.17715945335290315,0.9166334580005367
26,72,1,99,0.2653061224489796,0.98989898989899,0.1972031851313288,0.9186747771150267
9,17,4,30,0.34615384615384615,0.8666666666666667,0.22389772952498824,0.9271781784755708
9,74,13,96,0.10843373493975904,0.8645833333333334,0.1962848148119489,0.9331622210287621
26,30,1,57,0.4642857142857143,0.9824561403508771,0.2493838321966806,0.9332533579620045
0,4,58,62,0.0,0.06451612903225806,0.21942991514598933,0.8082708136246214
13,185,10,208,0.06565656565656566,0.9519230769230769,0.21936432417130747,0.8142920480293144
42,179,14,235,0.19004524886877827,0.9404255319148936,0.20569731890766357,0.808638552588585
44,104,4,152,0.2972972972972973,0.9736842105263158,0.21026748674313753,0.8063221555353458
6,51,7,64,0.10526315789473684,0.890625,0.17585453127755044,0.8097447745829649
40,183,6,229,0.17937219730941703,0.9737991266375546,0.18598859733035877,0.8253470307692821
0,10,55,65,0.0,0.15384615384615385,0.11966206671811384,0.7069741755543217
6,7,2,15,0.46153846153846156,0.8666666666666667,0.18559613265217978,0.8215671095020944
29,54,5,88,0.3493975903614458,0.9431818181818182,0.2261305647528769,0.8203183582533431
2,60,3,65,0.03225806451612903,0.9538461538461539,0.2035895384167842,0.8222355899578089
42,98,3,143,0.3,0.9790209790209791,0.20397563880288455,0.8229979854570465
14,112,470,596,0.1111111111111111,0.21140939597315436,0.20481106069093805,0.7259671848817828
1,49,9,59,0.02,0.847457627118644,0.18204360393244987,0.7079183992362241
18,69,20,107,0.20689655172413793,0.8130841121495327,0.2116002541787553,0.8020952504224211
2,0,0,2,1.0,1.0,0.2885233311018322,0.8211428694700401
8,8,1,17,0.5,0.9411764705882353,0.3100379610501971,0.8208563912423855
18,84,4,106,0.17647058823529413,0.9622641509433962,0.330639750152935,0.8220589622562773
45,83,22,150,0.3515625,0.8533333333333334,0.3380058215815064,0.8041035843008993
23,36,4,63,0.3898305084745763,0.9365079365079365,0.37782287834771566,0.9076890900915825
11,18,2,31,0.3793103448275862,0.9354838709677419,0.4291529276087994,0.9202642677843108
0,23,1,24,0.0,0.9583333333333334,0.4136942333068244,0.9382577289839105
36,60,21,117,0.375,0.8205128205128205,0.32440851902111006,0.9126167033428848
15,94,2,111,0.13761467889908258,0.9819819819819819,0.2726391874352648,0.91844606211342
0,1,0,1,0.0,1.0,0.24281187189366346,0.924461099707405
34,87,3,124,0.2809917355371901,0.9758064516129032,0.22968478326580444,0.9434538581010851
126,250,36,412,0.3351063829787234,0.912621359223301,0.2194457435460579,0.9400414899175656
14,72,20,106,0.16279069767441862,0.8113207547169812,0.18450049929848805,0.9229395287687601
0,35,5,40,0.0,0.875,0.18450049929848805,0.9110347668639981
0,13,1,14,0.0,0.9285714285714286,0.13092907072705948,0.9264717108723708
3,12,1,16,0.2,0.9375,0.139841259455762,0.9201171420178019
39,167,60,266,0.18932038834951456,0.7744360902255639,0.16688702921997836,0.8878937263357395
44,106,22,172,0.29333333333333333,0.872093023255814,0.1686501146194274,0.8730775222847268
3,23,0,26,0.11538461538461539,1.0,0.13726129067741194,0.8855601852528265
10,47,69,126,0.17543859649122806,0.4523809523809524,0.1390681333655276,0.834283070633394
4,45,3,52,0.08163265306122448,0.9423076923076923,0.15072994094570252,0.8438984552487786
11,167,28,206,0.06179775280898876,0.8640776699029126,0.15955819134698662,0.8346850611532763
25,140,3,168,0.15151515151515152,0.9821428571428571,0.1526317844205797,0.8410626121736844
33,109,8,150,0.2323943661971831,0.9466666666666667,0.15878520982738947,0.8656669802366992
37,74,6,117,0.3333333333333333,0.9487179487179487,0.1644994955416752,0.8766133981598613
52,166,7,225,0.23853211009174313,0.9688888888888889,0.1820919947855506,0.8721689537154168
29,71,1,101,0.29,0.9900990099009901,0.19845790957251802,0.9489858190754222
4,55,1,60,0.06779661016949153,0.9833333333333333,0.19648133201655615,0.9548466249362281
1,26,12,39,0.037037037037037035,0.6923076923076923,0.19294408690627732,0.9303080567083395
13,147,4,164,0.08125,0.975609756097561,0.18290620811839856,0.9293747565590115
17,96,27,140,0.1504424778761062,0.8071428571428572,0.17119879550110184,0.9094427837698957
39,77,25,141,0.33620689655172414,0.8226950354609929,0.17160930453230056,0.8914395104474736
10,98,2,110,0.09259259259259259,0.9818181818181818,0.1507608020324219,0.8932865522945154
14,51,1,66,0.2153846153846154,0.9848484848484849,0.14010146137308124,0.8925364772870147
9,112,12,133,0.0743801652892562,0.9097744360902256,0.14104196924733334,0.8820280633951422
13,36,1,50,0.2653061224489796,0.98,0.17365183859189656,0.9231269644940433
26,72,1,99,0.2653061224489796,0.98989898989899,0.1999455703703222,0.9251682836085331
10,16,4,30,0.38461538461538464,0.8666666666666667,0.2333988427616477,0.9336716849690773
11,78,7,96,0.12359550561797752,0.9270833333333334,0.20302578691396964,0.9485842989508402
27,29,1,57,0.48214285714285715,0.9824561403508771,0.2586758247068645,0.9486754358840824
0,5,57,62,0.0,0.08064516129032258,0.22790659393763382,0.8195035325186305
13,185,10,208,0.06565656565656566,0.9519230769230769,0.226660365418678,0.8255247669233237
43,179,13,235,0.19369369369369369,0.9446808510638298,0.21643001845363716,0.8204791742181564
44,103,5,152,0.29931972789115646,0.9671052631578947,0.2212891049453767,0.8172229275408572
6,53,5,64,0.1016949152542373,0.921875,0.1808718950366414,0.8251098323027619
35,188,6,229,0.15695067264573992,0.9737991266375546,0.18563691889775027,0.8317835170605079
9,55,1,65,0.140625,0.9846153846153847,0.13684865359162782,0.8320919805268661
6,7,2,15,0.46153846153846156,0.8666666666666667,0.20278271952569377,0.9443807670092009
29,54,5,88,0.3493975903614458,0.9431818181818182,0.24331715162639092,0.9431320157604496
2,60,3,65,0.03225806451612903,0.9538461538461539,0.22025491888673882,0.9444413447293531
43,97,3,143,0.30714285714285716,0.9790209790209791,0.22137250877983897,0.946143589852651
15,109,472,596,0.12096774193548387,0.2080536912751678,0.22412576973430273,0.8441691171776748
1,49,9,59,0.02,0.847457627118644,0.20456138792776848,0.8261203315321162
18,69,20,107,0.20689655172413793,0.8130841121495327,0.21402875245978817,0.8016158640369945
2,0,0,2,1.0,1.0,0.2909518293828651,0.8206634830846136
8,8,1,17,0.5,0.9411764705882353,0.31246645933123,0.8203770048569589
17,85,4,106,0.16666666666666666,0.9622641509433962,0.33166768820987824,0.8215795758708506
47,80,23,150,0.3700787401574803,0.8466666666666667,0.34065852864053864,0.8026718169630918
25,34,4,63,0.423728813559322,0.9365079365079365,0.383910110301087,0.9067367091392017
11,18,2,31,0.3793103448275862,0.9354838709677419,0.43524015956217077,0.9193118868319298
0,21,1,22,0.0,0.9545454545454546,0.33376694151512576,0.9366961952795195
34,57,23,114,0.37362637362637363,0.7982456140350878,0.3157135663188934,0.9078741401416749
16,78,2,96,0.1702127659574468,0.9791666666666666,0.2686011043128144,0.9133013110100222
0,1,0,1,0.0,1.0,0.23877378877121316,0.9193163486040072
33,72,3,108,0.3142857142857143,0.9722222222222222,0.2336106978938366,0.9388174823908554
128,210,39,377,0.378698224852071,0.896551724137931,0.22959906415599685,0.933109452052283
15,62,20,97,0.19480519480519481,0.7938144329896907,0.2045183247895432,0.9135065877995788
0,28,5,33,0.0,0.8484848484848485,0.2045183247895432,0.8983550726480637
0,12,2,14,0.0,0.8571428571428571,0.1511431285572041,0.9067689645206023
1,8,2,11,0.1111111111111111,0.8181818181818182,0.14270003500772757,0.8837711290227668
37,146,56,239,0.20218579234972678,0.7656903765690377,0.1715837196291171,0.8502983256754864
41,97,21,159,0.2971014492753623,0.8679245283018868,0.16912882462763826,0.8353986551154385
3,18,4,25,0.14285714285714285,0.84,0.13543724148550568,0.8273198373814484
10,19,93,122,0.3448275862068966,0.23770491803278687,0.15686901168574877,0.7478756209590335
4,42,3,49,0.08695652173913043,0.9387755102040817,0.16929137193419597,0.760774286918924
13,148,27,188,0.08074534161490683,0.8563829787234043,0.18082642073632552,0.7606657328590021
23,107,3,133,0.17692307692307693,0.9774436090225563,0.1902281301380349,0.7834174172648218
28,109,8,145,0.20437956204379562,0.9448275862068966,0.1905415258086162,0.8090084472130874
34,66,6,106,0.34,0.9433962264150944,0.19666989019785014,0.819790118372117
52,166,7,225,0.23853211009174313,0.9688888888888889,0.2103377426599359,0.8382028167848155
21,61,1,83,0.25609756097560976,0.9879518072289156,0.19766202476975206,0.9453809438128339
4,48,1,53,0.07692307692307693,0.9811320754716981,0.1962286755103159,0.9514318817082075
3,21,12,36,0.125,0.6666666666666666,0.2025507695653292,0.924329551414388
14,142,4,160,0.08974358974358974,0.975,0.1900965571111167,0.9239804644111655
18,88,26,132,0.16981132075471697,0.803030303030303,0.18515823692696262,0.9037237096716523
33,67,25,125,0.33,0.8,0.18372966549839118,0.883238534469496
12,89,2,103,0.1188118811881188,0.9805825242718447,0.1666267756550163,0.8849090538099181
13,50,1,64,0.20634920634920634,0.984375,0.15951986785124436,0.8843980813486445
10,98,12,120,0.09259259259259259,0.9,0.1617583700897466,0.8728077848526876
14,32,1,47,0.30434782608695654,0.9787234042553191,0.187379488102169,0.9173873187939237
26,69,1,96,0.2736842105263158,0.9895833333333334,0.21365671964255842,0.919470652127257
8,17,4,29,0.32,0.8620689655172413,0.23511224524902744,0.9279047467682482
8,60,12,80,0.11764705882352941,0.85,0.20477611079524588,0.9350476039111053
27,26,1,54,0.5094339622641509,0.9814814814814815,0.26057926523467906,0.9351760263696249
0,2,58,60,0.0,0.03333333333333333,0.23110080718479245,0.7993129311315297
12,158,10,180,0.07058823529411765,0.9444444444444444,0.2279573275707246,0.805662137480736
43,142,15,200,0.23243243243243245,0.925,0.2176836999057926,0.7979873654442619
44,92,3,139,0.3235294117647059,0.9784172661870504,0.2248044429398483,0.7963922129947928
6,54,3,63,0.1,0.9523809523809523,0.19337587151127686,0.8092939254038944
37,170,6,213,0.178743961352657,0.971830985915493,0.2021040004440094,0.8266983519632506
0,10,55,65,0.0,0.15384615384615385,0.12932772012055924,0.7084647337296323
6,6,2,14,0.5,0.8571428571428571,0.2007562915491307,0.8261518085595644
27,44,5,76,0.38028169014084506,0.9342105263157895,0.24499821367009172,0.8246898202554708
1,60,3,64,0.01639344262295082,0.953125,0.21413550084016578,0.828707677398328
40,78,3,121,0.3389830508474576,0.9752066115702479,0.21634316356627317,0.8282490124530704
14,80,413,507,0.14893617021276595,0.1854043392504931,0.22333404502523974,0.7186809248630048
1,43,9,53,0.022727272727272728,0.8301886792452831,0.20104594665018485,0.6984463096244033
21,61,20,102,0.25609756097560976,0.803921568627451,0.2376313125038434,0.7913142260217316
2,0,0,2,1.0,1.0,0.3090598839324148,0.8117223892870378
8,8,1,17,0.5,0.9411764705882353,0.3261624996265798,0.8127175241831013
19,72,4,95,0.2087912087912088,0.9578947368421052,0.35364789479347375,0.813398915160545
44,74,22,140,0.3728813559322034,0.8428571428571429,0.35849050980558034,0.79449184820153
24,35,4,63,0.4067796610169492,0.9365079365079365,0.39532529420617796,0.9017923620954506
11,16,2,29,0.4074074074074074,0.9310344827586207,0.45027959916048294,0.9161989054544987
0,21,1,22,0.0,0.9545454545454546,0.3088014765679304,0.9395206500313471
34,57,23,114,0.37362637362637363,0.7982456140350878,0.29074810137169804,0.9106985948935026
14,80,2,96,0.14893617021276595,0.9791666666666666,0.24059612568780747,0.9161257657618498
0,1,0,1,0.0,1.0,0.21958772232646293,0.9215166013413647
33,72,3,108,0.3142857142857143,0.9722222222222222,0.21949130580709927,0.9394531092778726
124,217,36,377,0.36363636363636365,0.9045092838196287,0.21090667010381953,0.934881873179543
13,64,20,97,0.16883116883116883,0.7938144329896907,0.1956165415131983,0.9146433820398213
0,28,5,33,0.0,0.8484848484848485,0.19561654151319832,0.8994918668883063
0,12,2,14,0.0,0.8571428571428571,0.14224134528085922,0.9079057587608447
1,8,2,11,0.1111111111111111,0.8181818181818182,0.13683776540919423,0.8849079232630093
35,145,59,239,0.19444444444444445,0.7531380753138075,0.16461554318697202,0.8496419340221246
40,95,22,157,0.2962962962962963,0.8598726114649682,0.16204562633134087,0.8335919896282312
3,18,4,25,0.14285714285714285,0.84,0.13050573764859502,0.8243763776539985
9,18,95,122,0.3333333333333333,0.22131147540983606,0.15400604686318994,0.7425902408568764
4,42,3,49,0.08695652173913043,0.9387755102040817,0.16642840711163717,0.7554889068167668
10,151,27,188,0.062111801242236024,0.8563829787234043,0.17530152157481374,0.755380352756845
20,111,3,134,0.15267175572519084,0.9776119402985075,0.18123875651968227,0.7781560844878006
28,109,8,145,0.20437956204379562,0.9448275862068966,0.1826580590338753,0.8055403003296705
36,65,5,106,0.3564356435643564,0.9528301886792453,0.1912493943578839,0.8188199542174244
52,166,7,225,0.23853211009174313,0.9688888888888889,0.20491724681996965,0.8372326526301227
21,61,1,83,0.25609756097560976,0.9879518072289156,0.19388356505458057,0.9467527000328484
5,43,5,53,0.10416666666666667,0.9056603773584906,0.19634215718708575,0.9420219667691926
2,22,12,36,0.08333333333333333,0.6666666666666666,0.19937380462867108,0.9149196364753729
6,150,4,160,0.038461538461538464,0.975,0.18305805930529218,0.9145465021470148
16,89,27,132,0.1523809523809524,0.7954545454545454,0.17562968649631455,0.8932074963252502
34,66,25,125,0.34,0.8,0.17328173741569222,0.8713746122282151
10,91,2,103,0.09900990099009901,0.9805825242718447,0.1533499932583145,0.8730451315686374
14,49,1,64,0.2222222222222222,0.984375,0.1485106591506877,0.8725341591073638
10,98,12,120,0.09259259259259259,0.9,0.14685721999724852,0.8717255337704365
14,32,1,47,0.30434782608695654,0.9787234042553191,0.17843071896205184,0.9163050677116727
26,69,1,96,0.2736842105263158,0.9895833333333334,0.2120339578284486,0.918388401045006
10,15,4,29,0.4,0.8620689655172413,0.24740810748831257,0.9279047467682482
8,60,12,80,0.11764705882352941,0.85,0.21564340160595963,0.9350476039111054
23,29,1,53,0.4423076923076923,0.9811320754716981,0.2646859432227587,0.9351261112253703
0,2,58,60,0.0,0.03333333333333333,0.23293991147672694,0.799263015987275
12,157,10,179,0.07100591715976332,0.9441340782122905,0.22985610070060844,0.8055678843033165
43,144,14,201,0.22994652406417113,0.9303482587064676,0.21922734326878196,0.798657149224909
44,92,3,139,0.3235294117647059,0.9784172661870504,0.22634808630283773,0.7970619967754401
5,51,7,63,0.08928571428571429,0.8888888888888888,0.18196033120079688,0.8008934143999611
36,170,6,212,0.17475728155339806,0.9716981132075472,0.19011893444792097,0.8182788591438964
0,10,55,65,0.0,0.15384615384615385,0.12693212126110778,0.700095156054533
6,6,2,14,0.5,0.8571428571428571,0.1983606926896792,0.8177822308844649
28,43,5,76,0.39436619718309857,0.9342105263157895,0.2445550184072985,0.8163645806135362
1,60,3,64,0.01639344262295082,0.953125,0.21404743534426704,0.8196184007983265
41,78,3,122,0.3445378151260504,0.9754098360655737,0.21704863582445913,0.8191887679238299
14,80,413,507,0.14893617021276595,0.1854043392504931,0.22557012952832364,0.7186909751183448
1,43,9,53,0.022727272727272728,0.8301886792452831,0.20385155683887718,0.6984753416951642
21,60,20,101,0.25925925925925924,0.801980198019802,0.24088859387591421,0.7910659194342567
1,1,0,2,0.5,1.0,0.24088859387591421,0.811474082699563
8,8,1,17,0.5,0.9411764705882353,0.25597913713547155,0.8124692175956267
19,72,4,95,0.2087912087912088,0.9578947368421052,0.28346453230236557,0.8131506085730703
41,76,23,140,0.3504273504273504,0.8357142857142857,0.28430589448826554,0.7931941013800291
24,35,4,63,0.4067796610169492,0.9365079365079365,0.32114067888886316,0.9004946152739496
10,17,2,29,0.37037037037037035,0.9310344827586207,0.3708039785521628,0.9149011586329978
1,22,1,24,0.043478260869565216,0.9583333333333334,0.3886909469058773,0.9400617755724728
34,61,22,117,0.35789473684210527,0.811965811965812,0.2969616235976066,0.913199748710446
12,98,2,112,0.10909090909090909,0.9821428571428571,0.24111746775345072,0.9190520896468204
0,1,0,1,0.0,1.0,0.2201090643921062,0.9244429252263353
32,89,3,124,0.2644628099173554,0.9758064516129032,0.21064537132068226,0.9428914659329405
133,244,38,415,0.35278514588859416,0.908433734939759,0.20051056165343545,0.938880865708915
14,72,20,106,0.16279069767441862,0.8113207547169812,0.18435750861184994,0.9211432776730922
0,35,5,40,0.0,0.875,0.17814632848762632,0.9092385157683303
0,12,2,14,0.0,0.8571428571428571,0.12701850893875413,0.915692379365051
1,13,2,16,0.07142857142857142,0.875,0.12163817498699162,0.9003862569160714
39,169,59,267,0.1875,0.7790262172284644,0.1484238892727059,0.8688185736629949
41,110,21,172,0.271523178807947,0.877906976744186,0.14943251339993327,0.8548329343960352
3,19,4,26,0.13636363636363635,0.8461538461538461,0.11851515489636788,0.8459358074266191
8,23,95,126,0.25806451612903225,0.24603174603174602,0.1321257003898841,0.7651802347572998
5,45,3,53,0.1,0.9433962264150944,0.1464114146755984,0.7749511242451704
8,170,28,206,0.0449438202247191,0.8640776699029126,0.15283196042198682,0.7759418117823212
21,144,3,168,0.12727272727272726,0.9821428571428571,0.16080969697115194,0.7912479342313008
26,116,8,150,0.18309859154929578,0.9466666666666667,0.1601809243353371,0.8151965698653297
37,74,6,117,0.3333333333333333,0.9487179487179487,0.16901094641039224,0.8253124230044386
52,166,7,225,0.23853211009174313,0.9688888888888889,0.1836064426572647,0.8428460005380163
29,72,1,102,0.2871287128712871,0.9901960784313726,0.18775847076330107,0.94915519088082
5,50,5,60,0.09090909090909091,0.9166666666666666,0.18645976946459977,0.9453366823453303
2,24,13,39,0.07692307692307693,0.6666666666666666,0.1910282347072223,0.917135110454438
7,152,4,163,0.0440251572327044,0.9754601226993865,0.17913572470150477,0.9161804341053709
16,98,26,140,0.14035087719298245,0.8142857142857143,0.17302890836488857,0.8972688694795204
35,78,26,139,0.30973451327433627,0.8129496402877698,0.16965764835646044,0.8778733968466378
11,97,2,110,0.10185185185185185,0.9818181818181818,0.1501318971793331,0.8797204386936796
12,53,1,66,0.18461538461538463,0.9848484848484849,0.13548713599991846,0.8789564967532671
10,111,12,133,0.08264462809917356,0.9097744360902256,0.13430649845564455,0.8779718923852042
12,37,1,50,0.24489795918367346,0.98,0.15830291020715834,0.9227337971471089
24,74,1,99,0.24489795918367346,0.98989898989899,0.1869990247715825,0.9247964924613379
8,18,4,30,0.3076923076923077,0.8666666666666667,0.21090494341434327,0.9322794856586168
10,75,11,96,0.11764705882352941,0.8854166666666666,0.1834638784927994,0.9426319179984592
24,30,2,56,0.4444444444444444,0.9642857142857143,0.23240567743459836,0.9401272797795353
0,4,58,62,0.0,0.06451612903225806,0.20603205106097194,0.8086512289486458
11,187,10,208,0.05555555555555555,0.9519230769230769,0.20216218355474083,0.8146724633533388
44,177,13,234,0.19909502262443438,0.9444444444444444,0.19561890690342093,0.8095930982739736
35,104,13,152,0.2517985611510791,0.9144736842105263,0.1966047071844789,0.7988180546041932
5,53,7,65,0.08620689655172414,0.8923076923076924,0.16496393416439553,0.8024810582671968
34,187,6,227,0.15384615384615385,0.973568281938326,0.1701352334533419,0.8150741461631482
0,8,57,65,0.0,0.12307692307692308,0.1066431699612784,0.6949014617047494
6,7,2,15,0.46153846153846156,0.8666666666666667,0.17257723589534435,0.8094943956525221
29,54,5,88,0.3493975903614458,0.9431818181818182,0.21455466943904294,0.8082456444037709
2,60,3,65,0.03225806451612903,0.9538461538461539,0.1907208182807136,0.8095887457468721
40,100,3,143,0.2857142857142857,0.9790209790209791,0.19556592178974314,0.8188097878626512
15,109,473,597,0.12096774193548387,0.20770519262981574,0.20053175684456592,0.7210094307658117
1,49,9,59,0.02,0.847457627118644,0.18141087772368683,0.7029936229344285
22,65,20,107,0.25287356321839083,0.8130841121495327,0.21753567246917124,0.80156607851623
1,1,0,2,0.5,1.0,0.22303017796367672,0.8206136975638489
8,8,1,17,0.5,0.9411764705882353,0.2445448079120416,0.8203272193361943
15,87,4,106,0.14705882352941177,0.9622641509433962,0.26094491634251055,0.821529790350086
40,87,23,150,0.31496062992125984,0.8466666666666667,0.26512296551493547,0.8026220314423271
25,34,4,63,0.423728813559322,0.9365079365079365,0.3083745471754838,0.9067367091392015
8,21,2,31,0.27586206896551724,0.9354838709677419,0.3449262713134148,0.9193118868319298
5,18,1,24,0.21739130434782608,0.9583333333333334,0.4229965546041145,0.9400104342812393
35,61,21,117,0.3645833333333333,0.8205128205128205,0.33222274508030497,0.9143694086402135
14,96,2,112,0.12727272727272726,0.9821428571428571,0.27897599183355176,0.9202217495765882
0,1,0,1,0.0,1.0,0.2535163030075263,0.9256639264473365
33,88,3,124,0.2727272727272727,0.9758064516129032,0.24523324748037628,0.9441124671539417
136,240,39,415,0.3617021276595745,0.9060240963855422,0.24121490736394743,0.9397576328507424
15,71,20,106,0.1744186046511628,0.8113207547169812,0.21687076714169978,0.9220200448149195
0,35,5,40,0.0,0.875,0.1858148665205818,0.9101152829101576
0,12,2,14,0.0,0.8571428571428571,0.13373153318724842,0.9153481452858772
1,13,2,16,0.07142857142857142,0.875,0.1257537966380833,0.9000420228368975
42,166,59,267,0.20192307692307693,0.7790262172284644,0.1545999504842372,0.8684743395838209
43,108,21,172,0.2847682119205298,0.877906976744186,0.15632008465470246,0.8544887003168614
3,19,4,26,0.13636363636363635,0.8461538461538461,0.12412887161242558,0.8459358074266191
9,22,95,126,0.2903225806451613,0.24603174603174602,0.1406865824687111,0.7651802347572998
5,45,3,53,0.1,0.9433962264150944,0.15497229675442536,0.7749511242451704
10,167,28,205,0.05649717514124294,0.8634146341463415,0.16304332177460296,0.7758470923885253
19,146,3,168,0.11515151515151516,0.9821428571428571,0.16928945659216632,0.791153214837505
27,115,8,150,0.19014084507042253,0.9466666666666667,0.1676062806132157,0.8151018504715338
39,73,5,117,0.3482142857142857,0.9572649572649573,0.17667000544089512,0.826438704831644
52,166,7,225,0.23853211009174313,0.9688888888888889,0.1912655016877675,0.8439722823652216
28,73,1,102,0.27722772277227725,0.9901960784313726,0.1893948077059269,0.9502814727080253
4,51,5,60,0.07272727272727272,0.9166666666666666,0.18549870380982303,0.9464629641725357
2,24,13,39,0.07692307692307693,0.6666666666666666,0.18841668977865647,0.9183561116754394
6,152,5,163,0.0379746835443038,0.9693251533742331,0.17739142812048342,0.9165250111370644
16,98,26,140,0.14035087719298245,0.8142857142857143,0.1702785755665634,0.8976134465112141
34,80,25,139,0.2982456140350877,0.8201438848920863,0.16314019389810655,0.8780247218865183
11,97,2,110,0.10185185185185185,0.9818181818181818,0.1436144427209792,0.8798717637335601
14,51,1,66,0.2153846153846154,0.9848484848484849,0.1347797130941704,0.8791078217931476
10,111,12,133,0.08264462809917356,0.9097744360902256,0.13619647814729907,0.8781232174250846
12,37,1,50,0.24489795918367346,0.98,0.1601928898988129,0.9228851221869893
24,74,1,99,0.24489795918367346,0.98989898989899,0.18975335784729425,0.9258242416905259
10,16,4,30,0.38461538461538464,0.8666666666666667,0.224648287479066,0.933307234887805
11,74,11,96,0.12941176470588237,0.8854166666666666,0.20052916614632238,0.9426319179984591
25,29,2,56,0.46296296296296297,0.9642857142857143,0.25211646773362395,0.9401272797795353
0,4,58,62,0.0,0.06451612903225806,0.22134723696439318,0.8086512289486457
12,186,10,208,0.06060606060606061,0.9519230769230769,0.21819887017966275,0.8146724633533389
43,177,14,234,0.19545454545454546,0.9401709401709402,0.21113552536121588,0.808982597663473
37,99,16,152,0.27205882352941174,0.8947368421052632,0.2150156488391785,0.7953880051215122
4,54,7,65,0.06896551724137931,0.8923076923076924,0.16992281064289205,0.7990510087845158
37,184,6,227,0.167420814479638,0.973568281938326,0.1753526748962857,0.8116440966804672
0,8,57,65,0.0,0.12307692307692308,0.10921510875871955,0.6914714122220685
7,6,2,15,0.5384615384615384,0.8666666666666667,0.1861381856817965,0.8060643461698411
29,54,5,88,0.3493975903614458,0.9431818181818182,0.22739411850399435,0.8048155949210898
2,60,3,65,0.03225806451612903,0.9538461538461539,0.204080335512792,0.8067691968746917
42,98,3,143,0.3,0.9790209790209791,0.20807193215144748,0.8188097878626512
15,110,472,597,0.12,0.20938023450586266,0.21536257254553615,0.7212487224623897
1,49,9,59,0.02,0.847457627118644,0.19430245619130213,0.7032329146310067
22,65,20,107,0.25287356321839083,0.8130841121495327,0.23042725093678657,0.801805370212808
2,0,0,2,1.0,1.0,0.2963613168708525,0.820852989260427
8,8,1,17,0.5,0.9411764705882353,0.3178759468192173,0.8205665110327723
15,87,4,106,0.14705882352941177,0.9622641509433962,0.33427605524968634,0.8217690820466642
42,85,23,150,0.33070866141732286,0.8466666666666667,0.3386630068807325,0.8028613231389052
25,34,4,63,0.423728813559322,0.9365079365079365,0.3820528373892071,0.9067367091392017
8,21,2,31,0.27586206896551724,0.9354838709677419,0.41860456152713804,0.9193118868319298
5,18,1,24,0.21739130434782608,0.9583333333333334,0.4194503877054853,0.9400104342812393
35,61,21,117,0.3645833333333333,0.8205128205128205,0.3286765781816758,0.9143694086402137
17,93,2,112,0.15454545454545454,0.9821428571428571,0.27932592883102647,0.9202217495765881
0,1,0,1,0.0,1.0,0.253866240005001,0.9256639264473364
34,87,3,124,0.2809917355371901,0.9758064516129032,0.2478886814147008,0.9441124671539417
129,246,40,415,0.344,0.9036144578313253,0.24376277342438607,0.9394133987715687
12,74,20,106,0.13953488372093023,0.8113207547169812,0.21443524449781945,0.9216758107357457
0,35,5,40,0.0,0.875,0.18337934387670143,0.9097710488309837
0,12,2,14,0.0,0.8571428571428571,0.1312960105433681,0.9150039112067033
1,13,2,16,0.07142857142857142,0.875,0.11942217009809908,0.8996977887577238
38,170,59,267,0.18269230769230768,0.7790262172284644,0.14552107119700017,0.8681301055046473
44,106,22,172,0.29333333333333333,0.872093023255814,0.1472841565964492,0.8533139014536344
3,19,4,26,0.13636363636363635,0.8461538461538461,0.11762181893411153,0.8451052426425659
8,21,97,126,0.27586206896551724,0.23015873015873015,0.1370971311119097,0.7620820962771016
5,45,3,53,0.1,0.9433962264150944,0.15138284539762398,0.7718529857649722
11,166,28,205,0.062146892655367235,0.8634146341463415,0.16026097291981928,0.7727489539083271
19,146,3,168,0.11515151515151516,0.9821428571428571,0.1665071077373827,0.7880550763573065
28,114,8,150,0.19718309859154928,0.9466666666666667,0.1685772207229886,0.8120037119913356
40,71,6,117,0.36036036036036034,0.9487179487179487,0.1781525102982782,0.8229501299144977
52,166,7,225,0.23853211009174313,0.9688888888888889,0.19274800654515056,0.8404837074480752
29,72,1,102,0.2871287128712871,0.9901960784313726,0.1943575271031177,0.9490604714870241
4,51,5,60,0.07272727272727272,0.9166666666666666,0.1904614232070138,0.9452419629515345
4,22,13,39,0.15384615384615385,0.6666666666666666,0.2035613176628405,0.917135110454438
6,153,4,163,0.03773584905660377,0.9754601226993865,0.19250193679213887,0.9161804341053709
16,97,27,140,0.1415929203539823,0.8071428571428572,0.18456048275820072,0.8962484613162551
35,79,25,139,0.30701754385964913,0.8201438848920863,0.17694008040095627,0.8778807379125606
11,96,2,109,0.102803738317757,0.981651376146789,0.15755031300467254,0.8797039503779749
13,52,1,66,0.2,0.9848484848484849,0.1451033540230601,0.8789400084375624
10,111,12,133,0.08264462809917356,0.9097744360902256,0.1465201190761888,0.8779554040694993
14,35,1,50,0.2857142857142857,0.98,0.16535842362877906,0.9227173088314041
25,73,1,99,0.25510204081632654,0.98989898989899,0.19641073673731088,0.9247800041456332
9,17,4,30,0.34615384615384615,0.8666666666666667,0.2256337261372914,0.9332834055061774
11,73,12,96,0.13095238095238096,0.875,0.20048156000768166,0.9411199933787364
26,28,1,55,0.48148148148148145,0.9818181818181818,0.2545783804596423,0.941143822760364
0,4,58,62,0.0,0.06451612903225806,0.2260069518882137,0.8096677719294745
13,185,10,208,0.06565656565656566,0.9519230769230769,0.22358008582498404,0.8156890063341675
43,177,14,234,0.19545454545454546,0.9401709401709402,0.2106858372164497,0.8099991406443018
43,103,6,152,0.2945205479452055,0.9605263157894737,0.2163170525205753,0.8058030443429424
7,51,7,65,0.1206896551724138,0.8923076923076924,0.18410788238037065,0.809466048005946
38,183,6,227,0.17194570135746606,0.973568281938326,0.18996407100966856,0.8235472311399926
0,10,55,65,0.0,0.15384615384615385,0.12118100222659975,0.7052655128582742
7,6,2,15,0.5384615384615384,0.8666666666666667,0.19810407914967668,0.8198584468060469
29,54,5,88,0.3493975903614458,0.9431818181818182,0.2386385112503738,0.8186096955572957
2,60,3,65,0.03225806451612903,0.9538461538461539,0.2153247282591715,0.8205632975108976
40,100,3,143,0.2857142857142857,0.9790209790209791,0.2140666907976115,0.8232053922582556
16,109,472,597,0.128,0.20938023450586266,0.21511102577298097,0.7256443268579942
1,49,9,59,0.02,0.847457627118644,0.19340449700762868,0.7076285190266111
22,65,20,107,0.25287356321839083,0.8130841121495327,0.2295292917531131,0.801805370212808
2,0,0,2,1.0,1.0,0.29546335768717896,0.820852989260427
8,8,1,17,0.5,0.9411764705882353,0.3169779876355439,0.8205665110327723
18,83,4,105,0.1782178217821782,0.9619047619047619,0.3378293815306938,0.8217177407554307
42,85,23,150,0.33070866141732286,0.8466666666666667,0.3442571494882706,0.8028099818476717
23,36,4,63,0.3898305084745763,0.9365079365079365,0.38166150784178143,0.9066853678479682
10,19,2,31,0.3448275862068966,0.9354838709677419,0.4280654487284809,0.9192605455406964
5,18,1,24,0.21739130434782608,0.9583333333333334,0.4177321291176964,0.9400104342812392
35,61,21,117,0.3645833333333333,0.8205128205128205,0.3269583195938868,0.9143694086402137
16,94,2,112,0.14545454545454545,0.9821428571428571,0.2852375403731076,0.9202217495765881
0,1,0,1,0.0,1.0,0.25836342439008075,0.9256639264473365
33,88,3,124,0.2727272727272727,0.9758064516129032,0.24783065007777888,0.9441124671539417
128,247,40,415,0.3413333333333333,0.9036144578313253,0.24090248220045846,0.9394133987715687
11,75,20,106,0.12790697674418605,0.8113207547169812,0.20991382370578554,0.9216758107357457
0,35,5,40,0.0,0.875,0.1788579230846675,0.9097710488309838
0,12,2,14,0.0,0.8571428571428571,0.12677458975133418,0.9150039112067032
2,12,2,16,0.14285714285714285,0.875,0.1264035322374195,0.8996977887577238
38,171,59,268,0.18181818181818182,0.7798507462686567,0.1523775582114455,0.8682478953675318
43,107,22,172,0.2866666666666667,0.872093023255814,0.15436890020278748,0.8534316913165191
4,18,4,26,0.18181818181818182,0.8461538461538461,0.1315810214149087,0.8452230325054505
10,20,96,126,0.3333333333333333,0.23809523809523808,0.16092764378478688,0.7633336729880587
5,45,3,53,0.1,0.9433962264150944,0.17521335807050117,0.7731045624759293
11,166,28,205,0.062146892655367235,0.8634146341463415,0.1840914855926965,0.7740005306192843
20,145,3,168,0.12121212121212122,0.9821428571428571,0.18099933964340773,0.789306653068264
33,109,8,150,0.2323943661971831,0.9466666666666667,0.1882245088404079,0.8131374988394081
39,70,8,117,0.3577981651376147,0.9316239316239316,0.19838615147911476,0.8216419143205679
52,166,7,225,0.23853211009174313,0.9688888888888889,0.20648814123248063,0.8391754918541452
29,72,1,102,0.2871287128712871,0.9901960784313726,0.19988748116647406,0.9466184690450217
4,55,1,60,0.06779661016949153,0.9833333333333333,0.19528699690497284,0.9523237700333416
3,23,13,39,0.11538461538461539,0.6666666666666666,0.20289238586629396,0.9242169175362452
6,153,4,163,0.03773584905660377,0.9754601226993865,0.19096720412979146,0.9232622411871779
16,98,26,140,0.14035087719298245,0.8142857142857143,0.17781813427204854,0.9043506765613276
34,80,25,139,0.2982456140350877,0.8201438848920863,0.16931062697168756,0.8884249555996354
10,97,2,109,0.09345794392523364,0.981651376146789,0.14858574609075761,0.8902481680650497
13,52,1,66,0.2,0.9848484848484849,0.13613878710914518,0.8894842261246373
10,111,12,133,0.08264462809917356,0.9097744360902256,0.1382599325276712,0.8789758122327646
15,34,1,50,0.30612244897959184,0.98,0.1655081944698107,0.9237377169946693
24,73,1,98,0.24742268041237114,0.9897959183673469,0.19546345609206317,0.925785687804378
10,16,4,30,0.38461538461538464,0.8666666666666667,0.2303583857238349,0.9332686810016569
10,74,12,96,0.11904761904761904,0.875,0.20475867215419652,0.941105268874216
26,29,1,56,0.4727272727272727,0.9821428571428571,0.2589400048402021,0.9411754804450829
0,4,58,62,0.0,0.06451612903225806,0.23036857626877352,0.8096994296141933
12,186,10,208,0.06060606060606061,0.9519230769230769,0.22722020948404312,0.8157206640188865
42,178,14,234,0.19090909090909092,0.9401709401709402,0.2107611583311144,0.8100307983290207
45,103,3,151,0.30405405405405406,0.9801324503311258,0.21885135456564053,0.808650302895275
5,53,7,65,0.08620689655172414,0.8923076923076924,0.17622157055654616,0.8123133065582785
39,182,6,227,0.17647058823529413,0.973568281938326,0.18442485186907118,0.8263944896923251
0,9,56,65,0.0,0.13846153846153847,0.11689238433660366,0.7058685870235654
6,7,2,15,0.46153846153846156,0.8666666666666667,0.1828264502706696,0.820461520971338
29,54,5,88,0.3493975903614458,0.9431818181818182,0.22408238309286752,0.8192127697225866
2,60,3,65,0.03225806451612903,0.9538461538461539,0.20141795075101582,0.8211663716761887
41,99,3,143,0.29285714285714287,0.9790209790209791,0.1998183920085999,0.8210075900604534
16,109,472,597,0.128,0.20938023450586266,0.2057888353583536,0.723446524660192
1,49,9,59,0.02,0.847457627118644,0.18343589418188302,0.7054307168288089
21,66,20,107,0.2413793103448276,0.8130841121495327,0.2179186528025727,0.801805370212808
2,0,0,2,1.0,1.0,0.2948417297256496,0.820852989260427
8,8,1,17,0.5,0.9411764705882353,0.3163563596740145,0.8205665110327723
18,83,4,105,0.1782178217821782,0.9619047619047619,0.3372077535691644,0.8217177407554307
41,86,23,150,0.3228346456692913,0.8466666666666667,0.3414902539708998,0.8028099818476717
22,37,4,63,0.3728813559322034,0.9365079365079365,0.37647330481835745,0.9066853678479679
10,19,2,31,0.3448275862068966,0.9354838709677419,0.422877245705057,0.9192605455406963
7,16,1,24,0.30434782608695654,0.9583333333333334,0.4513788975837615,0.9381937392222722
35,61,21,117,0.3645833333333333,0.8205128205128205,0.360605088059952,0.9125527135812466
16,94,2,112,0.14545454545454545,0.9821428571428571,0.30995573741060134,0.9184050545176212
0,1,0,1,0.0,1.0,0.2782097056645696,0.9244840818732444
33,88,3,124,0.2727272727272727,0.9758064516129032,0.2639019794924366,0.9434768402669244
129,249,37,415,0.3412698412698413,0.9108433734939759,0.25696474132033165,0.9398104741220729
14,72,20,106,0.16279069767441862,0.8113207547169812,0.2273105023637671,0.9227085129732672
0,35,5,40,0.0,0.875,0.18383224149420188,0.9108037510685053
0,13,1,14,0.0,0.9285714285714286,0.13174890816086854,0.9262406950768779
2,13,1,16,0.13333333333333333,0.9375,0.13001730642926682,0.9198631440564696
37,172,59,268,0.17703349282296652,0.7798507462686567,0.1553078054039763,0.8884132506662777
42,108,22,172,0.28,0.872093023255814,0.15634676644293735,0.873597046615265
3,23,0,26,0.11538461538461539,1.0,0.12407744845933368,0.8863337075446971
12,45,69,126,0.21052631578947367,0.4523809523809524,0.1308968224757701,0.8350565929252645
5,45,3,53,0.1,0.9433962264150944,0.14518253676148438,0.844827482413135
12,166,27,205,0.06741573033707865,0.8682926829268293,0.15481335538106705,0.8362162330353351
21,144,3,168,0.12727272727272726,0.9821428571428571,0.1539475545152662,0.8425937840557433
35,107,8,150,0.24647887323943662,0.9466666666666667,0.16386832314619046,0.8664246298268875
43,67,7,117,0.39090909090909093,0.9401709401709402,0.17971247899034634,0.8761500465290484
52,166,7,225,0.23853211009174313,0.9688888888888889,0.19730497823422172,0.8717056020846039
28,73,1,102,0.27722772277227725,0.9901960784313726,0.20683375066033652,0.948536334377521
4,55,1,60,0.06779661016949153,0.9833333333333333,0.20223326639883532,0.9542416353658411
4,23,12,39,0.14814814814814814,0.6923076923076923,0.2137664689432738,0.9291009224202501
14,145,4,163,0.0880503144654088,0.9754601226993865,0.20816326711365687,0.9281462460711828
16,99,25,140,0.1391304347826087,0.8214285714285714,0.1928277759055386,0.9102550896085978
32,82,25,139,0.2807017543859649,0.8201438848920863,0.17708387068794917,0.8931083674259044
11,96,2,109,0.102803738317757,0.981651376146789,0.15769410329166544,0.8949315798913187
14,51,1,66,0.2153846153846154,0.9848484848484849,0.14885937366485663,0.8941676379509061
10,111,12,133,0.08264462809917356,0.9097744360902256,0.1509805190833826,0.8836592240590336
15,34,1,50,0.30612244897959184,0.98,0.1735482763450174,0.9247581251579347
23,74,1,98,0.23711340206185566,0.9897959183673469,0.19484300314450984,0.9268060959676433
8,18,4,30,0.3076923076923077,0.8666666666666667,0.21892327070303824,0.9332686810016569
13,78,5,96,0.14285714285714285,0.9479166666666666,0.19923118334177797,0.9515219355408827
26,29,1,56,0.4727272727272727,0.9821428571428571,0.2520774025431374,0.9515921471117496
0,4,58,62,0.0,0.06451612903225806,0.22130817177390658,0.82011609628086
13,185,10,208,0.06565656565656566,0.9519230769230769,0.21888130571067688,0.8261373306855531
40,179,14,233,0.182648401826484,0.9399141630901288,0.20124215611737575,0.8204107825555714
44,104,3,151,0.2972972972972973,0.9801324503311258,0.2098398554367246,0.8190302871218257
5,56,4,65,0.08196721311475409,0.9384615384615385,0.17759341335421694,0.8292866973782358
40,181,6,227,0.18099547511312217,0.973568281938326,0.1830417465336425,0.8329512138456157
9,55,1,65,0.140625,0.9846153846153847,0.1355985647154607,0.8333044320559768
6,7,2,15,0.46153846153846156,0.8666666666666667,0.20153263064952665,0.9478973660037495
29,54,5,88,0.3493975903614458,0.9431818181818182,0.2420670627502238,0.9466486147549983
2,60,3,65,0.03225806451612903,0.9538461538461539,0.22058272884874452,0.9486388991487161
43,97,3,143,0.30714285714285716,0.9790209790209791,0.22198923739811025,0.9484801175329808
15,113,469,597,0.1171875,0.21440536013400335,0.22702070695314536,0.8450435206290473
0,50,9,59,0.0,0.847457627118644,0.20116421050841363,0.8270277127976641
21,66,20,107,0.2413793103448276,0.8130841121495327,0.21555768341481757,0.8025232453025425
2,0,0,2,1.0,1.0,0.29248076033789444,0.8215708643501615
7,9,1,17,0.4375,0.9411764705882353,0.30506681885768794,0.8212843861225068
19,82,4,105,0.18811881188118812,0.9619047619047619,0.32733263990983924,0.822435615845165
44,83,23,150,0.3464566929133858,0.8466666666666667,0.33294890216277195,0.8035278569374061
23,36,4,63,0.3898305084745763,0.9365079365079365,0.37189790337342565,0.9066853678479679
10,19,2,31,0.3448275862068966,0.9354838709677419,0.421158987117268,0.9192605455406964
6,15,1,22,0.2857142857142857,0.9545454545454546,0.44478009659607753,0.9376526136811467
35,55,24,114,0.3888888888888889,0.7894736842105263,0.3574785092944902,0.9075774257112219
17,78,2,97,0.17894736842105263,0.979381443298969,0.3116138476403548,0.9130352789556124
0,1,0,1,0.0,1.0,0.2830424190689263,0.9191143063112356
34,72,3,109,0.32075471698113206,0.9724770642201835,0.27922771762071025,0.9376314379345271
126,211,40,377,0.37388724035608306,0.8938992042440318,0.2793714153955502,0.9315444761825408
13,64,20,97,0.16883116883116883,0.7938144329896907,0.24528909559894468,0.9119416119298364
0,28,5,33,0.0,0.8484848484848485,0.20447276906833248,0.8967900967783213
0,12,2,14,0.0,0.8571428571428571,0.1489172135127769,0.90645712148294
2,7,2,11,0.2222222222222222,0.8181818181818182,0.15509933548437257,0.8834286036090612
35,146,59,240,0.19337016574585636,0.7541666666666667,0.18272364487663775,0.8483095559900137
41,96,22,159,0.29927007299270075,0.8616352201257862,0.1796544100211476,0.8324750068336711
3,18,4,25,0.14285714285714285,0.84,0.14665011037844183,0.8247751205130952
8,25,89,122,0.24242424242424243,0.27049180327868855,0.15716340660602376,0.7500147448400949
4,41,3,48,0.08888888888888889,0.9375,0.16986181930443647,0.7627311950565451
11,149,27,187,0.06875,0.8556149732620321,0.17968324787586504,0.7625129259307128
19,111,3,133,0.14615384615384616,0.9774436090225563,0.16881633700895415,0.7852646103365327
34,103,8,145,0.24817518248175183,0.9448275862068966,0.17664562511408208,0.8125018845565656
38,66,2,106,0.36538461538461536,0.9811320754716981,0.1860905597414985,0.8295728638916958
52,166,7,225,0.23853211009174313,0.9688888888888889,0.1997584122035842,0.8479855623043944
17,65,1,83,0.2073170731707317,0.9879518072289156,0.19474310231022557,0.9504798485829982
5,44,4,53,0.10204081632653061,0.9245283018867925,0.1966219490870315,0.94862674885254
3,21,12,36,0.125,0.6666666666666666,0.20465766337274577,0.9216341336246305
6,150,4,160,0.038461538461538464,0.975,0.1892730479881304,0.9212850466214082
16,89,26,131,0.1523809523809524,0.8015267175572519,0.17558815797373048,0.9008134939571733
32,67,25,124,0.32323232323232326,0.7983870967741935,0.16956640195197448,0.8747070684289583
13,87,2,102,0.13,0.9803921568627451,0.15406181479601117,0.8763503924252234
14,49,1,64,0.2222222222222222,0.984375,0.15619112180336694,0.8758394199639498
10,98,12,120,0.09259259259259259,0.9,0.15484137555566152,0.8723353768372651
14,32,1,47,0.30434782608695654,0.9787234042553191,0.1804624935680839,0.9169149107785012
24,70,1,95,0.2553191489361702,0.9894736842105263,0.21144215220731696,0.9189825799514335
9,16,4,29,0.36,0.8620689655172413,0.24110201615289523,0.9276314725171463
7,61,12,80,0.10294117647058823,0.85,0.2096318523297902,0.9350047444065474
25,26,1,52,0.49019607843137253,0.9807692307692307,0.26108843496284345,0.9350586121074738
0,2,58,60,0.0,0.03333333333333333,0.22934240321681168,0.7991955168693786
9,161,10,180,0.052941176470588235,0.9444444444444444,0.2236779151993825,0.8055447232185848
40,144,15,199,0.21739130434782608,0.9246231155778895,0.21125555495093526,0.7978161105503806
43,93,3,139,0.3161764705882353,0.9784172661870504,0.21994945804408747,0.7962366222613128
6,50,7,63,0.10714285714285714,0.8888888888888888,0.1838270090644956,0.8000680398858337
36,169,6,211,0.17560975609756097,0.9715639810426541,0.1942082347254917,0.8174343228919271
0,10,55,65,0.0,0.15384615384615385,0.12418022352100992,0.699302454760059
6,6,2,14,0.5,0.8571428571428571,0.19560879494958133,0.8169895295899909
28,43,5,76,0.39436619718309857,0.9342105263157895,0.24438379790851142,0.8155275412858976
1,60,3,64,0.01639344262295082,0.953125,0.21566981766210064,0.8195992390604846
43,75,3,121,0.3644067796610169,0.9752066115702479,0.22255986181535517,0.8191405741152272
15,79,412,506,0.1595744680851064,0.1857707509881423,0.2300500919499622,0.718695125843692
1,43,9,53,0.022727272727272728,0.8301886792452831,0.2082097371827782,0.6984986541583533
21,61,20,102,0.25609756097560976,0.803921568627451,0.24479510303643667,0.7913665705556815
2,0,0,2,1.0,1.0,0.31622367446500815,0.8117747338209876
8,8,1,17,0.5,0.9411764705882353,0.3313142177245655,0.8127698687170513
20,70,4,94,0.2222222222222222,0.9574468085106383,0.36071832909588997,0.8133872699328567
44,74,22,140,0.3728813559322034,0.8428571428571429,0.3619289828489166,0.7944802029738416
23,36,4,63,0.3898305084745763,0.9365079365079365,0.3948227029045551,0.9017283723338123
10,17,2,29,0.37037037037037035,0.9310344827586207,0.4444860025678548,0.9161349156928605
6,15,1,22,0.2857142857142857,0.9545454545454546,0.42251768689375074,0.9383635241443962
35,55,24,114,0.3888888888888889,0.7894736842105263,0.3352160995921634,0.9082883361744714
17,78,2,97,0.17894736842105263,0.979381443298969,0.29828000936659954,0.913746189418862
0,1,0,1,0.0,1.0,0.2728203205405741,0.9191883662896103
33,72,3,108,0.3142857142857143,0.9722222222222222,0.2742897082956761,0.9382306588218358
125,211,42,378,0.37202380952380953,0.8888888888888888,0.2741672016659056,0.9314279377334003
13,64,20,97,0.16883116883116883,0.7938144329896907,0.24409874795213168,0.9111894465936786
0,28,5,33,0.0,0.8484848484848485,0.20328242142151945,0.8960379314421635
0,12,2,14,0.0,0.8571428571428571,0.1477268658659639,0.9057049561467821
2,7,2,11,0.2222222222222222,0.8181818181818182,0.15390898783755952,0.8826764382729034
34,147,59,240,0.1878453038674033,0.7541666666666667,0.18074403124718857,0.8475573906538559
41,95,22,158,0.3014705882352941,0.8607594936708861,0.1789132989542714,0.8316341437179506
3,18,4,25,0.14285714285714285,0.84,0.14617520371617615,0.8246500167338239
9,23,90,122,0.28125,0.26229508196721313,0.1622350367402949,0.7487186808734698
4,41,3,48,0.08888888888888889,0.9375,0.17493344943870762,0.76143513108992
10,150,27,187,0.0625,0.8556149732620321,0.18386202086727904,0.7612168619640879
18,113,3,134,0.13740458015267176,0.9776119402985075,0.17174521485734326,0.7839925936950436
31,106,8,145,0.22627737226277372,0.9448275862068966,0.17723551034239618,0.8112298679150763
37,67,2,106,0.3557692307692308,0.9811320754716981,0.1849924592758157,0.8284259510294781
52,166,7,225,0.23853211009174313,0.9688888888888889,0.19866031173790147,0.8468386494421765
17,65,1,83,0.2073170731707317,0.9879518072289156,0.18809846504800598,0.950503895908134
4,45,5,54,0.08163265306122448,0.9074074074074074,0.1870618599297682,0.9462049541091923
2,22,12,36,0.08333333333333333,0.6666666666666666,0.19003805040595867,0.9192123388812828
6,150,4,160,0.038461538461538464,0.975,0.1759033301643682,0.9188392045529247
16,89,26,131,0.1523809523809524,0.8015267175572519,0.16534669875267946,0.8983676518886897
32,67,25,124,0.32323232323232326,0.7983870967741935,0.1606985691045498,0.8722612263604747
9,91,2,102,0.09,0.9803921568627451,0.13947969623430076,0.8739045503567399
13,50,1,64,0.20634920634920634,0.984375,0.13934142954551146,0.8733935778954661
10,98,12,120,0.09259259259259259,0.9,0.14090713519284975,0.8723353768372651
13,33,1,47,0.2826086956521739,0.9787234042553191,0.16937504409554124,0.9169149107785012
24,71,1,96,0.25263157894736843,0.9895833333333334,0.19997076416494555,0.9189982441118346
9,16,4,29,0.36,0.8620689655172413,0.22963062811052376,0.9276471366775473
7,61,12,80,0.10294117647058823,0.85,0.1981604642874188,0.9350204085669482
25,27,1,53,0.4807692307692308,0.9811320754716981,0.25398464011159455,0.9351261112253703
0,2,58,60,0.0,0.03333333333333333,0.224506182061708,0.799263015987275
9,161,10,180,0.052941176470588235,0.9444444444444444,0.21884169404427878,0.8056122223364813
40,144,15,199,0.21739130434782608,0.9246231155778895,0.20952492385794336,0.797883609668277
44,93,3,140,0.32116788321167883,0.9785714285714285,0.21931582446713058,0.7963104804165763
6,50,7,63,0.10714285714285714,0.8888888888888888,0.18319337548753872,0.8001418980410975
36,168,7,211,0.17647058823529413,0.966824644549763,0.193697577168211,0.8168311329767778
0,9,56,65,0.0,0.13846153846153847,0.12501625848689232,0.696449627689612
6,6,2,14,0.5,0.8571428571428571,0.19644482991546375,0.8141367025195442
28,43,5,76,0.39436619718309857,0.9342105263157895,0.24521983287439378,0.8126747142154506
1,60,3,64,0.01639344262295082,0.953125,0.21650585262798303,0.8167464119900378
42,76,3,121,0.3559322033898305,0.9752066115702479,0.2214721840820047,0.816265723847012
14,80,413,507,0.14893617021276595,0.1854043392504931,0.22744265737770597,0.7157679310415268
1,43,9,53,0.022727272727272728,0.8301886792452831,0.20547932659084575,0.6962485074266012
20,61,20,101,0.24691358024691357,0.801980198019802,0.2407526951975477,0.791036887363496
2,0,0,2,1.0,1.0,0.3121812666261191,0.8114450506288021
8,8,1,17,0.5,0.9411764705882353,0.3272718098856765,0.8124401855248659
18,72,4,94,0.2,0.9574468085106383,0.3535013180823978,0.8130575867406712
41,77,22,140,0.3474576271186441,0.8428571428571429,0.3522906643293711,0.7941505197816563
22,37,4,63,0.3728813559322034,0.9365079365079365,0.38428283371786226,0.9014510336755768
11,16,2,29,0.4074074074074074,0.9310344827586207,0.4392371386721671,0.915857577034625
5,18,1,24,0.21739130434782608,0.9583333333333334,0.41773585279016834,0.9389046496855217
36,57,24,117,0.3870967741935484,0.7948717948717948,0.33017824910353244,0.9096006203814924
16,94,2,112,0.14545454545454545,0.9821428571428571,0.2884574698827532,0.9154529613178671
0,1,0,1,0.0,1.0,0.26158335389972637,0.9208951381886153
34,85,3,122,0.2857142857142857,0.9754098360655737,0.25782825185891,0.9403928041270337
127,247,41,415,0.339572192513369,0.9012048192771084,0.2506484924358804,0.9353495016654868
11,75,20,106,0.12790697674418605,0.8113207547169812,0.21473372556682327,0.917611913629664
0,35,5,40,0.0,0.875,0.18367782494570523,0.9057071517249021
0,12,2,14,0.0,0.8571428571428571,0.1283782857751983,0.9146030177636252
3,11,2,16,0.21428571428571427,0.875,0.1382113098939367,0.8992968953146455
34,176,58,268,0.1619047619047619,0.7835820895522388,0.16134056159461702,0.8683800509649655
41,110,21,172,0.271523178807947,0.877906976744186,0.1593132606079972,0.8544510710619101
5,17,4,26,0.22727272727272727,0.8461538461538461,0.14327047985933405,0.8465866463300156
9,19,98,126,0.32142857142857145,0.2222222222222222,0.1709164219571034,0.7624297131164786
5,44,3,52,0.10204081632653061,0.9423076923076923,0.18549368143232206,0.772045097731863
10,169,28,207,0.055865921787709494,0.8647342995169082,0.19347452740199486,0.7731295894995848
19,145,3,167,0.11585365853658537,0.9820359281437125,0.1794128051521193,0.788420436377258
26,116,8,150,0.18309859154929578,0.9466666666666667,0.18244049510133845,0.8117182331078904
39,76,2,117,0.3391304347826087,0.9829059829059829,0.1920986745262901,0.8267180911310044
52,166,7,225,0.23853211009174313,0.9688888888888889,0.19370715778614953,0.8442516686645819
24,76,1,101,0.24,0.9900990099009901,0.182074504724925,0.9539483526186915
6,49,5,60,0.10909090909090909,0.9166666666666666,0.18308166083412195,0.9502853489556878
2,25,12,39,0.07407407407407407,0.6923076923076923,0.18568282544645973,0.9256529764972284
6,146,12,164,0.039473684210526314,0.926829268292683,0.17477140054273702,0.9177663108042242
16,98,26,140,0.14035087719298245,0.8142857142857143,0.16866458420612082,0.8988547461783739
33,83,25,141,0.28448275862068967,0.8226950354609929,0.1608577733258467,0.8759674679719467
10,97,2,109,0.09345794392523364,0.981651376146789,0.14013289244491672,0.877790680437361
11,54,1,66,0.16923076923076924,0.9848484848484849,0.13002300233502664,0.8770406054298603
10,111,12,133,0.08264462809917356,0.9097744360902256,0.12624496219335013,0.8760560010617973
12,37,1,50,0.24489795918367346,0.98,0.15064837435186432,0.9171549021606984
23,75,1,99,0.23469387755102042,0.98989898989899,0.17853697340050637,0.9261648623901708
10,16,4,30,0.38461538461538464,0.8666666666666667,0.21343190303227808,0.9336478555874497
8,76,12,96,0.09523809523809523,0.875,0.18639695112047885,0.9411199933787364
23,32,1,56,0.41818181818181815,0.9821428571428571,0.23278607601427664,0.9411902049496034
0,5,57,62,0.0,0.08064516129032258,0.2086102518384525,0.8120183015841516
10,188,10,208,0.050505050505050504,0.9519230769230769,0.20401888361072062,0.8180395359888447
41,178,16,235,0.1872146118721461,0.9319148936170213,0.19577840542335959,0.8111702350769906
38,101,13,152,0.2733812949640288,0.9144736842105263,0.20130517933950362,0.80039519140721
4,54,7,65,0.06896551724137931,0.8923076923076924,0.15621234114321716,0.8040581950702137
34,187,6,227,0.15384615384615385,0.973568281938326,0.16458492094436838,0.8181393782042603
0,8,57,65,0.0,0.12307692307692308,0.10484466120410864,0.6954156733376982
6,7,2,15,0.46153846153846156,0.8666666666666667,0.17077872713817457,0.8077044598200331
29,54,5,88,0.3493975903614458,0.9431818181818182,0.21347766140337393,0.8064557085712819
2,60,3,65,0.03225806451612903,0.9538461538461539,0.19134101178108573,0.8095887457468722
43,97,3,143,0.30714285714285716,0.9790209790209791,0.19616409209234695,0.8188097878626512
14,109,474,597,0.11382113821138211,0.20603015075376885,0.20257203794520448,0.7207701390692336
1,49,9,59,0.02,0.847457627118644,0.18345115882432536,0.7027543312378504
20,67,20,107,0.22988505747126436,0.8130841121495327,0.2162918813202203,0.8013267868196519
2,0,0,2,1.0,1.0,0.2932149582432972,0.8203744058672708
7,9,1,17,0.4375,0.9411764705882353,0.3058010167630906,0.820087927639616
18,83,4,105,0.1782178217821782,0.9619047619047619,0.3266524106582405,0.8212391573622744
38,87,24,149,0.304,0.8389261744966443,0.3262034310664038,0.8012256138587981
22,37,4,63,0.3728813559322034,0.9365079365079365,0.3632120335979497,0.9055795832522505
11,18,2,31,0.3793103448275862,0.9354838709677419,0.41454208285903343,0.9181547609449788
7,16,1,24,0.30434782608695654,0.9583333333333334,0.43257579687219694,0.9408221952272283
36,57,24,117,0.3870967741935484,0.7948717948717948,0.34501819318556093,0.911518165923199
17,93,2,112,0.15454545454545454,0.9821428571428571,0.304596115263483,0.9173705068595737
0,1,0,1,0.0,1.0,0.27772199928045616,0.9228126837303219
33,86,3,122,0.2773109243697479,0.9754098360655737,0.26784403234565074,0.9403928041270337
136,238,42,416,0.36363636363636365,0.8990384615384616,0.2616807041484242,0.9350400219885374
12,74,20,106,0.13953488372093023,0.8113207547169812,0.23235317522185758,0.9173024339527144
0,35,5,40,0.0,0.875,0.18887491435229237,0.9053976720479524
0,12,2,14,0.0,0.8571428571428571,0.13357537518178547,0.9142935380866756
2,12,2,16,0.14285714285714285,0.875,0.1319056163691695,0.898987415637696
35,175,58,268,0.16666666666666666,0.7835820895522388,0.15571514017869334,0.868070571288016
39,112,21,172,0.2582781456953642,0.877906976744186,0.15299617179663852,0.8541415913849606
5,17,4,26,0.22727272727272727,0.8461538461538461,0.13351565231611903,0.8465866463300155
10,19,97,126,0.3448275862068966,0.23015873015873015,0.16284318124268563,0.7635634999645511
6,43,3,52,0.12244897959183673,0.9423076923076923,0.18033589261294805,0.7731788845799356
11,168,28,207,0.061452513966480445,0.8647342995169082,0.18911482317958808,0.7742633763476573
20,144,3,167,0.12195121951219512,0.9820359281437125,0.18612826270173843,0.7895542232253305
27,115,8,150,0.19014084507042253,0.9466666666666667,0.18948171675941783,0.8128520199559629
38,77,2,117,0.33043478260869563,0.9829059829059829,0.1997898077470366,0.8278518779790769
53,165,7,225,0.24311926605504589,0.9688888888888889,0.20205359900165357,0.8453854555126544
24,76,1,101,0.24,0.9900990099009901,0.18707822954352551,0.9539483526186915
5,50,5,60,0.09090909090909091,0.9166666666666666,0.18257253116027608,0.9502853489556878
3,24,12,39,0.1111111111111111,0.6923076923076923,0.1896666164666519,0.9256529764972284
6,154,4,164,0.0375,0.975609756097561,0.1776021565363383,0.9247349519192067
16,98,26,140,0.14035087719298245,0.8142857142857143,0.17048930398241827,0.9058233872933564
35,81,25,141,0.3017241379310345,0.8226950354609929,0.16638778331418097,0.8829361090869293
9,98,2,109,0.08411214953271028,0.981651376146789,0.1436724809538473,0.8847593215523436
11,54,1,66,0.16923076923076924,0.9848484848484849,0.13356259084395722,0.8840092465448428
9,112,12,133,0.0743801652892562,0.9097744360902256,0.13120131575540941,0.8830246421767799
11,38,1,50,0.22448979591836735,0.98,0.14739827072787456,0.924123543275681
24,74,1,99,0.24489795918367346,0.98989898989899,0.1770265506112565,0.9261648623901708
10,16,4,30,0.38461538461538464,0.8666666666666667,0.21192148024302823,0.9336478555874497
8,76,12,96,0.09523809523809523,0.875,0.18242347414403692,0.9411199933787364
24,31,1,56,0.43636363636363634,0.9821428571428571,0.23274511511988352,0.9411902049496034
0,4,58,62,0.0,0.06451612903225806,0.20856929094405932,0.8097141541187138
9,189,10,208,0.045454545454545456,0.9519230769230769,0.20443705953910066,0.8157353885234068
41,178,16,235,0.1872146118721461,0.9319148936170213,0.1991120332467833,0.8088660876115527
37,102,13,152,0.26618705035971224,0.9144736842105263,0.20215333198621743,0.7980910439417722
3,55,7,65,0.05172413793103448,0.8923076923076924,0.15459743960273883,0.801754047604776
37,184,6,227,0.167420814479638,0.973568281938326,0.16490925663724496,0.8158352307388225
0,8,57,65,0.0,0.12307692307692308,0.10257159429958261,0.6931115258722604
8,5,2,15,0.6153846153846154,0.8666666666666667,0.19048368221167053,0.807704459820033
29,54,5,88,0.3493975903614458,0.9431818181818182,0.2339041171983706,0.8064557085712819
2,60,3,65,0.03225806451612903,0.9538461538461539,0.2117674675760824,0.8095887457468722
40,100,3,143,0.2857142857142857,0.9790209790209791,0.2145570726267358,0.8188097878626512
14,110,473,597,0.11290322580645161,0.20770519262981574,0.22329694232322392,0.7210094307658117
1,49,9,59,0.02,0.847457627118644,0.20223682596898993,0.7029936229344286
22,65,20,107,0.25287356321839083,0.8130841121495327,0.2383616207144743,0.80156607851623
2,0,0,2,1.0,1.0,0.2933066756595292,0.820613697563849
7,9,1,17,0.4375,0.9411764705882353,0.3058927341793227,0.8203272193361943
19,82,4,105,0.18811881188118812,0.9619047619047619,0.328158555231474,0.8214784490588525
39,86,24,149,0.312,0.8389261744966443,0.3319136572722904,0.8014649055553761
23,36,4,63,0.3898305084745763,0.9365079365079365,0.37147469765345104,0.9055795832522505
11,18,2,31,0.3793103448275862,0.9354838709677419,0.4228047469145348,0.9181547609449788
6,17,1,24,0.2608695652173913,0.9583333333333334,0.4279506326258761,0.9408221952272283
35,59,23,117,0.3723404255319149,0.8034188034188035,0.33828497913043537,0.9127391671442003
18,92,2,112,0.16363636363636364,0.9821428571428571,0.29916160250705875,0.9185915080805749
0,1,0,1,0.0,1.0,0.2708730593670305,0.9240336849513231
32,87,3,122,0.2689075630252101,0.9754098360655737,0.26204433102530006,0.9416138053480351
130,242,44,416,0.34946236559139787,0.8942307692307693,0.25143483845845377,0.9355742100227254
11,75,20,106,0.12790697674418605,0.8113207547169812,0.22044617996378083,0.9178366219869024
0,35,5,40,0.0,0.875,0.18317909921843922,0.9059318600821405
0,12,2,14,0.0,0.8571428571428571,0.1299876098567371,0.9136067248998625
3,11,2,16,0.21428571428571427,0.875,0.1372232313780729,0.898300602450883
37,172,59,268,0.17703349282296652,0.7798507462686567,0.16251373035278238,0.8668507090606911
42,108,22,172,0.28,0.872093023255814,0.16409836420632382,0.8520911643735823
3,19,4,26,0.13636363636363635,0.8461538461538461,0.13365568860235788,0.8452230325054506
10,23,93,126,0.30303030303030304,0.2619047619047619,0.15867330664323173,0.7667350335322765
6,43,3,52,0.12244897959183673,0.9423076923076923,0.17616601801349413,0.776350418147661
11,168,28,207,0.061452513966480445,0.8647342995169082,0.1849449485801342,0.7774349099153826
22,142,3,167,0.13414634146341464,0.9820359281437125,0.17349646674837713,0.7927257567930558
30,111,8,149,0.2127659574468085,0.9463087248322147,0.1786011045517831,0.8165054680164213
41,74,2,117,0.3565217391304348,0.9829059829059829,0.18953278157041664,0.8323358908235884
53,165,7,225,0.24311926605504589,0.9688888888888889,0.2047835858120466,0.8498694683571657
25,75,1,101,0.25,0.9900990099009901,0.19720782823628902,0.9538972180709127
4,55,1,60,0.06779661016949153,0.9833333333333333,0.18940034689023968,0.9597580239317185
2,26,11,39,0.07142857142857142,0.717948717948718,0.1908254979562527,0.9387886551362629
6,154,4,164,0.0375,0.975609756097561,0.17701887774719344,0.9378706305582412
16,97,27,140,0.1415929203539823,0.8071428571428572,0.16685130101964682,0.9179897923169043
36,80,25,141,0.3103448275862069,0.8226950354609929,0.1602545993704714,0.8951025141104771
9,98,2,109,0.08411214953271028,0.981651376146789,0.13753929701013776,0.8969257265758915
12,53,1,66,0.18461538461538463,0.9848484848484849,0.12819863766947842,0.8961756515683907
9,112,12,133,0.0743801652892562,0.9097744360902256,0.12913914554373054,0.8856672376765182
14,35,1,50,0.2857142857142857,0.98,0.15975139044168968,0.9231031351124156
25,73,1,99,0.25510204081632654,0.98989898989899,0.19083739627259352,0.9251444542269055
9,17,4,30,0.34615384615384615,0.8666666666666667,0.22006038567257405,0.9336478555874497
7,77,12,96,0.08333333333333333,0.875,0.18763017220787784,0.9411199933787364
24,31,1,56,0.43636363636363634,0.9821428571428571,0.2379518131837244,0.9411902049496034
0,4,58,62,0.0,0.06451612903225806,0.21157818681009805,0.8097141541187138
11,187,10,208,0.05555555555555555,0.9519230769230769,0.20888895684814082,0.8157353885234068
40,180,15,235,0.18181818181818182,0.9361702127659575,0.19404665629155454,0.8094739903471151
43,103,6,152,0.2945205479452055,0.9605263157894737,0.1996778715956801,0.8052778940457556
3,55,7,65,0.05172413793103448,0.8923076923076924,0.157616484706707,0.8089408977087593
41,180,6,227,0.18552036199095023,0.973568281938326,0.1722146316577951,0.8230220808428059
0,9,56,65,0.0,0.13846153846153847,0.10987696932013279,0.702496178174046
8,5,2,15,0.6153846153846154,0.8666666666666667,0.1977890572322207,0.8170891121218187
30,53,5,88,0.3614457831325301,0.9431818181818182,0.2414876611717885,0.8158403608730674
2,60,3,65,0.03225806451612903,0.9538461538461539,0.22012193012863812,0.8183654953130954
42,98,3,143,0.3,0.9790209790209791,0.22090470899360876,0.8210075900604534
15,108,474,597,0.12195121951219512,0.20603015075376885,0.23093714921948885,0.7229679412670357
1,49,9,59,0.02,0.847457627118644,0.20729138322078167,0.7049521334356526
21,66,20,107,0.2413793103448276,0.8130841121495327,0.24177414184147134,0.8013267868196517
2,0,0,2,1.0,1.0,0.29671919678652625,0.8203744058672707
7,9,1,17,0.4375,0.9411764705882353,0.30758408491045053,0.820087927639616
19,82,4,105,0.18811881188118812,0.9619047619047619,0.32984990596260183,0.8212391573622744
44,83,22,149,0.3464566929133858,0.8523489932885906,0.3364865763787998,0.8031431594005047
24,35,4,63,0.4067796610169492,0.9365079365079365,0.37717635373662184,0.907497128793957
10,19,2,31,0.3448275862068966,0.9354838709677419,0.4235802946233213,0.9200723064866854
7,16,1,24,0.30434782608695654,0.9583333333333334,0.4420835038296193,0.9408221952272285
37,59,21,117,0.3854166666666667,0.8205128205128205,0.3542858847820002,0.9151811695862027
19,91,2,112,0.17272727272727273,0.9821428571428571,0.3075326380287535,0.9210335105225773
0,1,0,1,0.0,1.0,0.2778296677317238,0.9264756873933255
32,87,3,122,0.2689075630252101,0.9754098360655737,0.2690009393899934,0.9440558077900374
129,244,43,416,0.34584450402144773,0.8966346153846154,0.2602959169620646,0.9383596190581345
11,75,20,106,0.12790697674418605,0.8113207547169812,0.22930725846739167,0.9206220310223115
0,35,5,40,0.0,0.875,0.18582899759782645,0.9087172691175496
0,12,2,14,0.0,0.8571428571428571,0.13076947378830264,0.9139501314932691
3,11,2,16,0.21428571428571427,0.875,0.13670639401093715,0.8986440090442895
37,172,59,268,0.17703349282296652,0.7798507462686567,0.16199689298564665,0.8671941156540977
41,110,21,172,0.271523178807947,0.877906976744186,0.16237055238318052,0.8532651357510421
3,19,4,26,0.13636363636363635,0.8461538461538461,0.1324447141463503,0.8460535972895038
9,28,89,126,0.24324324324324326,0.29365079365079366,0.14892132364621563,0.7721007457086199
6,43,3,52,0.12244897959183673,0.9423076923076923,0.16641403501647803,0.7817161303240044
9,171,27,207,0.05,0.8695652173913043,0.17355689215933515,0.7834907532166397
22,142,3,167,0.13414634146341464,0.9820359281437125,0.16210841032757808,0.798781600094313
32,109,8,149,0.22695035460992907,0.9463087248322147,0.16923939058285845,0.8225613113176784
41,74,2,117,0.3565217391304348,0.9829059829059829,0.18138204205749955,0.8375611693407923
53,165,7,225,0.24311926605504589,0.9688888888888889,0.1966328462991295,0.8550947468743697
25,75,1,101,0.25,0.9900990099009901,0.19759809726438046,0.9545873491958263
4,51,5,60,0.07272727272727272,0.9166666666666666,0.19049499628372843,0.9509243455328227
3,24,12,39,0.1111111111111111,0.6923076923076923,0.19922515501388718,0.9256018419494497
6,154,4,164,0.0375,0.975609756097561,0.18541853480482798,0.924683817371428
17,97,26,140,0.14912280701754385,0.8142857142857143,0.1743003137202015,0.9058233872933564
35,81,25,141,0.3017241379310345,0.8226950354609929,0.16647208497743002,0.8829361090869293
9,98,2,109,0.08411214953271028,0.981651376146789,0.14375678261709632,0.8847593215523436
12,53,1,66,0.18461538461538463,0.9848484848484849,0.134416123276437,0.8840092465448429
9,112,12,133,0.0743801652892562,0.9097744360902256,0.1346522507852918,0.8830246421767799
13,36,1,50,0.2653061224489796,0.98,0.15668010954784445,0.9241235432756809
23,75,1,99,0.23469387755102042,0.98989898989899,0.18485066348370446,0.9261648623901708
9,17,4,30,0.34615384615384615,0.8666666666666667,0.21299795478889053,0.9336478555874497
9,75,12,96,0.10714285714285714,0.875,0.1852006289620081,0.9411199933787364
24,31,1,56,0.43636363636363634,0.9821428571428571,0.23552226993785466,0.9411902049496034
0,4,58,62,0.0,0.06451612903225806,0.20914864356422827,0.8097141541187138
9,189,10,208,0.045454545454545456,0.9519230769230769,0.2050164121592696,0.8157353885234068
41,179,15,235,0.18636363636363637,0.9361702127659575,0.19373891414707772,0.8094739903471151
42,107,3,152,0.28187919463087246,0.9802631578947368,0.2004796737299137,0.808097442917936
5,53,7,65,0.08620689655172414,0.8923076923076924,0.16334439521532484,0.8117604465809397
41,180,6,227,0.18552036199095023,0.973568281938326,0.17454118162219528,0.8258416297149863
0,10,55,65,0.0,0.15384615384615385,0.11220351928453295,0.7075135292440287
7,6,2,15,0.5384615384615384,0.8666666666666667,0.18912659620760985,0.8221064631918013
30,53,5,88,0.3614457831325301,0.9431818181818182,0.2342682015901791,0.8208577119430501
2,60,3,65,0.03225806451612903,0.9538461538461539,0.21225311989767803,0.8233828463830781
42,98,3,143,0.3,0.9790209790209791,0.214841806378982,0.8232053922582556
16,108,473,597,0.12903225806451613,0.20770519262981574,0.2209597151665237,0.7254050351614161
1,49,9,59,0.02,0.847457627118644,0.1973139491678165,0.707389227330033
22,65,20,107,0.25287356321839083,0.8130841121495327,0.23343874391330094,0.80156607851623
2,0,0,2,1.0,1.0,0.29937280984736686,0.8206136975638489
7,9,1,17,0.4375,0.9411764705882353,0.3102376979712912,0.8203272193361942
20,81,4,105,0.19801980198019803,0.9619047619047619,0.33391794618044385,0.8214784490588525
42,85,22,149,0.33070866141732286,0.8523489932885906,0.33830489781149,0.8033824510970826
25,34,4,63,0.423728813559322,0.9365079365079365,0.3804044057393194,0.9074971287939572
10,19,2,31,0.3448275862068966,0.9354838709677419,0.42680834662601885,0.9200723064866854
6,17,1,24,0.2608695652173913,0.9583333333333334,0.45239887299577813,0.9372999774622491
37,59,21,117,0.3854166666666667,0.8205128205128205,0.3646012539481592,0.9116589518212235
15,95,2,112,0.13636363636363635,0.9821428571428571,0.3126532020001072,0.917511292757598
0,1,0,1,0.0,1.0,0.2769389162858215,0.9234636737099791
33,86,3,122,0.2773109243697479,0.9754098360655737,0.2701567162263105,0.9434201809030202
130,247,38,415,0.3448275862068966,0.908433734939759,0.25888511231882116,0.9394095806789948
11,75,20,106,0.12790697674418605,0.8113207547169812,0.21895647936693244,0.9223076195301891
0,35,5,40,0.0,0.875,0.18168939862159078,0.9104028576254272
0,13,1,14,0.0,0.9285714285714286,0.12662987481206697,0.9258398016337999
3,12,1,16,0.2,0.9375,0.1357207839029761,0.9194622506133916
35,178,55,268,0.1643192488262911,0.7947761194029851,0.15919496230673194,0.8901445533852466
39,110,22,171,0.26174496644295303,0.8713450292397661,0.15697125403147555,0.8752781524101313
3,23,0,26,0.11538461538461539,1.0,0.12419368677114966,0.8883590474187371
14,43,69,126,0.24561403508771928,0.4523809523809524,0.14100898082022584,0.8370819327993045
6,43,3,52,0.12244897959183673,0.9423076923076923,0.15850169219048824,0.8466973174146891
11,169,27,207,0.06111111111111111,0.8695652173913043,0.16723185092064696,0.8382678586746714
22,142,3,167,0.13414634146341464,0.9820359281437125,0.15782418541542048,0.8446301341237731
33,108,8,149,0.23404255319148937,0.9463087248322147,0.16778465746759166,0.8662776491850916
42,73,2,117,0.3652173913043478,0.9829059829059829,0.18256643244779092,0.8822149282802655
53,165,7,225,0.24311926605504589,0.9688888888888889,0.20081423968642384,0.8777704838358211
25,75,1,101,0.25,0.9900990099009901,0.20144080610246395,0.9545873491958264
5,54,1,60,0.0847457627118644,0.9833333333333333,0.1960546322624679,0.9604481550566322
2,25,12,39,0.07407407407407407,0.6923076923076923,0.19790648411431971,0.935125651473259
6,154,4,164,0.0375,0.975609756097561,0.1840998639052605,0.9342076268952375
16,99,25,140,0.1391304347826087,0.8214285714285714,0.170540989846849,0.9163676049804312
35,81,25,141,0.3017241379310345,0.8226950354609929,0.1614705250792328,0.8934803267740042
8,99,2,109,0.07476635514018691,0.981651376146789,0.13742010923425294,0.8953035392394184
11,54,1,66,0.16923076923076924,0.9848484848484849,0.12588164769579138,0.8945534642319176
9,77,47,133,0.10465116279069768,0.6466165413533834,0.12872527627848188,0.8464510653776393
13,36,1,50,0.2653061224489796,0.98,0.1560441403320398,0.8875499664765403
23,75,1,99,0.23469387755102042,0.98989898989899,0.18421469426789988,0.8895912855910301
8,18,4,30,0.3076923076923077,0.8666666666666667,0.2082949618264283,0.8960538706250437
11,79,6,96,0.12222222222222222,0.9375,0.1826518310108837,0.9124545798449019
25,30,1,56,0.45454545454545453,0.9821428571428571,0.23690598806877908,0.9125247914157687
0,4,58,62,0.0,0.06451612903225806,0.21273016389295488,0.7810487405848792
13,185,10,208,0.06565656565656566,0.9519230769230769,0.20715950715950743,0.8246639599519783
42,180,13,235,0.1891891891891892,0.9446808510638298,0.19628565955096594,0.8196183672468111
43,105,4,152,0.2905405405405405,0.9736842105263158,0.20426375426375457,0.817301970193572
5,54,6,65,0.0847457627118644,0.9076923076923077,0.17241424783797693,0.8231627760543778
40,181,6,227,0.18099547511312217,0.973568281938326,0.1808104268223912,0.8283153877598529
8,56,1,65,0.125,0.9846153846153847,0.13373250474446913,0.8286686059702141
7,6,2,15,0.5384615384615384,0.8666666666666667,0.21065558166754603,0.9432615399179867
30,53,5,88,0.3614457831325301,0.9431818181818182,0.2529111841641124,0.9420127886692354
2,60,3,65,0.03225806451612903,0.9538461538461539,0.23049245206796096,0.9433221176381389
43,97,3,143,0.30714285714285716,0.9790209790209791,0.2328642115825776,0.9440845131373765
16,109,472,597,0.128,0.20938023450586266,0.23904338833802558,0.8443256455393129
1,49,9,59,0.02,0.847457627118644,0.21604403475043668,0.8263098377079298
18,69,20,107,0.20689655172413793,0.8130841121495327,0.22774354213959924,0.801805370212808
2,0,0,2,1.0,1.0,0.2936776080736652,0.820852989260427
8,8,1,17,0.5,0.9411764705882353,0.3134710676261609,0.8205665110327723
21,80,4,105,0.2079207920792079,0.9619047619047619,0.33856574299231507,0.8217177407554307
42,85,22,149,0.33070866141732286,0.8523489932885906,0.3419322864600958,0.8036217427936609
24,35,4,63,0.4067796610169492,0.9365079365079365,0.3817579523196599,0.9074971287939572
10,19,2,31,0.3448275862068966,0.9354838709677419,0.4281618932063595,0.9200723064866854
6,15,1,22,0.2857142857142857,0.9545454545454546,0.46250797051810194,0.9370894066782378
38,56,20,114,0.40425531914893614,0.8245614035087719,0.3774015875393784,0.9120267500366338
17,77,2,96,0.18085106382978725,0.9791666666666666,0.3318088823722052,0.917453920904981
0,1,0,1,0.0,1.0,0.2976473916889754,0.9234063018573619
32,74,3,109,0.3018867924528302,0.9724770642201835,0.29155438844994397,0.9426132868868047
129,205,45,379,0.38622754491017963,0.8812664907651715,0.2861970643572093,0.9347216517806954
12,65,20,97,0.15584415584415584,0.7938144329896907,0.24496845170002524,0.915118787527991
0,28,5,33,0.0,0.8484848484848485,0.204152125169413,0.899967272376476
0,12,2,14,0.0,0.8571428571428571,0.14640136529099354,0.9046217657527738
1,8,2,11,0.1111111111111111,0.8181818181818182,0.13643851490261125,0.8816239302549383
40,141,59,240,0.22099447513812154,0.7541666666666667,0.1680091542080572,0.8465048826358909
36,99,22,157,0.26666666666666666,0.8598726114649682,0.1629777076671767,0.8304185322422886
3,18,4,25,0.14285714285714285,0.84,0.1282105073738857,0.8245233192758354
10,22,90,122,0.3125,0.26229508196721313,0.15058991368186345,0.7485919834154816
4,43,3,50,0.0851063829787234,0.94,0.16274796839310965,0.7616655764890746
9,151,27,187,0.05625,0.8556149732620321,0.17078368267882396,0.7614473073632425
20,111,3,134,0.15267175572519084,0.9776119402985075,0.1767209176236925,0.7842230390941981
32,105,7,144,0.23357664233576642,0.9513888888888888,0.17851837008049887,0.8123976422688013
42,62,2,106,0.40384615384615385,0.9811320754716981,0.19811543967756848,0.8297204228411913
53,165,7,225,0.24311926605504589,0.9688888888888889,0.2124386001344118,0.8481331212538896
18,64,1,83,0.21951219512195122,0.9879518072289156,0.19915462800897624,0.951798367719847
5,43,5,53,0.10416666666666667,0.9056603773584906,0.20187752567868242,0.9468927073424888
2,23,11,36,0.08,0.6944444444444444,0.20527038282153956,0.9238683460828333
6,149,4,159,0.03870967741935484,0.9748427672955975,0.18899008592070585,0.9234727499395604
16,89,26,131,0.1523809523809524,0.8015267175572519,0.17739070164144669,0.9020638683207551
32,67,26,125,0.32323232323232326,0.792,0.1658744401251852,0.8750450003962269
11,89,2,102,0.11,0.9803921568627451,0.14685740211732148,0.8766883243924921
11,52,1,64,0.1746031746031746,0.984375,0.14044182775749628,0.8761773519312184
9,99,12,120,0.08333333333333333,0.9,0.13746563728130576,0.8753687265942911
14,32,1,47,0.30434782608695654,0.9787234042553191,0.16951532672229958,0.9159800065672733
22,73,1,96,0.23157894736842105,0.9895833333333334,0.19706807957216615,0.9180858017155211
8,17,4,29,0.32,0.8620689655172413,0.2210136578034587,0.926734694281234
9,60,11,80,0.13043478260869565,0.8625,0.1934711520000833,0.9368061228526626
24,28,1,53,0.46153846153846156,0.9811320754716981,0.24369093221986352,0.9369118255110844
0,2,58,60,0.0,0.03333333333333333,0.21874762156226718,0.8010487302729892
9,161,10,180,0.052941176470588235,0.9444444444444444,0.2144058848675893,0.8073979366221956
40,144,15,199,0.21739130434782608,0.9246231155778895,0.2019835246191421,0.7996693239539913
42,93,3,138,0.3111111111111111,0.9782608695652174,0.21334526229666922,0.7980518291299747
5,51,7,63,0.08928571428571429,0.8888888888888888,0.18038607862319986,0.8018832467544958
41,164,6,211,0.2,0.9715639810426541,0.19032396682195762,0.817463815474875
0,10,55,65,0.0,0.15384615384615385,0.12438990088789167,0.6992801123855115
7,5,2,14,0.5833333333333334,0.8571428571428571,0.20772323422122502,0.8169671872154435
29,42,5,76,0.4084507042253521,0.9342105263157895,0.2585103096147627,0.8155051989113499
1,60,3,64,0.01639344262295082,0.953125,0.22979632936835195,0.819576896685937
43,75,3,121,0.3644067796610169,0.9752066115702479,0.2374099963040528,0.8191405741152272
17,79,412,508,0.17708333333333334,0.1889763779527559,0.24995251331085552,0.7191530725529224
1,43,9,53,0.022727272727272728,0.8301886792452831,0.2246278379861802,0.6989566008675838
20,61,20,101,0.24691358024691357,0.801980198019802,0.25990120659288213,0.7915471786066764
2,0,0,2,1.0,1.0,0.31942501611669166,0.8119553418719825
8,8,1,17,0.5,0.9411764705882353,0.33250348694164134,0.8129504767680462
23,69,4,96,0.25,0.9583333333333334,0.36587585228121977,0.8136945243870938
38,79,23,140,0.3247863247863248,0.8357142857142857,0.3602157872991209,0.7937670492648135
25,34,4,63,0.423728813559322,0.9365079365079365,0.3954508559028335,0.9005572719155536
11,16,2,29,0.4074074074074074,0.9310344827586207,0.45040516085713855,0.9149638152746018
6,15,1,22,0.2857142857142857,0.9545454545454546,0.4509362600282741,0.9385169277877328
37,58,19,114,0.3894736842105263,0.8333333333333334,0.36371821491549217,0.9147074039782089
16,78,2,96,0.1702127659574468,0.9791666666666666,0.3166057529094131,0.9201345748465563
0,1,0,1,0.0,1.0,0.28690278261238344,0.9255767517173046
33,72,3,108,0.3142857142857143,0.9722222222222222,0.28531548102508186,0.9444656406061934
134,203,43,380,0.39762611275964393,0.8868421052631579,0.281586523767985,0.9373705218569394
11,66,20,97,0.14285714285714285,0.7938144329896907,0.24288138654068028,0.9171320307172177
0,28,5,33,0.0,0.8484848484848485,0.202065060010068,0.9019805155657025
0,12,2,14,0.0,0.8571428571428571,0.14642596226570712,0.9053818761099203
1,8,2,11,0.1111111111111111,0.8181818181818182,0.13798286871623058,0.882384040612085
39,142,59,240,0.2154696132596685,0.7541666666666667,0.16876424203904036,0.8472649929930373
36,99,22,157,0.26666666666666666,0.8598726114649682,0.16196152095060498,0.8312150485991437
3,18,4,25,0.14285714285714285,0.84,0.1255659538216763,0.8245233192758354
10,24,88,122,0.29411764705882354,0.2786885245901639,0.14717459727905924,0.7509339037901887
3,44,3,50,0.06382978723404255,0.94,0.1562931383124939,0.7640074968637819
9,152,27,188,0.055900621118012424,0.8563829787234043,0.1642789413293528,0.7638989428038601
20,111,3,134,0.15267175572519084,0.9776119402985075,0.17021617627422134,0.7866746745348155
32,105,7,144,0.23357664233576642,0.9513888888888888,0.1728028947136639,0.8148492777094188
39,65,2,106,0.375,0.9811320754716981,0.18827908518985437,0.8321720582818088
53,165,7,225,0.24311926605504589,0.9688888888888889,0.20260224564669765,0.8505847566945072
17,65,1,83,0.2073170731707317,0.9879518072289156,0.19020216366268455,0.9519080827857574
5,47,1,53,0.09615384615384616,0.9811320754716981,0.19481988636551364,0.9577840935674287
2,23,11,36,0.08,0.6944444444444444,0.19826265477722615,0.9346500172418628
6,148,4,158,0.03896103896103896,0.9746835443037974,0.1820182666680616,0.9342316749569044
16,89,26,131,0.1523809523809524,0.8015267175572519,0.17041888238880246,0.9128227933380991
32,67,26,125,0.32323232323232326,0.792,0.16302349999342006,0.8858039254135708
11,89,2,102,0.11,0.9803921568627451,0.14400646198555636,0.887447249409836
11,52,1,64,0.1746031746031746,0.984375,0.13933304790447676,0.8869362769485623
10,98,12,120,0.09259259259259259,0.9,0.13882429739572627,0.8753459804526054
12,34,1,47,0.2608695652173913,0.9787234042553191,0.16466280671249642,0.9159572604255874
22,73,1,96,0.23157894736842105,0.9895833333333334,0.19217965077069388,0.9180858017155212
9,16,4,29,0.36,0.8620689655172413,0.2218395147162721,0.926734694281234
8,60,12,80,0.11764705882352941,0.85,0.19247019122930156,0.9350204085669482
24,27,1,52,0.47058823529411764,0.9807692307692307,0.24398279627131836,0.9350742762678748
0,2,58,60,0.0,0.03333333333333333,0.21903948561372197,0.7992111810297795
9,160,10,179,0.05325443786982249,0.9441340782122905,0.21341974922475485,0.805516049345821
40,145,14,199,0.21621621621621623,0.9296482412060302,0.20704069936744413,0.7985053117673512
41,92,5,138,0.3082706766917293,0.9637681159420289,0.2179966606993453,0.7948174235685934
7,49,7,63,0.125,0.8888888888888888,0.1844252321279167,0.7986488411931144
38,165,6,209,0.18719211822660098,0.9712918660287081,0.19436024061406978,0.815976250625787
0,11,54,65,0.0,0.16923076923076924,0.12713334985776728,0.7000421846917212
7,5,2,14,0.5833333333333334,0.8571428571428571,0.21046668319110062,0.8177292595216531
29,42,5,76,0.4084507042253521,0.9342105263157895,0.26120900695617627,0.8163116092507243
1,60,3,64,0.01639344262295082,0.953125,0.23266289644285262,0.8196654319355773
44,75,3,122,0.3697478991596639,0.9754098360655737,0.24144535679541473,0.8213285348103694
17,78,413,508,0.17894736842105263,0.18700787401574803,0.24915212371270798,0.7210598183999207
1,43,9,53,0.022727272727272728,0.8301886792452831,0.22565714578423252,0.7009022202880029
21,60,20,101,0.25925925925925924,0.801980198019802,0.26269418282126955,0.7912949958292932
2,0,0,2,1.0,1.0,0.3222179923450791,0.8117031590945994
8,8,1,17,0.5,0.9411764705882353,0.33529646317002876,0.8126982939906631
22,70,4,96,0.2391304347826087,0.9583333333333334,0.3671160334785513,0.8134423416097107
41,78,23,142,0.3445378151260504,0.8380281690140845,0.3635145929023208,0.7938163891737836
25,34,4,63,0.423728813559322,0.9365079365079365,0.3984833707792165,0.9008878266726678
12,15,2,29,0.4444444444444444,0.9310344827586207,0.4587286810245267,0.9152943700317159
6,17,1,24,0.2608695652173913,0.9583333333333334,0.37279804850631365,0.9400104342812393
38,58,21,117,0.3958333333333333,0.8205128205128205,0.3579170961253612,0.9143694086402135
16,93,2,111,0.14678899082568808,0.9819819819819819,0.30745838052903096,0.9201987674107489
0,1,0,1,0.0,1.0,0.2791698373890027,0.9256409442814971
33,89,3,125,0.27049180327868855,0.976,0.27056742908348347,0.9441171347576877
135,236,43,414,0.3638814016172507,0.8961352657004831,0.25959649129999146,0.9383496103566228
13,73,20,106,0.1511627906976744,0.8113207547169812,0.2270039835671469,0.9206120223207999
0,35,5,40,0.0,0.875,0.18973690282180528,0.9087072604160379
0,12,2,14,0.0,0.8571428571428571,0.13318928377418623,0.9139401227917575
0,14,2,16,0.0,0.875,0.11221942794194509,0.8986569825086173
42,167,59,268,0.20095693779904306,0.7798507462686567,0.14092756191323694,0.8672070891184253
37,113,21,171,0.24666666666666667,0.8771929824561403,0.1375239709686624,0.853091800897874
4,18,4,26,0.18181818181818182,0.8461538461538461,0.11151493956879542,0.8459515981054972
9,24,93,126,0.2727272727272727,0.2619047619047619,0.12888129414445232,0.7674635991323232
4,46,3,53,0.08,0.9433962264150944,0.14030986557302375,0.7772344886201935
12,166,28,206,0.06741573033707865,0.8640776699029126,0.1499406841926064,0.7782251761573444
21,144,3,168,0.12727272727272726,0.9821428571428571,0.1681225023744246,0.793531298606324
31,110,7,148,0.2198581560283688,0.9527027027027027,0.1708226764071854,0.8182244352397593
45,70,2,117,0.391304347826087,0.9829059829059829,0.19148520228710258,0.8333262924468795
53,165,7,225,0.24311926605504589,0.9688888888888889,0.200242500035226,0.850859869980457
24,76,1,101,0.24,0.9900990099009901,0.19556717535990134,0.9548876196942039
6,49,5,60,0.10909090909090909,0.9166666666666666,0.19972301951574553,0.9510691111587144
1,29,9,39,0.03333333333333333,0.7692307692307693,0.19485410565806763,0.9375195539198368
6,154,4,164,0.0375,0.975609756097561,0.18202943033339228,0.9365862537705086
16,98,26,140,0.14035087719298245,0.8142857142857143,0.17067124764262281,0.9168123982823674
36,80,25,141,0.3103448275862069,0.8226950354609929,0.1591056018940685,0.8939251200759404
12,95,2,109,0.11214953271028037,0.981651376146789,0.14039563998767343,0.8957483325413546
11,54,1,66,0.16923076923076924,0.9848484848484849,0.13028574987778335,0.8949982575338539
8,113,12,133,0.06611570247933884,0.9097744360902256,0.12414643464755902,0.8940136531657908
13,36,1,50,0.2653061224489796,0.98,0.15728540452122278,0.9241235432756809
22,76,1,99,0.22448979591836735,0.98989898989899,0.18399823250956096,0.9261648623901708
9,17,4,30,0.34615384615384615,0.8666666666666667,0.2133986566468272,0.9336478555874497
11,73,12,96,0.13095238095238096,0.875,0.18777116427056637,0.9411199933787364
21,33,2,56,0.3888888888888889,0.9642857142857143,0.22730535801036758,0.93863918454144
0,4,58,62,0.0,0.06451612903225806,0.2031295338345434,0.8071631337105505
12,186,10,208,0.06060606060606061,0.9519230769230769,0.20234244213836078,0.8131843681152435
43,178,14,235,0.19457013574660634,0.9404255319148936,0.1922373011808789,0.8075308726745141
39,99,14,152,0.2826086956521739,0.9078947368421053,0.20054000114285125,0.7958159793806734
7,51,7,65,0.1206896551724138,0.8923076923076924,0.16833083100264662,0.7994789830436771
37,184,6,227,0.167420814479638,0.973568281938326,0.17354060722082623,0.8135601661777238
1,8,57,66,0.1111111111111111,0.13636363636363635,0.13385806753828652,0.6952855836174268
7,6,2,15,0.5384615384615384,0.8666666666666667,0.21078114446136345,0.8098785175651996
30,53,5,88,0.3614457831325301,0.9431818181818182,0.25375824767943056,0.8086297663164483
2,60,3,65,0.03225806451612903,0.9538461538461539,0.2305708089322195,0.810546998020914
45,95,3,143,0.32142857142857145,0.9790209790209791,0.23611650547170485,0.820707889760753
17,109,472,598,0.1349206349206349,0.21070234113712374,0.23814950257859357,0.7233356967363862
1,49,9,59,0.02,0.847457627118644,0.21708938622435955,0.7053198889050031
22,65,20,107,0.25287356321839083,0.8130841121495327,0.23734116509682815,0.8019942425887026
2,0,0,2,1.0,1.0,0.30327523103089404,0.8210418616363215
8,8,1,17,0.5,0.9411764705882353,0.3230686905833897,0.8207553834086668
21,80,4,105,0.2079207920792079,0.9619047619047619,0.3481633659495439,0.8219066131313252
41,85,24,150,0.3253968253968254,0.84,0.34873025937358015,0.8020464732711853
25,34,4,63,0.423728813559322,0.9365079365079365,0.3899885706076783,0.905732986895587
12,17,2,31,0.41379310344827586,0.9354838709677419,0.44624472824314626,0.9183081645883153
8,15,1,24,0.34782608695652173,0.9583333333333334,0.4603966194877632,0.9400104342812393
38,60,19,117,0.3877551020408163,0.8376068376068376,0.37293306263645126,0.9168114110822161
20,89,2,111,0.1834862385321101,0.9819819819819819,0.3277168109981813,0.9226407698527513
0,1,0,1,0.0,1.0,0.29801384070115156,0.9280829467234996
31,91,3,125,0.2540983606557377,0.976,0.2848197932357733,0.9465591371996901
132,234,48,414,0.36065573770491804,0.8840579710144928,0.27823066133405455,0.9390662849863409
13,73,20,106,0.1511627906976744,0.8113207547169812,0.2407120452268258,0.9213286969505179
0,35,5,40,0.0,0.875,0.19102260423303694,0.909423935045756
0,12,2,14,0.0,0.8571428571428571,0.13562901822720605,0.9122147949794732
0,14,2,16,0.0,0.875,0.10941669843690459,0.8969316546963328
43,166,59,268,0.20574162679425836,0.7798507462686567,0.13880835940751293,0.865481761306141
37,113,21,171,0.24666666666666667,0.8771929824561403,0.13774668883764565,0.8513664730855897
4,18,4,26,0.18181818181818182,0.8461538461538461,0.11219846656811192,0.8459515981054971
10,25,91,126,0.2857142857142857,0.2777777777777778,0.13142010871334206,0.7697311728284681
5,45,3,53,0.1,0.9433962264150944,0.14570582299905638,0.7795020623163388
15,164,28,207,0.08379888268156424,0.8647342995169082,0.15767709195356552,0.7805865540840603
22,143,3,168,0.13333333333333333,0.9821428571428571,0.17672471100118461,0.79589267653304
31,109,8,148,0.22142857142857142,0.9459459459459459,0.17896570309180074,0.819620562201224
46,69,2,117,0.4,0.9829059829059829,0.20087046499656264,0.8347224194083445
52,166,7,225,0.23853211009174313,0.9688888888888889,0.20897245474992854,0.8522559969419221
24,76,1,101,0.24,0.9900990099009901,0.20244184250503058,0.9540161729595239
4,51,5,60,0.07272727272727272,0.9166666666666666,0.1985457386089267,0.9501976644240341
1,29,9,39,0.03333333333333333,0.7692307692307693,0.19133637441632226,0.9365543029545856
6,154,4,164,0.0375,0.975609756097561,0.17764589822584606,0.9356210028052576
17,97,26,140,0.14912280701754385,0.8142857142857143,0.16731650330998502,0.9168123982823675
36,80,25,141,0.3103448275862069,0.8226950354609929,0.154508621536586,0.8939251200759404
12,95,2,109,0.11214953271028037,0.981651376146789,0.13645396762494846,0.8957483325413546
10,55,1,66,0.15384615384615385,0.9848484848484849,0.12414627531725615,0.8949982575338539
10,111,12,133,0.08264462809917356,0.9097744360902256,0.12556304037038485,0.894013653165791
12,37,1,50,0.24489795918367346,0.98,0.15578655834900484,0.9241235432756809
21,77,1,99,0.21428571428571427,0.98989898989899,0.18104166038982114,0.9261648623901707
9,17,4,30,0.34615384615384615,0.8666666666666667,0.20918895169500723,0.9336478555874497
10,75,11,96,0.11764705882352941,0.8854166666666666,0.18166069901462473,0.9426080886168317
22,32,2,56,0.4074074074074074,0.9642857142857143,0.2238403953999286,0.9401272797795353
0,4,58,62,0.0,0.06451612903225806,0.20186237342190663,0.8086512289486457
10,188,10,208,0.050505050505050504,0.9519230769230769,0.19727100519417476,0.8146724633533389
44,176,15,235,0.2,0.9361702127659575,0.19085701102507852,0.8084110651770471
37,101,14,152,0.26811594202898553,0.9078947368421053,0.19854704355983158,0.7966961718832064
7,51,7,65,0.1206896551724138,0.8923076923076924,0.16633787341962694,0.8003591755462099
39,182,6,227,0.17647058823529413,0.973568281938326,0.17474123476416475,0.8129522634421614
1,8,57,66,0.1111111111111111,0.13636363636363635,0.13241319243612243,0.6946776808818645
6,7,2,15,0.46153846153846156,0.8666666666666667,0.19834725837018838,0.8092706148296372
30,53,5,88,0.3614457831325301,0.9431818181818182,0.24276736303125687,0.8080218635808859
2,60,3,65,0.03225806451612903,0.9538461538461539,0.2188042293907039,0.810546998020914
44,96,3,143,0.3142857142857143,0.9790209790209791,0.22539991114166516,0.820707889760753
17,108,473,598,0.136,0.20903010033444816,0.22758710325989176,0.7230968051931468
1,49,9,59,0.02,0.847457627118644,0.20523416208342113,0.7050809973617637
22,65,20,107,0.25287356321839083,0.8130841121495327,0.22548594095588967,0.801755351045463
1,1,0,2,0.5,1.0,0.2309804464503952,0.8208029700930821
8,8,1,17,0.5,0.9411764705882353,0.2507739060028909,0.8205164918654274
20,81,4,105,0.19801980198019803,0.9619047619047619,0.2744541542120436,0.8216677215880858
42,85,23,150,0.33070866141732286,0.8466666666666667,0.2768002895165591,0.8027599626803268
26,33,4,63,0.4406779661016949,0.9365079365079365,0.3203257132453727,0.9066853678479682
11,18,2,31,0.3793103448275862,0.9354838709677419,0.3716557625064564,0.9192605455406964
7,16,1,24,0.30434782608695654,0.9583333333333334,0.38485412199534963,0.9400104342812393
38,60,19,117,0.3877551020408163,0.8376068376068376,0.36881913657260906,0.9168114110822161
20,89,2,111,0.1834862385321101,0.9819819819819819,0.32360288493433903,0.9226407698527513
0,1,0,1,0.0,1.0,0.29672876895131217,0.9280829467234996
32,90,3,125,0.26229508196721313,0.976,0.2847056816732875,0.9465591371996901
125,243,46,414,0.33967391304347827,0.8888888888888888,0.275119146248506,0.9397564161112547
14,72,20,106,0.16279069767441862,0.8113207547169812,0.2343355513349993,0.9220188280754317
0,35,5,40,0.0,0.875,0.19085729046543407,0.9101140661706698
0,12,2,14,0.0,0.8571428571428571,0.13546370445960315,0.9129049261043869
1,13,2,16,0.07142857142857142,0.875,0.11945546630195478,0.8976217858212466
40,169,59,268,0.19138755980861244,0.7798507462686567,0.1467965462746137,0.8661718924310547
40,109,22,171,0.2684563758389262,0.8713450292397661,0.14767673111342985,0.8512211823224499
3,19,4,26,0.13636363636363635,0.8461538461538461,0.11863240587345243,0.8451161762174438
10,25,91,126,0.2857142857142857,0.2777777777777778,0.1361929184505763,0.7688957509404147
5,45,3,53,0.1,0.9433962264150944,0.15047863273629059,0.7786666404282853
10,169,28,207,0.055865921787709494,0.8647342995169082,0.15845947870596339,0.7797511321960069
25,140,3,168,0.15151515151515152,0.9821428571428571,0.16990041871833197,0.7950572546449864
29,111,8,148,0.20714285714285716,0.9459459459459459,0.1721511754803669,0.8187851403131707
42,73,2,117,0.3652173913043478,0.9829059829059829,0.18597417768971286,0.8347224194083446
52,166,7,225,0.23853211009174313,0.9688888888888889,0.20056967393658523,0.852255996941922
24,76,1,101,0.24,0.9900990099009901,0.19403906169168733,0.9540161729595237
4,51,5,60,0.07272727272727272,0.9166666666666666,0.19014295779558338,0.9501976644240342
1,29,9,39,0.03333333333333333,0.7692307692307693,0.1869240165878154,0.9365543029545857
6,154,4,164,0.0375,0.975609756097561,0.1706361377999366,0.9356210028052577
17,97,26,140,0.14912280701754385,0.8142857142857143,0.16234755921060612,0.9168123982823674
37,79,25,141,0.31896551724137934,0.8226950354609929,0.15574014863018207,0.8939251200759403
13,94,2,109,0.12149532710280374,0.981651376146789,0.1390206082031907,0.8957483325413547
12,53,1,66,0.18461538461538463,0.9848484848484849,0.13110852029110281,0.8949982575338539
10,111,12,133,0.08264462809917356,0.9097744360902256,0.1325252853442315,0.8940136531657908
12,37,1,50,0.24489795918367346,0.98,0.16274880332285152,0.9241235432756809
22,76,1,99,0.22448979591836735,0.98989898989899,0.18946163131118968,0.9261648623901708
10,16,4,30,0.38461538461538464,0.8666666666666667,0.22310342811088127,0.9336478555874497
10,75,11,96,0.11764705882352941,0.8854166666666666,0.19434364833690268,0.9426080886168318
22,33,1,56,0.4,0.9821428571428571,0.23413003017935932,0.9426783001876985
0,4,58,62,0.0,0.06451612903225806,0.20775640380573293,0.811202249356809
12,186,10,208,0.06060606060606061,0.9519230769230769,0.20460803702100247,0.817223483761502
44,176,15,235,0.2,0.9361702127659575,0.1981940428519063,0.8109620855852102
45,102,5,152,0.30612244897959184,0.9671052631578947,0.20985585043208124,0.8077058389079108
8,50,7,65,0.13793103448275862,0.8923076923076924,0.17461522898456322,0.8113688425709146
36,185,6,227,0.16289592760180996,0.973568281938326,0.18107935309574616,0.8239619304668659
1,10,55,66,0.09090909090909091,0.16666666666666666,0.136923508939902,0.7074653318274102
7,6,2,15,0.5384615384615384,0.8666666666666667,0.21384658586297892,0.8220582657751828
30,53,5,88,0.3614457831325301,0.9431818181818182,0.25682368908104597,0.8208095145264317
2,60,3,65,0.03225806451612903,0.9538461538461539,0.23286055544049297,0.8233346489664596
41,99,3,143,0.29285714285714287,0.9790209790209791,0.23096551170871457,0.8250368940897576
24,117,457,598,0.1702127659574468,0.23578595317725753,0.23557718763367,0.731248074213981
0,50,9,59,0.0,0.847457627118644,0.21230634083341143,0.713232266382598
21,66,20,107,0.2413793103448276,0.8130841121495327,0.23380208646708808,0.8055776157372929
2,0,0,2,1.0,1.0,0.29973615240115403,0.824625234784912
8,8,1,17,0.5,0.9411764705882353,0.3195296119536497,0.8243387565572574
21,80,4,105,0.2079207920792079,0.9619047619047619,0.3446242873198039,0.8254899862799157
44,83,23,150,0.3464566929133858,0.8466666666666667,0.35228136589926723,0.8065822273721567
24,35,4,63,0.4067796610169492,0.9365079365079365,0.3860766366220532,0.9066853678479682
12,17,2,31,0.41379310344827586,0.9354838709677419,0.44518993711466404,0.9192605455406964
8,15,1,24,0.34782608695652173,0.9583333333333334,0.45811241502136496,0.9400104342812393
38,60,19,117,0.3877551020408163,0.8376068376068376,0.370648858170053,0.9168114110822161
22,87,2,111,0.2018348623853211,0.9819819819819819,0.32805383851081327,0.9226407698527513
0,1,0,1,0.0,1.0,0.29976529537078495,0.9280829467234996
33,89,3,125,0.27049180327868855,0.976,0.29228774645784167,0.9465591371996901
127,241,46,414,0.3451086956521739,0.8888888888888888,0.28589891605464135,0.9397564161112547
14,72,20,106,0.16279069767441862,0.8113207547169812,0.24511532114113457,0.9220188280754317
0,35,5,40,0.0,0.875,0.1954258801473458,0.9101140661706698
0,12,2,14,0.0,0.8571428571428571,0.14003229414151488,0.9129049261043869
1,13,2,16,0.07142857142857142,0.875,0.12140282400483636,0.8976217858212466
43,166,59,268,0.20574162679425836,0.7798507462686567,0.1507944849754447,0.8661718924310547
40,109,22,171,0.2684563758389262,0.8713450292397661,0.15050370962690723,0.8512211823224499
3,19,4,26,0.13636363636363635,0.8461538461538461,0.12068298687140186,0.8451161762174438
10,24,92,126,0.29411764705882354,0.2698412698412698,0.13944397964060254,0.7677619640923422
6,44,3,53,0.12,0.9433962264150944,0.1565868367834597,0.7775328535802127
10,169,28,207,0.055865921787709494,0.8647342995169082,0.16456768275313247,0.7786173453479343
21,144,3,168,0.12727272727272726,0.9821428571428571,0.17254541930229758,0.7939234677969138
32,108,8,148,0.22857142857142856,0.9459459459459459,0.17580681955617905,0.8176513534650981
42,73,2,117,0.3652173913043478,0.9829059829059829,0.189629821765525,0.833588632560272
52,166,7,225,0.23853211009174313,0.9688888888888889,0.2042253180123974,0.8511222100938494
24,76,1,101,0.24,0.9900990099009901,0.1964942255754226,0.9540161729595237
4,51,5,60,0.07272727272727272,0.9166666666666666,0.18974097882217583,0.9501976644240342
1,29,9,39,0.03333333333333333,0.7692307692307693,0.18652203761440783,0.9365543029545857
6,154,4,164,0.0375,0.975609756097561,0.1736973622897325,0.9356210028052577
16,97,27,140,0.1415929203539823,0.8071428571428572,0.16127186111581163,0.9157919901191021
36,81,24,141,0.3076923076923077,0.8297872340425532,0.1530539920283773,0.8939178831386121
13,94,2,109,0.12149532710280374,0.981651376146789,0.13633445160138596,0.8957410956040265
12,53,1,66,0.18461538461538463,0.9848484848484849,0.12842236368929807,0.8949910205965257
10,111,12,133,0.08264462809917356,0.9097744360902256,0.12983912874242676,0.8940064162284627
13,36,1,50,0.2653061224489796,0.98,0.1629780986160905,0.9241163063383527
22,76,1,99,0.22448979591836735,0.98989898989899,0.18969092660442868,0.9261576254528426
7,19,4,30,0.2692307692307692,0.8666666666666667,0.20792490501539826,0.9346610268133869
10,75,11,96,0.11764705882352941,0.8854166666666666,0.18077558374842992,0.9426080886168318
22,33,1,56,0.4,0.9821428571428571,0.22056196559088656,0.9426783001876985
0,4,58,62,0.0,0.06451612903225806,0.19418833921726014,0.811202249356809
11,187,10,208,0.05555555555555555,0.9519230769230769,0.19031847171102903,0.817223483761502
44,176,15,235,0.2,0.9361702127659575,0.1809890256468891,0.8109620855852102
42,106,4,152,0.28378378378378377,0.9736842105263158,0.1894595953419486,0.808645688531971
5,53,7,65,0.08620689655172414,0.8923076923076924,0.1633133278163707,0.8123086921949748
36,185,6,227,0.16289592760180996,0.973568281938326,0.16977745192755364,0.8249017800909261
1,9,56,66,0.1,0.15151515151515152,0.12692030907041077,0.7062406792869682
7,6,2,15,0.5384615384615384,0.8666666666666667,0.2038433859934877,0.8208336132347408
29,54,5,88,0.3493975903614458,0.9431818181818182,0.2458208195371863,0.8195848619859897
2,60,3,65,0.03225806451612903,0.9538461538461539,0.2218576858966333,0.8221099964260176
45,95,3,143,0.32142857142857145,0.9790209790209791,0.22723551270303158,0.8228723919252553
25,116,457,598,0.1773049645390071,0.23578595317725753,0.24024952241550054,0.7290835720494789
1,49,9,59,0.02,0.847457627118644,0.21983581847238484,0.7110677642180957
22,65,20,107,0.25287356321839083,0.8130841121495327,0.24167489893215494,0.805577615737293
1,1,0,2,0.5,1.0,0.23618039343764943,0.824625234784912
8,8,1,17,0.5,0.9411764705882353,0.25769502338601435,0.8243387565572574
19,82,4,105,0.18811881188118812,0.9619047619047619,0.27996084443816566,0.8254899862799157
44,83,23,150,0.3464566929133858,0.8466666666666667,0.2835362903645677,0.8065822273721567
24,35,4,63,0.4067796610169492,0.9365079365079365,0.3163183898614165,0.9066853678479679
13,16,2,31,0.4482758620689655,0.9354838709677419,0.3775006558712688,0.9192605455406964
8,15,1,24,0.34782608695652173,0.9583333333333334,0.4750503951683026,0.9373397806175537
38,62,17,117,0.38,0.8547008547008547,0.386478966596874,0.9165827598605331
21,88,2,111,0.1926605504587156,0.9819819819819819,0.3425733309481191,0.9224121186310682
0,1,0,1,0.0,1.0,0.30923999761478577,0.9284911459866915
30,92,3,125,0.2459016393442623,0.976,0.29352134560827603,0.9483655127546751
132,234,45,411,0.36065573770491804,0.8905109489051095,0.28693221370655725,0.9417945145257
15,71,20,106,0.1744186046511628,0.8113207547169812,0.24306608844508323,0.9246925533768943
0,35,5,40,0.0,0.875,0.1933766474512944,0.9127877914721323
0,13,1,14,0.0,0.9285714285714286,0.1390909331655801,0.9233407305965
2,13,1,16,0.13333333333333333,0.9375,0.13061561643338265,0.9169861617419313
42,167,59,268,0.20095693779904306,0.7798507462686567,0.1593237504046745,0.8855362683517394
39,109,22,170,0.2635135135135135,0.8705882352941177,0.16183973242885324,0.8704774448223275
4,22,0,26,0.15384615384615385,1.0,0.1322955061633155,0.8861187378358834
12,47,67,126,0.2033898305084746,0.46825396825396826,0.13643425271436005,0.8371091969125958
5,45,3,53,0.1,0.9433962264150944,0.15071996700007434,0.8468800864004665
10,169,27,206,0.055865921787709494,0.8689320388349514,0.1587008129697471,0.8383601735809697
22,143,3,168,0.13333333333333333,0.9821428571428571,0.15870081296974714,0.8447377246013777
35,105,8,148,0.25,0.9459459459459459,0.16570696471274096,0.8684656102695618
44,71,2,117,0.3826086956521739,0.9829059829059829,0.18272056216112104,0.8845110027855426
52,166,7,225,0.23853211009174313,0.9688888888888889,0.19481855591049094,0.8800665583410983
24,76,1,101,0.24,0.9900990099009901,0.200048580123566,0.9546158500049585
5,54,1,60,0.0847457627118644,0.9833333333333333,0.19786940336811804,0.9603211509932784
1,29,9,39,0.03333333333333333,0.7692307692307693,0.19465046216035004,0.9460781124783952
6,154,4,164,0.0375,0.975609756097561,0.1809599859698738,0.9451448123290672
16,98,26,140,0.14035087719298245,0.8142857142857143,0.16529582556887132,0.9263362078061769
36,79,26,141,0.3130434782608696,0.8156028368794326,0.15535793737011355,0.9024357583738126
10,97,2,109,0.09345794392523364,0.981651376146789,0.13463305648918364,0.9042589708392269
12,53,1,66,0.18461538461538463,0.9848484848484849,0.12672096857709572,0.9035088958317262
9,74,50,133,0.10843373493975904,0.6240601503759399,0.1301049646096521,0.8521841554092414
14,35,1,50,0.2857142857142857,0.98,0.1661593863783596,0.8822940455191315
23,75,1,99,0.23469387755102042,0.98989898989899,0.19432994031421963,0.8843353646336214
7,19,4,30,0.2692307692307692,0.8666666666666667,0.21274135346247489,0.8918183578309004
11,78,7,96,0.12359550561797752,0.9270833333333334,0.18567735737063318,0.9077441430386004
23,32,1,56,0.41818181818181815,0.9821428571428571,0.23206648226443097,0.9078143546094672
0,4,58,62,0.0,0.06451612903225806,0.20569285589080458,0.7763383037785777
12,186,10,208,0.06060606060606061,0.9519230769230769,0.1988603309859905,0.8231758647138829
44,178,13,235,0.1981981981981982,0.9446808510638298,0.18635803276940657,0.8181302720087159
45,104,3,152,0.30201342281879195,0.9802631578947368,0.1959751106648025,0.8167537245795368
7,51,7,65,0.1206896551724138,0.8923076923076924,0.1747549515136089,0.8204167282425405
35,186,6,227,0.1583710407239819,0.973568281938326,0.17972288510018095,0.827057435186111
10,54,2,66,0.15625,0.9696969696969697,0.1423040539313498,0.8252794512652698
7,6,2,15,0.5384615384615384,0.8666666666666667,0.21922713085442672,0.9398723852130424
30,53,5,88,0.3614457831325301,0.9431818181818182,0.26220423407249377,0.9386236339642913
2,60,3,65,0.03225806451612903,0.9538461538461539,0.23849850068934103,0.9399329629331946
47,92,3,142,0.3381294964028777,0.9788732394366197,0.24365793977278186,0.9397344031534638
19,122,456,597,0.1347517730496454,0.23618090452261306,0.24566681375524355,0.8460020048984523
1,49,9,59,0.02,0.847457627118644,0.2258995222232461,0.8279861970670692
22,65,20,107,0.25287356321839083,0.8130841121495327,0.23970288839730194,0.8056129317031496
2,0,0,2,1.0,1.0,0.3056369543313679,0.8246605507507686
8,8,1,17,0.5,0.9411764705882353,0.32543041388386357,0.824374072523114
20,81,4,105,0.19801980198019803,0.9619047619047619,0.34911066209301633,0.8255253022457723
41,86,23,150,0.3228346456692913,0.8466666666666667,0.34692568341678964,0.8066386489929218
23,36,4,63,0.3898305084745763,0.9365079365079365,0.38336550276320835,0.9066853678479682
13,16,2,31,0.4482758620689655,0.9354838709677419,0.4445477687730606,0.9192605455406964
8,13,1,22,0.38095238095238093,0.9545454545454546,0.4699581244927353,0.9378118263023655
38,58,18,114,0.3958333333333333,0.8421052631578947,0.38364860068321144,0.9152554353249219
19,75,2,96,0.20212765957446807,0.9791666666666666,0.3500239806224212,0.9206826061932691
0,1,0,1,0.0,1.0,0.31669064728908786,0.9267616335488924
34,71,3,108,0.3238095238095238,0.9722222222222222,0.31012802223906777,0.9450831465512562
131,198,48,377,0.3981762917933131,0.8726790450928382,0.3064776619867808,0.9359647334919565
16,61,20,97,0.2077922077922078,0.7938144329896907,0.27267019960788985,0.9163618692392523
0,28,5,33,0.0,0.8484848484848485,0.21824843090040688,0.9012103540877371
0,12,2,14,0.0,0.8571428571428571,0.16170081185278784,0.9033585817998746
2,7,2,11,0.2222222222222222,0.8181818181818182,0.16457146365960984,0.8803607463020392
40,141,59,240,0.22099447513812154,0.7541666666666667,0.1961421029650558,0.8452416986829915
39,95,22,156,0.291044776119403,0.8589743589743589,0.19146142472360997,0.8290634325047254
3,18,4,25,0.14285714285714285,0.84,0.15498726058987136,0.8243949974914627
10,22,90,122,0.3125,0.26229508196721313,0.16994551661955595,0.7484636616311089
4,43,3,50,0.0851063829787234,0.94,0.18210357133080216,0.7615372547047018
8,154,27,189,0.04938271604938271,0.8571428571428571,0.18915824505214254,0.761537254704702
22,109,3,134,0.16793893129770993,0.9776119402985075,0.18140348920578367,0.7843129864356575
30,106,8,144,0.22058823529411764,0.9444444444444444,0.18134545494235452,0.8114955261181971
41,64,2,107,0.3904761904761905,0.9813084112149533,0.1955499427076099,0.8289718192954248
52,166,7,225,0.23853211009174313,0.9688888888888889,0.20921779516969563,0.8473845177081234
17,65,1,83,0.2073170731707317,0.9879518072289156,0.19419166276551444,0.9510497641740808
6,46,1,53,0.11538461538461539,0.9811320754716981,0.19851712453778475,0.956925774955752
1,27,8,36,0.03571428571428571,0.7777777777777778,0.1965644916327709,0.9455879064750263
6,149,4,159,0.03870967741935484,0.9748427672955975,0.17810316965014872,0.9451923103317535
17,88,26,131,0.1619047619047619,0.8015267175572519,0.1697198163088122,0.9247754922050117
33,67,25,125,0.33,0.8,0.16108036052649924,0.8988742906028756
9,91,2,102,0.09,0.9803921568627451,0.13986148765625023,0.9005176145991406
12,51,1,64,0.19047619047619047,0.984375,0.1374556472713158,0.900006642137867
8,100,12,120,0.07407407407407407,0.9,0.13155414136980986,0.8884163456419102
12,34,1,47,0.2608695652173913,0.9787234042553191,0.16371918129882498,0.9171228637101304
22,74,1,97,0.22916666666666666,0.9896907216494846,0.1909273226198695,0.9192440000464001
7,18,4,29,0.28,0.8620689655172413,0.20779807091918925,0.9278928926121128
9,60,11,80,0.13043478260869565,0.8625,0.1792887541490029,0.9368214640406842
23,28,1,52,0.45098039215686275,0.9807692307692307,0.23085738159998329,0.9368753317416108
0,2,58,60,0.0,0.03333333333333333,0.20364649724624176,0.8010122365035155
11,158,10,179,0.0650887573964497,0.9441340782122905,0.20236288057800975,0.807317104819557
46,138,15,199,0.25,0.9246231155778895,0.20081008554695384,0.7995884921513526
46,90,4,140,0.3382352941176471,0.9714285714285714,0.21639131803995104,0.7969796135483651
6,50,7,63,0.10714285714285714,0.8888888888888888,0.19169744048893064,0.8008110311728862
35,171,6,212,0.16990291262135923,0.9716981132075472,0.19733574477645396,0.8164107616311072
0,10,55,65,0.0,0.15384615384615385,0.13290997446833075,0.6982788934992391
7,5,2,14,0.5833333333333334,0.8571428571428571,0.2162433078016641,0.815965968329171
29,42,5,76,0.4084507042253521,0.9342105263157895,0.2652950144915073,0.8145483180582423
1,60,3,64,0.01639344262295082,0.953125,0.23192264915192884,0.8186200158328296
43,75,3,121,0.3644067796610169,0.9752066115702479,0.23566143280098167,0.8191597358530691
25,84,398,507,0.22935779816513763,0.21499013806706113,0.25312071008987885,0.7228884857356652
1,43,9,53,0.022727272727272728,0.8301886792452831,0.23209561867643796,0.7026728523124846
19,62,20,101,0.2345679012345679,0.801980198019802,0.2656053188528048,0.7952634300515771
2,0,0,2,1.0,1.0,0.3251291283766143,0.8156715933168833
8,8,1,17,0.5,0.9411764705882353,0.338207599201564,0.8166667282129468
21,69,4,94,0.23333333333333334,0.9574468085106383,0.36919901216019013,0.8172841294287523
42,76,23,141,0.3559322033898305,0.8368794326241135,0.36798835840716343,0.7975231038650189
24,35,4,63,0.4067796610169492,0.9365079365079365,0.39333433881456514,0.9005970750708582
13,14,2,29,0.48148148148148145,0.9310344827586207,0.45887065435088065,0.9150036184299065
8,13,1,22,0.38095238095238093,0.9545454545454546,0.45929513162972,0.9385169277877327
38,57,19,114,0.4,0.8333333333333334,0.3735808459154343,0.914707403978209
19,75,2,96,0.20212765957446807,0.9791666666666666,0.33995622585464397,0.9201345748465563
0,1,0,1,0.0,1.0,0.3088388284006129,0.9255767517173046
32,73,3,108,0.3047619047619048,0.9722222222222222,0.3036234088994791,0.9444656406061934
127,205,46,378,0.3825301204819277,0.8783068783068783,0.29773788131699425,0.9361512037203281
13,65,20,98,0.16666666666666666,0.7959183673469388,0.2624341046339072,0.9162132746316418
0,28,5,33,0.0,0.8484848484848485,0.20801233592642418,0.9010617594801268
0,12,2,14,0.0,0.8571428571428571,0.15086947878356707,0.9044631200243443
1,8,2,11,0.1111111111111111,0.8181818181818182,0.1378671147173732,0.8814652845265089
40,141,59,240,0.22099447513812154,0.7541666666666667,0.16943775402281913,0.8463462369074614
39,95,22,156,0.291044776119403,0.8589743589743589,0.16747816421674747,0.8301679707291951
4,17,4,25,0.19047619047619047,0.84,0.14004188850164215,0.8246955595424981
8,22,92,122,0.26666666666666666,0.2459016393442623,0.1543276027873564,0.7461217412564016
4,43,3,50,0.0851063829787234,0.94,0.16648565749860264,0.7591953343299946
9,156,27,192,0.05454545454545454,0.859375,0.1742778652908104,0.759514211881015
19,111,3,133,0.14615384615384616,0.9774436090225563,0.17928397029691542,0.7822658962868347
29,107,8,144,0.21323529411764705,0.9444444444444444,0.17817551586541908,0.8094484359693743
41,63,2,106,0.3942307692307692,0.9811320754716981,0.19291637202418568,0.8268995383261372
52,166,7,225,0.23853211009174313,0.9688888888888889,0.19978150339783607,0.8453122367388356
17,65,1,83,0.2073170731707317,0.9879518072289156,0.19130299004127393,0.9513194035795003
6,46,1,53,0.11538461538461539,0.9811320754716981,0.19562845181354419,0.9571954143611715
1,27,8,36,0.03571428571428571,0.7777777777777778,0.19293828483766293,0.9455386683294255
6,149,4,159,0.03870967741935484,0.9748427672955975,0.17758911787559278,0.9451671195112885
17,88,26,131,0.1619047619047619,0.8015267175572519,0.17025618470232343,0.9247503013845468
32,68,25,125,0.32,0.8,0.15965178909792785,0.8988742906028756
9,93,2,104,0.08823529411764706,0.9807692307692307,0.1381808153873427,0.9005714823000673
12,51,1,64,0.19047619047619047,0.984375,0.13577497500240823,0.9000605098387936
9,99,12,120,0.08333333333333333,0.9,0.13119622042365367,0.8884702133428367
12,34,1,47,0.2608695652173913,0.9787234042553191,0.1633612603526687,0.9171767314110569
22,74,1,97,0.22916666666666666,0.9896907216494846,0.19056940167371325,0.9192978677473266
6,19,4,29,0.24,0.8620689655172413,0.2017258642587473,0.9279467603130392
9,60,11,80,0.13043478260869565,0.8625,0.17464511891713239,0.9368753317416106
25,26,1,52,0.49019607843137253,0.9807692307692307,0.23206808810480745,0.9368753317416106
0,2,58,60,0.0,0.03333333333333333,0.20485720375106592,0.8010122365035154
11,159,10,180,0.06470588235294118,0.9444444444444444,0.20219613932529562,0.8073614428527218
45,140,15,200,0.24324324324324326,0.925,0.1996780933289888,0.7996866708162476
46,90,4,140,0.3382352941176471,0.9714285714285714,0.21525932582198598,0.79707779221326
6,51,7,64,0.10526315789473684,0.890625,0.19601120552123413,0.801157225710797
38,167,6,211,0.18536585365853658,0.9715639810426541,0.20385850138549708,0.8167377944311761
0,10,55,65,0.0,0.15384615384615385,0.1338304901810153,0.6986059262993081
7,5,2,14,0.5833333333333334,0.8571428571428571,0.21716382351434865,0.81629300112924
29,42,5,76,0.4084507042253521,0.9342105263157895,0.26627022663897876,0.8148310128251465
1,60,3,64,0.01639344262295082,0.953125,0.23386311226465126,0.8188488699680035
45,73,3,121,0.3813559322033898,0.9752066115702479,0.24002320341975739,0.8193885899882432
27,84,397,508,0.24324324324324326,0.21850393700787402,0.2597346441838297,0.7233712952750823
1,44,9,54,0.022222222222222223,0.8333333333333334,0.23642841112149912,0.7036240598880364
20,61,20,101,0.24691358024691357,0.801980198019802,0.27170177972820103,0.796214637627129
2,0,0,2,1.0,1.0,0.33122558925201057,0.8166228008924351
7,9,1,17,0.4375,0.9411764705882353,0.33537548864838884,0.8176179357884988
21,69,4,94,0.23333333333333334,0.9574468085106383,0.3663669016070149,0.8182353370043043
44,75,22,141,0.3697478991596639,0.8439716312056738,0.36470861117219694,0.7994874826665079
25,34,4,63,0.423728813559322,0.9365079365079365,0.3904922640744939,0.9020594825950884
12,15,2,29,0.4444444444444444,0.9310344827586207,0.45080972439195416,0.9160167896558437
7,16,1,24,0.30434782608695654,0.9583333333333334,0.446656556325872,0.9390580533288582
37,60,20,117,0.38144329896907214,0.8290598290598291,0.3582913133214537,0.9146380289088338
17,93,2,112,0.15454545454545454,0.9821428571428571,0.3178692353993758,0.9204903698452085
0,1,0,1,0.0,1.0,0.2895806922593475,0.9259325467159567
32,89,3,124,0.2644628099173554,0.9758064516129032,0.2774744723609198,0.9453334683749429
135,236,44,415,0.3638814016172507,0.8939759036144578,0.26892484208348105,0.9392574636758745
12,74,20,106,0.13953488372093023,0.8113207547169812,0.22974509640814597,0.9215198756400514
0,35,5,40,0.0,0.875,0.18626683553858076,0.9096151137352896
0,12,2,14,0.0,0.8571428571428571,0.13177493568585616,0.9136269748900079
2,12,2,16,0.14285714285714285,0.875,0.1301051768732402,0.8983208524410283
43,166,59,268,0.20574162679425836,0.7798507462686567,0.15949683784384855,0.8668709590508364
39,110,21,170,0.26174496644295303,0.8764705882352941,0.15910857449036248,0.8526801214254638
5,17,4,26,0.22727272727272727,0.8461538461538461,0.139593049584002,0.8458483989310907
11,19,96,126,0.36666666666666664,0.23809523809523808,0.1720404471476786,0.7639590394136988
5,45,3,53,0.1,0.9433962264150944,0.1863261614333929,0.7737299289015694
11,167,28,206,0.06179775280898876,0.8640776699029126,0.19515441183467702,0.7747206164387201
25,140,3,168,0.15151515151515152,0.9821428571428571,0.19639127021439254,0.7900267388876997
27,115,8,150,0.19014084507042253,0.9466666666666667,0.1941625871109874,0.813857584658844
40,75,2,117,0.34782608695652173,0.9829059829059829,0.20645989004149726,0.8290626410403709
53,165,7,225,0.24311926605504589,0.9688888888888889,0.20872368129611418,0.8465962185739485
26,75,1,102,0.25742574257425743,0.9901960784313726,0.19311783499719853,0.9540391957648249
3,52,5,60,0.05454545454545454,0.9166666666666666,0.1866243285036921,0.9502206872293352
2,28,9,39,0.06666666666666667,0.7692307692307693,0.18731988762621749,0.9366711299904574
6,153,4,163,0.03773584905660377,0.9754601226993865,0.1710657015607107,0.9357164536413903
17,97,26,140,0.14912280701754385,0.8142857142857143,0.16520598183887086,0.9168048890155401
32,85,24,141,0.27350427350427353,0.8297872340425532,0.15458857991712113,0.8949307820350502
7,100,2,109,0.06542056074766354,0.981651376146789,0.1292030505874951,0.8967539945004643
12,52,2,66,0.1875,0.9696969696969697,0.1192136587911726,0.8938255503955496
9,112,12,133,0.0743801652892562,0.9097744360902256,0.12204718889742996,0.8928409460274868
13,36,1,50,0.2653061224489796,0.98,0.15042425400918896,0.9229508361373769
22,77,1,100,0.2222222222222222,0.99,0.1767794501757059,0.9250279614660358
9,17,4,30,0.34615384615384615,0.8666666666666667,0.20492674148089193,0.9325109546633147
9,76,11,96,0.10588235294117647,0.8854166666666666,0.18098075282902096,0.9404580164667594
21,34,1,56,0.38181818181818183,0.9821428571428571,0.2261804129819521,0.9405282280376265
0,5,57,62,0.0,0.08064516129032258,0.19939469869623783,0.8135208268366768
10,188,10,208,0.050505050505050504,0.9519230769230769,0.19598396801277987,0.8195420612413699
48,173,14,235,0.2171945701357466,0.9404255319148936,0.18911088911088944,0.8138885658006405
41,98,13,152,0.2949640287769784,0.9144736842105263,0.19950257576156888,0.8030990921164298
4,54,7,65,0.06896551724137931,0.8923076923076924,0.1599042430597879,0.8067620957794335
37,184,6,227,0.167420814479638,0.973568281938326,0.16869545185099669,0.819355183675385
1,8,57,66,0.1111111111111111,0.13636363636363635,0.13002301317855802,0.6985295807069247
7,6,2,15,0.5384615384615384,0.8666666666666667,0.20694609010163492,0.8108183671892597
29,54,5,88,0.3493975903614458,0.9431818181818182,0.24964502436683425,0.8095696159405084
2,60,3,65,0.03225806451612903,0.9538461538461539,0.22322552356403175,0.8114868476449743
44,96,3,143,0.3142857142857143,0.9790209790209791,0.22598576435099402,0.820707889760753
20,125,451,596,0.13793103448275862,0.24328859060402686,0.23583798109976248,0.727990875231658
1,49,9,59,0.02,0.847457627118644,0.21477786474552849,0.7099750674002748
21,66,20,107,0.2413793103448276,0.8130841121495327,0.23338760749320225,0.8066494210839744
2,0,0,2,1.0,1.0,0.2993216734272682,0.8256970401315934
7,9,1,17,0.4375,0.9411764705882353,0.3119077319470617,0.8254105619039386
22,79,4,105,0.21782178217821782,0.9619047619047619,0.33841683447021725,0.826561791626597
43,83,24,150,0.3412698412698413,0.84,0.34227170975366394,0.8067016517664571
25,34,4,63,0.423728813559322,0.9365079365079365,0.3830999639074587,0.9057329868955871
12,17,2,31,0.41379310344827586,0.9354838709677419,0.43935612154292664,0.9183081645883153
8,15,1,24,0.34782608695652173,0.9583333333333334,0.46219004211735715,0.9400104342812392
36,59,22,117,0.37894736842105264,0.811965811965812,0.3734682376060789,0.9131484074192124
19,91,2,112,0.17272727272727273,0.9821428571428571,0.3356435622814035,0.9190007483555869
0,1,0,1,0.0,1.0,0.3059405919843739,0.9244429252263353
33,89,3,125,0.27049180327868855,0.976,0.29171388671597503,0.9429191157025257
133,237,45,415,0.35945945945945945,0.891566265060241,0.2825325504159947,0.9364988769242836
11,75,20,106,0.12790697674418605,0.8113207547169812,0.23676556679816904,0.9187612888884605
0,35,5,40,0.0,0.875,0.18707612580438024,0.9068565269836987
0,12,2,14,0.0,0.8571428571428571,0.13294078745851556,0.9133103905804193
2,12,2,16,0.14285714285714285,0.875,0.12867362604849703,0.8980042681314397
39,170,59,268,0.18660287081339713,0.7798507462686567,0.15533117902183946,0.8665543747412479
40,109,21,170,0.2684563758389262,0.8764705882352941,0.15504040367330196,0.8523358873462898
4,18,4,26,0.18181818181818182,0.8461538461538461,0.12966307829597662,0.8458483989310908
10,22,94,126,0.3125,0.25396825396825395,0.15603351018966433,0.766226613109844
6,44,3,53,0.12,0.9433962264150944,0.17317636733252145,0.7759975025977145
13,165,28,206,0.07303370786516854,0.8640776699029126,0.18360975417040268,0.7769881901348653
24,141,3,168,0.14545454545454545,0.9821428571428571,0.18398081168431735,0.792294312583845
26,116,8,150,0.18309859154929578,0.9466666666666667,0.18348020036087428,0.8161251583549891
40,75,2,117,0.34782608695652173,0.9829059829059829,0.1948187305205308,0.8313302147365161
53,165,7,225,0.24311926605504589,0.9688888888888889,0.20357602826865423,0.8488637922700936
27,74,1,102,0.26732673267326734,0.9901960784313726,0.19712270436483528,0.9540391957648248
3,52,5,60,0.05454545454545454,0.9166666666666666,0.18777205501418592,0.9502206872293353
1,29,9,39,0.03333333333333333,0.7692307692307693,0.18210057293820947,0.9366711299904577
6,153,4,163,0.03773584905660377,0.9754601226993865,0.16671218773850352,0.9357164536413903
17,97,26,140,0.14912280701754385,0.8142857142857143,0.16185850423396753,0.91680488901554
33,84,24,141,0.28205128205128205,0.8297872340425532,0.152462103533219,0.8949307820350499
9,98,2,109,0.08411214953271028,0.981651376146789,0.12974680117288534,0.8967539945004644
12,52,2,66,0.1875,0.9696969696969697,0.11834298221956144,0.8938255503955498
10,111,12,133,0.08264462809917356,0.9097744360902256,0.12235714987009273,0.8928409460274868
13,36,1,50,0.2653061224489796,0.98,0.1554961197437565,0.9229508361373767
22,77,1,100,0.2222222222222222,0.99,0.18185131591027343,0.9250279614660358
9,17,4,30,0.34615384615384615,0.8666666666666667,0.20999860721545943,0.9325109546633147
10,76,10,96,0.11627906976744186,0.8958333333333334,0.1863168626034823,0.9419461117048549
20,35,1,56,0.36363636363636365,0.9821428571428571,0.22624889318971844,0.9420163232757216
0,5,57,62,0.0,0.08064516129032258,0.19946317890400417,0.815008922074772
12,186,10,208,0.06060606060606061,0.9519230769230769,0.19631481211927376,0.8210301564794651
47,174,14,235,0.21266968325791855,0.9404255319148936,0.18879532080626502,0.8153766610387356
41,97,14,152,0.2971014492753623,0.9078947368421053,0.19949235324242792,0.8036473377304649
7,51,7,65,0.1206896551724138,0.8923076923076924,0.16728318310222326,0.8073103413934687
38,183,6,227,0.17194570135746606,0.973568281938326,0.17523555904365531,0.8184153340513246
1,8,57,66,0.1111111111111111,0.13636363636363635,0.13916052296861922,0.6975897310828646
7,6,2,15,0.5384615384615384,0.8666666666666667,0.21608359989169615,0.8098785175651994
29,54,5,88,0.3493975903614458,0.9431818181818182,0.25733953271389404,0.8086297663164482
2,60,3,65,0.03225806451612903,0.9538461538461539,0.23156644432220982,0.810546998020914
45,95,3,143,0.32142857142857145,0.9790209790209791,0.23504174748695397,0.820707889760753
21,122,453,596,0.14685314685314685,0.23993288590604026,0.23877938915563016,0.7275114888462315
1,49,9,59,0.02,0.847457627118644,0.21707286039027784,0.7094956810148483
21,66,20,107,0.2413793103448276,0.8130841121495327,0.23568260313795167,0.8061700346985478
2,0,0,2,1.0,1.0,0.30161666907201756,0.8252176537461668
7,9,1,17,0.4375,0.9411764705882353,0.31420272759181106,0.824931175518512
20,81,4,105,0.19801980198019803,0.9619047619047619,0.3378829758009637,0.8260824052411703
44,82,24,150,0.3492063492063492,0.84,0.34185122976921767,0.8062222653810304
25,34,4,63,0.423728813559322,0.9365079365079365,0.3814048964415285,0.905732986895587
12,17,2,31,0.41379310344827586,0.9354838709677419,0.43766105407699646,0.9183081645883153
8,15,1,24,0.34782608695652173,0.9583333333333334,0.4404613465663699,0.9400104342812392
39,57,21,117,0.40625,0.8205128205128205,0.3556399179949414,0.9143694086402137
20,90,2,112,0.18181818181818182,0.9821428571428571,0.32804251539753876,0.9202217495765881
0,1,0,1,0.0,1.0,0.29833954510050903,0.9256639264473365
31,91,3,125,0.2540983606557377,0.976,0.28964493520543444,0.9441401169235268
137,231,47,415,0.37228260869565216,0.8867469879518072,0.2822954773677674,0.937031409986937
13,73,20,106,0.1511627906976744,0.8113207547169812,0.24477686126053858,0.9192938219511141
0,35,5,40,0.0,0.875,0.19508742026674977,0.9073890600463521
0,12,2,14,0.0,0.8571428571428571,0.13705170598103547,0.9126219224220716
2,12,2,16,0.14285714285714285,0.875,0.13148584327231563,0.8973157999730921
43,166,59,268,0.20574162679425836,0.7798507462686567,0.16087750424292396,0.8658659065829001
42,106,22,170,0.28378378378378377,0.8705882352941177,0.16511827897550196,0.8508070830534884
4,18,4,26,0.18181818181818182,0.8461538461538461,0.13790907513586334,0.8450080627966369
10,23,93,126,0.30303030303030304,0.2619047619047619,0.15960443404052457,0.7665200638234626
6,44,3,53,0.12,0.9433962264150944,0.1767472911833817,0.7762909533113332
10,168,28,206,0.056179775280898875,0.8640776699029126,0.18477297336636725,0.7772816408484841
26,139,3,168,0.15757575757575756,0.9821428571428571,0.18687563261188367,0.7925877632974636
30,112,8,150,0.2112676056338028,0.9466666666666667,0.18766505816039,0.816418609068608
43,72,2,117,0.3739130434782609,0.9829059829059829,0.20054066668817244,0.8324640015845886
53,165,7,225,0.24311926605504589,0.9688888888888889,0.20929796443629592,0.8499975791181662
26,75,1,102,0.25742574257425743,0.9901960784313726,0.2027830272282894,0.9540391957648249
5,50,5,60,0.09090909090909091,0.9166666666666666,0.19862718307244523,0.9502206872293353
2,28,9,39,0.06666666666666667,0.7692307692307693,0.2001253104132692,0.9366711299904577
6,153,4,163,0.03773584905660377,0.9754601226993865,0.1830053234819615,0.9357164536413904
16,98,26,140,0.14035087719298245,0.8142857142857143,0.17287436227613004,0.91680488901554
38,78,25,141,0.3275862068965517,0.8226950354609929,0.1662562427644573,0.8939176108091129
9,98,2,109,0.08411214953271028,0.981651376146789,0.14354094040412363,0.8957408232745271
13,52,1,66,0.2,0.9848484848484849,0.13533726289351544,0.8949768813341147
10,111,12,133,0.08264462809917356,0.9097744360902256,0.13415662534924153,0.8939922769660517
14,35,1,50,0.2857142857142857,0.98,0.16544914235604424,0.9241021670759417
23,76,1,100,0.23232323232323232,0.99,0.1932473399655626,0.9261792924046007
9,17,4,30,0.34615384615384615,0.8666666666666667,0.22264776410282885,0.9336622856018797
11,75,10,96,0.12790697674418605,0.8958333333333334,0.19412215979534803,0.944110613869357
23,31,1,55,0.42592592592592593,0.9818181818181818,0.24295269928009314,0.9441344432509845
0,4,58,62,0.0,0.06451612903225806,0.21438127070866456,0.8126583924200949
11,187,10,208,0.05555555555555555,0.9519230769230769,0.2105114032024334,0.8186796268247879
47,174,14,235,0.21266968325791855,0.9404255319148936,0.20007645999438095,0.8130261313840584
43,104,5,152,0.2925170068027211,0.9671052631578947,0.20867557063430794,0.8097554546923291
7,51,7,65,0.1206896551724138,0.8923076923076924,0.17646640049410328,0.8134184583553329
35,186,6,227,0.1583710407239819,0.973568281938326,0.18081840963407414,0.8245234510131889
1,10,55,66,0.09090909090909091,0.16666666666666666,0.1329588617745263,0.7080732345629724
7,6,2,15,0.5384615384615384,0.8666666666666667,0.20988193869760322,0.8226661685107451
29,54,5,88,0.3493975903614458,0.9431818181818182,0.2518593722413018,0.8214174172619939
2,60,3,65,0.03225806451612903,0.9538461538461539,0.2260862838496176,0.8233346489664598
43,97,3,143,0.30714285714285716,0.9790209790209791,0.22817569104106558,0.8250368940897574
20,109,468,597,0.15503875968992248,0.21608040201005024,0.2330827059721383,0.7284329954758085
1,49,9,59,0.02,0.847457627118644,0.21331541444014088,0.7104171876444253
20,67,20,107,0.22988505747126436,0.8130841121495327,0.23316912394902278,0.8027625369991206
2,0,0,2,1.0,1.0,0.29910318988308876,0.8218101560467396
7,9,1,17,0.4375,0.9411764705882353,0.3116892484028822,0.8215236778190848
21,80,4,105,0.2079207920792079,0.9619047619047619,0.3367839237690363,0.8226749075417431
47,80,23,150,0.3700787401574803,0.8466666666666667,0.34577476419969677,0.8037671486339842
25,34,4,63,0.423728813559322,0.9365079365079365,0.38415905760961094,0.9066853678479679
13,16,2,31,0.4482758620689655,0.9354838709677419,0.44534132361946316,0.9192605455406964
7,16,1,24,0.30434782608695654,0.9583333333333334,0.4362448031441191,0.9400104342812392
39,59,19,117,0.3979591836734694,0.8376068376068376,0.35023897224032907,0.9168114110822161
21,89,2,112,0.19090909090909092,0.9821428571428571,0.32394027094162775,0.9226637520185905
0,1,0,1,0.0,1.0,0.294237300644598,0.928105928889339
33,89,3,125,0.27049180327868855,0.976,0.28338517355392695,0.9465821193655294
122,246,47,415,0.33152173913043476,0.8867469879518072,0.26779142684374696,0.9394734124289394
14,72,20,106,0.16279069767441862,0.8113207547169812,0.2368600486790087,0.9217358243931165
0,35,5,40,0.0,0.875,0.19338178780944348,0.9098310624883547
0,12,2,14,0.0,0.8571428571428571,0.13653047585609074,0.9126219224220716
2,12,2,16,0.14285714285714285,0.875,0.12966591184866957,0.8973157999730921
41,168,59,268,0.19617224880382775,0.7798507462686567,0.15769051882064497,0.8658659065829001
42,106,22,170,0.28378378378378377,0.8705882352941177,0.15958937317851568,0.8508070830534884
4,18,4,26,0.18181818181818182,0.8461538461538461,0.1382031507053367,0.8450080627966369
9,26,91,126,0.2571428571428571,0.2777777777777778,0.15168203062939936,0.7687876375196077
6,44,3,53,0.12,0.9433962264150944,0.1688248877722565,0.7785585270074783
9,168,28,205,0.05084745762711865,0.8634146341463415,0.17608881029041631,0.7794544951508333
25,140,3,168,0.15151515151515152,0.9821428571428571,0.17732566867013183,0.794760617599813
31,112,7,150,0.21678321678321677,0.9533333333333334,0.1802700926671874,0.8195438443233382
44,71,2,117,0.3826086956521739,0.9829059829059829,0.19438793721981457,0.8355892368393188
53,165,7,225,0.24311926605504589,0.9688888888888889,0.203145234967938,0.8531228143728964
26,75,1,102,0.25742574257425743,0.9901960784313726,0.20318564717242377,0.95489685732341
4,51,5,60,0.07272727272727272,0.9166666666666666,0.19643240041917703,0.9510783487879203
1,29,9,39,0.03333333333333333,0.7692307692307693,0.19393038266292195,0.9376235109428386
6,153,4,163,0.03773584905660377,0.9754601226993865,0.17767619659741513,0.9366688345937713
15,98,27,140,0.13274336283185842,0.8071428571428572,0.16567050317579252,0.9157844808522747
37,79,25,141,0.31896551724137934,0.8226950354609929,0.156578620545679,0.8928972026458475
10,97,2,109,0.09345794392523364,0.981651376146789,0.13519843166999154,0.894720415111262
13,52,1,66,0.2,0.9848484848484849,0.12699475415938336,0.8939564731708494
9,112,12,133,0.0743801652892562,0.9097744360902256,0.12723088166823812,0.8929718688027863
15,34,1,50,0.30612244897959184,0.98,0.16620075533198936,0.9230817589126764
24,75,1,100,0.24242424242424243,0.99,0.19544195438450915,0.9251588842413355
8,18,4,30,0.3076923076923077,0.8666666666666667,0.2204346607931448,0.9336622856018798
11,74,11,96,0.12941176470588237,0.8854166666666666,0.19335555328807377,0.9426225186312617
20,34,1,55,0.37037037037037035,0.9818181818181818,0.23291447135166474,0.9426463480128893
0,4,58,62,0.0,0.06451612903225806,0.20434304278023616,0.8111702971819997
10,188,10,208,0.050505050505050504,0.9519230769230769,0.20093231209677823,0.8171915315866928
46,175,14,235,0.2081447963800905,0.9404255319148936,0.18693550458256372,0.8115380361459633
46,103,3,152,0.3087248322147651,0.9802631578947368,0.19640701740978123,0.8101470587023544
6,52,7,65,0.10344827586206896,0.8923076923076924,0.16722929857688998,0.8138100623653578
36,185,6,227,0.16289592760180996,0.973568281938326,0.17201275041916536,0.8264031502613093
1,10,55,66,0.09090909090909091,0.16666666666666666,0.13208971049612545,0.7099529338110928
7,6,2,15,0.5384615384615384,0.8666666666666667,0.2090127874192024,0.8245458677588654
30,53,5,88,0.3614457831325301,0.9431818181818182,0.25343289208027087,0.8232971165101143
2,60,3,65,0.03225806451612903,0.9538461538461539,0.22830621609970495,0.82521434821458
41,99,3,143,0.29285714285714287,0.9790209790209791,0.22603940333433034,0.8250368940897576
18,108,471,597,0.14285714285714285,0.21105527638190955,0.23166924147648377,0.7277151203860742
1,49,9,59,0.02,0.847457627118644,0.21125553753336804,0.709699312554691
19,68,20,107,0.21839080459770116,0.8130841121495327,0.22946721091745523,0.8020446619093862
2,0,0,2,1.0,1.0,0.2954012768515212,0.8210922809570053
6,10,1,17,0.375,0.9411764705882353,0.297337593546874,0.8208058027293506
21,80,4,105,0.2079207920792079,0.9619047619047619,0.3224322689130282,0.8219570324520087
40,87,23,150,0.31496062992125984,0.8466666666666667,0.3255899099221877,0.8030492735442498
25,34,4,63,0.423728813559322,0.9365079365079365,0.3657144343082133,0.9066853678479679
12,17,2,31,0.41379310344827586,0.9354838709677419,0.42197059194368125,0.9192605455406964
7,16,1,24,0.30434782608695654,0.9583333333333334,0.3671454594198734,0.9371934855403831
40,61,16,117,0.39603960396039606,0.8632478632478633,0.35229397427135856,0.9176574660043636
20,90,2,112,0.18181818181818182,0.9821428571428571,0.32469657167395594,0.9235098069407381
0,1,0,1,0.0,1.0,0.29136323834062255,0.9295888342963613
32,90,3,125,0.26229508196721313,0.976,0.27798650670882014,0.949463201064345
130,239,45,414,0.3523035230352303,0.8913043478260869,0.2667392267483358,0.9431518406155373
13,73,20,106,0.1511627906976744,0.8113207547169812,0.23542385822366493,0.9260498794667316
0,35,5,40,0.0,0.875,0.19194559735409972,0.9141451175619697
0,13,1,14,0.0,0.9285714285714286,0.13536851107404313,0.9234770554653361
3,12,1,16,0.2,0.9375,0.13796591367144573,0.917099504444928
46,163,59,268,0.22009569377990432,0.7798507462686567,0.1694081556400035,0.8856496110547362
43,105,22,170,0.2905405405405405,0.8705882352941177,0.17344322115047883,0.8705907875253243
4,22,0,26,0.15384615384615385,1.0,0.1450921684091822,0.8861187378358834
9,50,67,126,0.15254237288135594,0.46825396825396826,0.14528925157827954,0.8371091969125957
7,43,3,53,0.14,0.9433962264150944,0.16528925157827956,0.8468800864004663
10,165,27,202,0.05714285714285714,0.8663366336633663,0.17345251688440202,0.8379894014136005
26,139,3,168,0.15757575757575756,0.9821428571428571,0.16739191082379595,0.8443669524340084
32,111,7,150,0.22377622377622378,0.9533333333333334,0.16791770082327015,0.8691501791575337
43,72,2,117,0.3739130434782609,0.9829059829059829,0.17982805838580163,0.8851955716735145
53,165,7,225,0.24311926605504589,0.9688888888888889,0.19258136012992907,0.88075112722907
26,75,1,102,0.25742574257425743,0.9901960784313726,0.20756469865748642,0.9553142858258422
6,53,1,60,0.1016949152542373,0.9833333333333333,0.202092543693806,0.961019586814162
2,28,9,39,0.06666666666666667,0.7692307692307693,0.20345308791149308,0.9471473204666481
6,153,4,163,0.03773584905660377,0.9754601226993865,0.1863331009801854,0.9461926441175809
16,99,25,140,0.1391304347826087,0.8214285714285714,0.17424084540966897,0.927349106702615
37,79,25,141,0.31896551724137934,0.8226950354609929,0.1663911988044002,0.9044618284961877
9,97,2,108,0.08490566037735849,0.9814814814814815,0.14378925513615912,0.9062607702951295
13,52,1,66,0.2,0.9848484848484849,0.13558557762555093,0.9054968283547169
10,110,13,133,0.08333333333333333,0.9022556390977443,0.13296249449399322,0.8939143006067757
14,35,1,50,0.2857142857142857,0.98,0.16425501150079594,0.9240241907166657
23,76,1,100,0.23232323232323232,0.99,0.1920532091103143,0.9261013160453249
9,17,4,30,0.34615384615384615,0.8666666666666667,0.2216279821633482,0.9325639010793384
11,79,6,96,0.12222222222222222,0.9375,0.1935217971606115,0.9489646102991965
23,32,1,56,0.41818181818181815,0.9821428571428571,0.24113267684696285,0.949059092536536
0,5,57,62,0.0,0.08064516129032258,0.2125612482755343,0.8198871891710843
11,187,10,208,0.05555555555555555,0.9519230769230769,0.20859299430728034,0.826982537431846
46,181,8,235,0.2026431718061674,0.9659574468085106,0.19672569232040632,0.8249764584044905
48,101,3,152,0.3221476510067114,0.9802631578947368,0.20955775213233188,0.8235854809608814
8,49,7,64,0.14035087719298245,0.890625,0.18015732799506565,0.8270081000085004
34,187,6,227,0.15384615384615385,0.973568281938326,0.18467503251277015,0.8321607117139757
9,55,2,66,0.140625,0.9696969696969697,0.14502405848679611,0.8303827277931345
7,6,2,15,0.5384615384615384,0.8666666666666667,0.22194713540987304,0.9426715142754694
28,55,5,88,0.3373493975903614,0.9431818181818182,0.26220339855770247,0.9414227630267181
2,60,3,65,0.03225806451612903,0.9538461538461539,0.23786266894483982,0.93969257831781
44,96,3,143,0.3142857142857143,0.9790209790209791,0.23673953512755452,0.9395151241929875
19,109,469,597,0.1484375,0.21440536013400335,0.23789476695712847,0.8429123184978452
1,49,9,59,0.02,0.847457627118644,0.21877388783624935,0.824896510666462
21,66,20,107,0.2413793103448276,0.8130841121495327,0.2331673607426533,0.8025232453025425
2,0,0,2,1.0,1.0,0.29910142667671924,0.8215708643501615
6,10,1,17,0.375,0.9411764705882353,0.30448008416381045,0.8212843861225068
21,80,4,105,0.2079207920792079,0.9619047619047619,0.3295747595299646,0.822435615845165
44,83,23,150,0.3464566929133858,0.8466666666666667,0.33417061361963196,0.8035278569374061
26,33,4,63,0.4406779661016949,0.9365079365079365,0.3759192516341598,0.9066853678479679
11,18,2,31,0.3793103448275862,0.9354838709677419,0.42724930089524354,0.9192605455406964
8,13,1,22,0.38095238095238093,0.9545454545454546,0.4565518544582587,0.9346260175473832
38,57,19,114,0.4,0.8333333333333334,0.370837568743973,0.9108164937378594
19,75,2,96,0.20212765957446807,0.9791666666666666,0.3461415201117542,0.9162436646062068
0,1,0,1,0.0,1.0,0.3128081867784208,0.9223226919618298
33,73,3,109,0.3113207547169811,0.9724770642201835,0.30432691528478756,0.9437201246417143
128,199,50,377,0.39143730886850153,0.8673740053050398,0.2937440677832434,0.9339901438327568
11,66,20,97,0.14285714285714285,0.7938144329896907,0.26124217813849665,0.9143872795800524
0,28,5,33,0.0,0.8484848484848485,0.20682040943101368,0.8992357644285374
0,12,2,14,0.0,0.8571428571428571,0.14967755228815655,0.9026371249727551
1,8,2,11,0.1111111111111111,0.8181818181818182,0.1366751882219627,0.8796392894749197
39,143,59,241,0.21428571428571427,0.7551867219917012,0.16728743311992186,0.8446659640451627
43,92,22,157,0.31851851851851853,0.8598726114649682,0.16831568509157008,0.8285796136515604
4,17,4,25,0.19047619047619047,0.84,0.1396069538926685,0.8246690414651262
9,19,94,122,0.32142857142857145,0.22950819672131148,0.16511715797430115,0.7440538648553577
4,41,3,48,0.08888888888888889,0.9375,0.17781557067271384,0.7567703150718079
8,153,26,187,0.049689440993788817,0.8609625668449198,0.1849140622432551,0.7573159878863882
23,109,3,135,0.17424242424242425,0.9777777777777777,0.1939328212620141,0.780115410685811
31,106,7,144,0.22627737226277372,0.9513888888888888,0.1956459152587369,0.8081442916711234
43,61,2,106,0.41346153846153844,0.9811320754716981,0.20920920382202549,0.8254670722435137
52,165,8,225,0.23963133640552994,0.9644444444444444,0.21623136752621683,0.8432448500212913
17,65,1,83,0.2073170731707317,0.9879518072289156,0.199929724917954,0.9515939372366634
6,46,1,53,0.11538461538461539,0.9811320754716981,0.20371482870305777,0.9578270908754775
2,26,8,36,0.07142857142857142,0.7777777777777778,0.2068204187651696,0.9459435495801714
7,147,5,159,0.045454545454545456,0.9685534591194969,0.1884221503669012,0.9446257897718455
14,90,27,131,0.1346153846153846,0.7938931297709924,0.17532758070298846,0.9221263956121462
33,68,24,125,0.32673267326732675,0.808,0.16293774281810108,0.897393241973332
9,91,2,102,0.09,0.9803921568627451,0.14156183761731106,0.8996714866045179
13,50,1,64,0.20634920634920634,0.984375,0.14142357092852173,0.8991605141432443
9,99,12,120,0.08333333333333333,0.9,0.13684481634976714,0.8875702176472873
12,34,1,47,0.2608695652173913,0.9787234042553191,0.16390781546245572,0.9162767357155074
21,77,0,98,0.21428571428571427,1.0,0.1880265538669084,0.9207690986984366
9,16,4,29,0.36,0.8620689655172413,0.2202243560647106,0.9305085038050435
9,60,11,80,0.13043478260869565,0.8625,0.19218180025633472,0.9382942180907577
24,27,1,52,0.47058823529411764,0.9807692307692307,0.24655154815549438,0.9383480857916843
0,2,58,60,0.0,0.03333333333333333,0.21707309010560777,0.8024849905535891
11,158,10,179,0.0650887573964497,0.9441340782122905,0.21446672211462442,0.8087898588696305
44,141,14,199,0.23783783783783785,0.9296482412060302,0.21117647534611678,0.8017791212911608
47,89,3,139,0.34558823529411764,0.9784172661870504,0.22993397834731727,0.7986958736035964
8,48,7,63,0.14285714285714285,0.8888888888888888,0.19891357018405192,0.8025272912281176
32,172,6,210,0.1568627450980392,0.9714285714285714,0.20268899339681531,0.8180885157179135
0,10,55,65,0.0,0.15384615384615385,0.13546210264051278,0.6999566475860455
7,5,2,14,0.5833333333333334,0.8571428571428571,0.21879543597384613,0.8176437224159773
29,42,5,76,0.4084507042253521,0.9342105263157895,0.2678471426636893,0.8162260721450486
0,61,3,64,0.0,0.953125,0.23387030868685535,0.8195798948299015
45,73,3,121,0.3813559322033898,0.9752066115702479,0.23897997967389423,0.8191212298846439
18,77,411,506,0.18947368421052632,0.18774703557312253,0.24563948558152043,0.7189581079823917
1,43,9,53,0.022727272727272728,0.8301886792452831,0.22647727524283948,0.6987809805276362
21,60,20,101,0.25925925925925924,0.801980198019802,0.26351431227987654,0.7913715582667287
1,1,0,2,0.5,1.0,0.2516095503751146,0.8117797215320348
6,10,1,17,0.375,0.9411764705882353,0.24683087834292147,0.8127748564280985
21,69,4,94,0.23333333333333334,0.9574468085106383,0.2801642116762548,0.813392257643904
42,76,23,141,0.3559322033898305,0.8368794326241135,0.2765322504171749,0.7936312320801705
25,33,4,62,0.43103448275862066,0.9354838709677419,0.3110409359240455,0.9004507799936875
10,17,2,29,0.37037037037037035,0.9310344827586207,0.3607042355873452,0.9148573233527358
8,13,1,22,0.38095238095238093,0.9545454545454546,0.43331226595565997,0.9391760018380789
37,60,17,114,0.38144329896907214,0.8508771929824561,0.34494702295124163,0.9178727436927154
19,75,2,96,0.20212765957446807,0.9791666666666666,0.3291795457475942,0.9232999145610628
0,1,0,1,0.0,1.0,0.30230542976456737,0.9287420914318111
32,73,3,108,0.3047619047619048,0.9722222222222222,0.29709001026343357,0.9468256111931833
129,198,50,377,0.3944954128440367,0.8673740053050398,0.2869440347583945,0.9370956303842258
10,67,20,97,0.12987012987012986,0.7938144329896907,0.25623582671028494,0.9168571392445042
0,29,5,34,0.0,0.8529411764705882,0.20181405800280197,0.902342242376666
0,12,2,14,0.0,0.8571428571428571,0.14732215815007738,0.9032373372567235
1,8,2,11,0.1111111111111111,0.8181818181818182,0.13431979408388353,0.880239501758888
35,146,59,240,0.19337016574585636,0.7541666666666667,0.1619441034761487,0.8451204541398403
42,94,22,158,0.3088235294117647,0.8607594936708861,0.16252433556898585,0.8291972072039352
4,17,4,25,0.19047619047619047,0.84,0.13337873237357925,0.8252866350175009
10,20,92,122,0.3333333333333333,0.2459016393442623,0.16244490429689404,0.7470133787824397
5,41,3,49,0.10869565217391304,0.9387755102040817,0.17797285460745305,0.7592754264586531
9,153,26,188,0.05555555555555555,0.8617021276595744,0.18590936254396095,0.759926750818184
20,113,3,136,0.15037593984962405,0.9779411764705882,0.19151862379231993,0.7827495162880085
30,107,7,144,0.21897810218978103,0.9513888888888888,0.19517690042716634,0.8109241194626114
42,62,2,106,0.40384615384615385,0.9811320754716981,0.2087515610606505,0.8281202025770131
52,165,8,225,0.23963133640552994,0.9644444444444444,0.21577372476484188,0.845897980354791
17,65,1,83,0.2073170731707317,0.9879518072289156,0.1977714018844702,0.9519051471954558
6,46,1,53,0.11538461538461539,0.9811320754716981,0.19872696805742768,0.9579560850908296
1,27,8,36,0.03571428571428571,0.7777777777777778,0.19589250093724628,0.945966892250573
7,148,4,159,0.04516129032258064,0.9748427672955975,0.1808618367190972,0.9455242623684313
14,90,27,131,0.1346153846153846,0.7938931297709924,0.16881001992275488,0.923024868208732
33,67,26,126,0.33,0.7936507936507936,0.15826056937330432,0.8962418279486027
8,92,2,102,0.08,0.9803921568627451,0.1354560927439429,0.8985200725797885
13,50,1,64,0.20634920634920634,0.984375,0.13531782605515355,0.8980091001185148
9,99,12,120,0.08333333333333333,0.9,0.130739071476399,0.8864188036225579
13,34,1,48,0.2765957446808511,0.9791666666666666,0.1651507084716226,0.9151886448923993
24,73,1,98,0.24742268041237114,0.9897959183673469,0.1940451927701641,0.9173248093312205
6,19,4,29,0.24,0.8620689655172413,0.20910013782510917,0.9270642144378274
10,60,10,80,0.14285714285714285,0.875,0.18236544394755813,0.9386855296305713
21,30,1,52,0.4117647058823529,0.9807692307692307,0.2297604019307514,0.9387393973314977
0,2,58,60,0.0,0.03333333333333333,0.20028194388086476,0.8028763020934025
13,156,10,179,0.07692307692307693,0.9441340782122905,0.19936619296511388,0.8091811704094442
45,138,16,199,0.2459016393442623,0.9195979899497487,0.1949813207741726,0.8006713594498843
45,90,4,139,0.3333333333333333,0.9712230215827338,0.20725427119145293,0.7980180884806539
5,51,7,63,0.08928571428571429,0.8888888888888888,0.18572365894655496,0.801849506105175
31,172,6,209,0.15270935960591134,0.9712918660287081,0.18713111848209335,0.8156054869664189
0,10,55,65,0.0,0.15384615384615385,0.12830758907032863,0.697473618834551
7,5,2,14,0.5833333333333334,0.8571428571428571,0.21164092240366195,0.8151606936644828
29,42,5,76,0.4084507042253521,0.9342105263157895,0.2590020120182727,0.8137430433935542
0,61,3,64,0.0,0.953125,0.2238732063976638,0.8185326162578759
45,73,3,121,0.3813559322033898,0.9752066115702479,0.23073357766481475,0.8191017005418064
12,85,411,508,0.12371134020618557,0.19094488188976377,0.23565152422488206,0.7193954138276456
1,43,9,53,0.022727272727272728,0.8301886792452831,0.21708265467079085,0.6992378157157279
21,60,20,101,0.25925925925925924,0.801980198019802,0.25411969170782783,0.7918283934548204
2,0,0,2,1.0,1.0,0.31364350123163737,0.8122365567201264
6,10,1,17,0.375,0.9411764705882353,0.3088648291994442,0.8132316916161901
21,69,4,94,0.23333333333333334,0.9574468085106383,0.34219816253277757,0.8138490928319956
43,73,25,141,0.3706896551724138,0.8226950354609929,0.34067440867120957,0.7920617248163877
27,31,4,62,0.46551724137931033,0.9354838709677419,0.3895038231245131,0.8984244375418131
10,17,2,29,0.37037037037037035,0.9310344827586207,0.4391671227878127,0.9128309809008615
7,16,1,24,0.30434782608695654,0.9583333333333334,0.42435569150495844,0.9397171273792043
38,60,19,117,0.3877551020408163,0.8376068376068376,0.3368921346536465,0.9165181041801811
17,92,2,111,0.1559633027522936,0.9819819819819819,0.31452974933254557,0.9223474629507163
0,1,0,1,0.0,1.0,0.2890700605065201,0.9277896398214648
33,88,3,124,0.2727272727272727,0.9758064516129032,0.2758769044562212,0.9463851923529342
128,238,50,416,0.34972677595628415,0.8798076923076923,0.25933540939578886,0.9384314525443556
12,74,20,106,0.13953488372093023,0.8113207547169812,0.23000788046922227,0.9206938645085326
0,35,5,40,0.0,0.875,0.18652961959965705,0.9087891026037708
0,12,2,14,0.0,0.8571428571428571,0.13113603359382614,0.9115799625374877
1,13,2,16,0.07142857142857142,0.875,0.11905964340472298,0.8962968222543476
36,173,59,268,0.1722488038277512,0.7798507462686567,0.14366661538011602,0.8648469288641556
43,107,21,171,0.2866666666666667,0.8771929824561403,0.145657957371458,0.8507592904131894
3,19,4,26,0.13636363636363635,0.8461538461538461,0.11517750885822262,0.8459515981054972
10,20,96,126,0.3333333333333333,0.23809523809523808,0.1428630016599945,0.7640622385881054
5,45,3,53,0.1,0.9433962264150944,0.15714871594570876,0.773833128075976
11,166,28,205,0.062146892655367235,0.8634146341463415,0.16602684346790406,0.774729096219331
21,145,3,169,0.12650602409638553,0.9822485207100592,0.17389505099187752,0.7900503134636251
28,115,7,150,0.1958041958041958,0.9533333333333334,0.17726010698851247,0.8148335401871503
49,66,2,117,0.4260869565217391,0.9829059829059829,0.19717729125352282,0.8299353973942708
52,165,8,225,0.23963133640552994,0.9644444444444444,0.2119298198309362,0.8468340542929276
25,76,1,102,0.24752475247524752,0.9901960784313726,0.19967145113692392,0.9542770314838039
6,48,5,59,0.1111111111111111,0.9152542372881356,0.20125875272422553,0.9502567473228097
2,28,9,39,0.06666666666666667,0.7692307692307693,0.20190443472583972,0.936801909477728
6,151,7,164,0.03821656050955414,0.9573170731707317,0.18929165421343525,0.933240274114967
15,99,26,140,0.13157894736842105,0.8142857142857143,0.18011661872261026,0.9133763285367357
32,84,25,141,0.27586206896551724,0.8226950354609929,0.15865592050029287,0.8904890503303085
7,100,2,109,0.06542056074766354,0.981651376146789,0.13376866683488337,0.8929471834306435
12,52,2,66,0.1875,0.9696969696969697,0.1251937021955623,0.8900187393257288
9,112,12,133,0.0743801652892562,0.9097744360902256,0.11994642422101161,0.8892359105831701
12,37,1,50,0.24489795918367346,0.98,0.14540803743772687,0.9193458006930603
21,78,1,100,0.21212121212121213,0.99,0.17025155909653517,0.9240147902400987
7,19,4,30,0.2692307692307692,0.8666666666666667,0.1899161050768706,0.9314977834373775
9,76,11,96,0.10588235294117647,0.8854166666666666,0.16563328850196476,0.9404580164667596
17,37,2,56,0.3148148148148148,0.9642857142857143,0.20126103908298637,0.9379772076294631
0,4,58,62,0.0,0.06451612903225806,0.1744753247972721,0.8086656589630757
13,185,10,208,0.06565656565656566,0.9519230769230769,0.17322909627831629,0.8146868933677689
44,175,16,235,0.2009132420091324,0.9319148936170213,0.16694556525338186,0.8078175924559147
43,105,5,153,0.2905405405405405,0.9673202614379085,0.17814832645614306,0.8045776298041873
6,53,6,65,0.1016949152542373,0.9076923076923077,0.15421463303092423,0.8104384356649933
34,187,6,227,0.15384615384615385,0.973568281938326,0.16106660458877814,0.8230315235609444
0,9,56,65,0.0,0.13846153846153847,0.11609305961523317,0.705056641300348
7,6,2,15,0.5384615384615384,0.8666666666666667,0.19301613653831007,0.8196495752481207
30,53,5,88,0.3614457831325301,0.9431818181818182,0.23527173903487641,0.8184008239993694
2,60,3,65,0.03225806451612903,0.9538461538461539,0.21117814225016165,0.8215338611749597
42,98,3,143,0.3,0.9790209790209791,0.21252949360151296,0.8232053922582556
15,109,473,597,0.12096774193548387,0.20770519262981574,0.21528275455597679,0.7232072329636139
2,48,9,59,0.04,0.847457627118644,0.19901901829224053,0.7051914251322309
22,65,20,107,0.25287356321839083,0.8130841121495327,0.23514381303772494,0.80156607851623
2,0,0,2,1.0,1.0,0.30107787897179084,0.820613697563849
5,11,1,17,0.3125,0.9411764705882353,0.29408562423857226,0.8203272193361943
19,82,4,105,0.18811881188118812,0.9619047619047619,0.31635144529072357,0.8214784490588526
43,83,23,149,0.3412698412698413,0.8456375838926175,0.3222471369007009,0.8024236783262294
27,31,4,62,0.46551724137931033,0.9354838709677419,0.3714684939641047,0.9063920609459332
10,19,2,31,0.3448275862068966,0.9354838709677419,0.41501529199366133,0.9189672386386614
8,15,1,24,0.34782608695652173,0.9583333333333334,0.4449430101578837,0.9397171273792043
38,61,18,117,0.3838383838383838,0.8461538461538461,0.35691992213479556,0.9177391054011823
20,89,2,111,0.1834862385321101,0.9819819819819819,0.33848938478223994,0.9235684641717176
0,1,0,1,0.0,1.0,0.3073719873282088,0.929010641042466
33,89,3,125,0.27049180327868855,0.976,0.2949932653476132,0.9476338433435206
128,239,50,417,0.34877384196185285,0.8800959232613909,0.278315636859405,0.9397212793854705
12,74,20,106,0.13953488372093023,0.8113207547169812,0.23913589118406997,0.9219836913496475
0,35,5,40,0.0,0.875,0.18944645019028114,0.9100789294448857
0,12,2,14,0.0,0.8571428571428571,0.13461239535622632,0.9116487881576013
1,13,2,16,0.07142857142857142,0.875,0.11860415719857793,0.8963656478744612
36,173,59,268,0.1722488038277512,0.7798507462686567,0.14321112917397097,0.8649157544842694
42,108,21,171,0.28,0.8771929824561403,0.14456944299130117,0.850800466263718
3,19,4,26,0.13636363636363635,0.8461538461538461,0.11422512790584165,0.8459515981054972
10,21,95,126,0.3225806451612903,0.24603174603174602,0.14037452239732168,0.7651960254361779
5,45,3,53,0.1,0.9433962264150944,0.154660236683036,0.7749669149240486
11,166,28,205,0.062146892655367235,0.8634146341463415,0.1635383642052313,0.7758628830674035
21,145,3,169,0.12650602409638553,0.9822485207100592,0.17140657172920476,0.7911841003116977
30,112,8,150,0.2112676056338028,0.9466666666666667,0.1769806862729264,0.8150149460828419
50,65,2,117,0.43478260869565216,0.9829059829059829,0.19909248751516243,0.8301168032899623
52,165,8,225,0.23963133640552994,0.9644444444444444,0.21384501609257578,0.8470154601886192
25,76,1,102,0.24752475247524752,0.9901960784313726,0.20312274570885538,0.9533246505314229
5,49,5,59,0.09259259259259259,0.9152542372881356,0.20206454465065432,0.9493043663704288
2,28,9,39,0.06666666666666667,0.7692307692307693,0.2027102266522685,0.9358495285253471
6,150,8,164,0.038461538461538464,0.9512195121951219,0.19013244299014748,0.9314168130232131
15,99,26,140,0.13157894736842105,0.8142857142857143,0.17874834895223582,0.9125052483973628
32,84,25,141,0.27586206896551724,0.8226950354609929,0.1560454147050737,0.8896179701909357
7,100,2,109,0.06542056074766354,0.981651376146789,0.1311581610396642,0.8920761032912707
12,52,2,66,0.1875,0.9696969696969697,0.12258319640034314,0.889147659186356
9,112,12,133,0.0743801652892562,0.9097744360902256,0.11998142107129509,0.8883648304437973
13,36,1,50,0.2653061224489796,0.98,0.14835848618305406,0.9184747205536875
21,78,1,100,0.21212121212121213,0.99,0.17316701099157888,0.9240147902400987
7,19,4,30,0.2692307692307692,0.8666666666666667,0.19283155697191434,0.9314977834373775
10,75,11,96,0.11764705882352941,0.8854166666666666,0.17022941266591607,0.9404580164667596
16,38,2,56,0.2962962962962963,0.9642857142857143,0.20321166060143506,0.9379772076294631
0,4,58,62,0.0,0.06451612903225806,0.17642594631572076,0.8086656589630757
12,186,10,208,0.06060606060606061,0.9519230769230769,0.17445821707526424,0.8146868933677689
44,175,16,235,0.2009132420091324,0.9319148936170213,0.16525923415528607,0.8078175924559147
40,100,13,153,0.2857142857142857,0.9150326797385621,0.17577253038286803,0.7971079752757093
4,59,2,65,0.06349206349206349,0.9692307692307692,0.14638128670591005,0.811759989927724
35,187,6,228,0.15765765765765766,0.9736842105263158,0.15209708653935694,0.8243696390505308
0,9,56,65,0.0,0.13846153846153847,0.10976904421131461,0.7063947567899344
7,6,2,15,0.5384615384615384,0.8666666666666667,0.18669212113439151,0.820987690737707
30,53,5,88,0.3614457831325301,0.9431818181818182,0.2296692243524586,0.8197389394889558
2,60,3,65,0.03225806451612903,0.9538461538461539,0.20557562756774383,0.8228719766645461
43,97,3,143,0.30714285714285716,0.9790209790209791,0.20863685205753976,0.83201316227632
14,111,471,596,0.112,0.20973154362416108,0.21556655727295926,0.7235132729039474
2,48,9,59,0.04,0.847457627118644,0.19875832046472247,0.7054809038457085
22,65,20,107,0.25287356321839083,0.8130841121495327,0.23488311521020686,0.8018555572297078
2,0,0,2,1.0,1.0,0.3008171811442728,0.820903176277327
5,11,1,17,0.3125,0.9411764705882353,0.29382492641105423,0.8206166980496723
18,83,4,105,0.1782178217821782,0.9619047619047619,0.3146763203062041,0.8217679277723304
46,80,23,149,0.36507936507936506,0.8456375838926175,0.3229529642971337,0.8027131570397074
27,31,4,62,0.46551724137931033,0.9354838709677419,0.3734554273513209,0.9063920609459332
10,19,2,31,0.3448275862068966,0.9354838709677419,0.41700222538087767,0.9189672386386615
8,15,1,24,0.34782608695652173,0.9583333333333334,0.4408700483226431,0.9397171273792045
41,57,19,117,0.41836734693877553,0.8376068376068376,0.3577796693138967,0.9165181041801812
21,88,2,111,0.1926605504587156,0.9819819819819819,0.34065974795085613,0.9223474629507165
0,1,0,1,0.0,1.0,0.3109567776538264,0.9277896398214648
31,91,3,125,0.2540983606557377,0.976,0.2939685616023785,0.9464128421225194
129,234,54,417,0.35537190082644626,0.8705035971223022,0.2782335129519694,0.9371299458588852
11,75,20,106,0.12790697674418605,0.8113207547169812,0.24231874608291218,0.9193923578230622
1,34,5,40,0.02857142857142857,0.875,0.1967109377421846,0.9074875959183002
0,12,2,14,0.0,0.8571428571428571,0.13694417389378813,0.9102784558520174
1,13,2,16,0.07142857142857142,0.875,0.11962531974662464,0.8949953155688771
36,173,59,268,0.1722488038277512,0.7798507462686567,0.14423229172201765,0.8635454221786851
42,106,23,171,0.28378378378378377,0.8654970760233918,0.14847306645459568,0.8477592901820268
3,19,4,26,0.13636363636363635,0.8461538461538461,0.11718617153133713,0.8442807543293903
10,23,93,126,0.30303030303030304,0.2619047619047619,0.142203789572211,0.7657927553562162
5,45,3,53,0.1,0.9433962264150944,0.15240787120486404,0.7755636448440867
9,168,28,205,0.05084745762711865,0.8634146341463415,0.15967179372302384,0.7764596129874416
23,143,3,169,0.13855421686746988,0.9822485207100592,0.1692611716428665,0.7917808302317358
29,113,8,150,0.20422535211267606,0.9466666666666667,0.17382924996928434,0.8156116760028801
45,70,2,117,0.391304347826087,0.9829059829059829,0.1891893305467562,0.8323843769861075
52,165,8,225,0.23963133640552994,0.9644444444444444,0.2039418591241696,0.8492830338847642
25,76,1,102,0.24752475247524752,0.9901960784313726,0.19601249475916166,0.9533246505314229
5,49,5,59,0.09259259259259259,0.9152542372881356,0.1949542937009606,0.9493043663704289
2,28,9,39,0.06666666666666667,0.7692307692307693,0.19721418070661031,0.9358495285253471
7,153,4,164,0.04375,0.975609756097561,0.18367072115411462,0.9349011335807045
15,99,26,140,0.13157894736842105,0.8142857142857143,0.17329266333350676,0.9159895689548542
32,83,26,141,0.2782608695652174,0.8156028368794326,0.15714359501052538,0.8920891195224898
10,97,2,109,0.09345794392523364,0.981651376146789,0.13626168179905448,0.8945472526228249
12,53,1,66,0.18461538461538463,0.9848484848484849,0.1272746292476455,0.8937833106824122
9,112,12,133,0.0743801652892562,0.9097744360902256,0.12467285391859743,0.8930004819398537
14,35,1,50,0.2857142857142857,0.98,0.15596537092540017,0.9231103720497437
22,77,1,100,0.2222222222222222,0.99,0.1814614026714319,0.9251661211786636
7,19,4,30,0.2692307692307692,0.8666666666666667,0.20112594865176736,0.9326491143759424
10,75,11,96,0.11764705882352941,0.8854166666666666,0.17818111854581195,0.9426225186312617
22,33,1,56,0.4,0.9821428571428571,0.22197284084220717,0.9426927302021285
0,4,58,62,0.0,0.06451612903225806,0.19559921446858075,0.8112166793712391
12,186,10,208,0.06060606060606061,0.9519230769230769,0.19363148522812423,0.817237913775932
45,174,16,235,0.2054794520547945,0.9319148936170213,0.18216936613391121,0.810368612864078
44,104,5,153,0.2972972972972973,0.9673202614379085,0.19289437685892194,0.8071286502123506
8,50,7,65,0.13793103448275862,0.8923076923076924,0.1741372718949204,0.8107916538753542
35,187,6,228,0.15765765765765766,0.9736842105263158,0.17985307172836731,0.8234013029981613
0,9,56,65,0.0,0.13846153846153847,0.1227102145855102,0.7028754003294015
6,7,2,15,0.46153846153846156,0.8666666666666667,0.1886442805195761,0.817468334277174
30,53,5,88,0.3614457831325301,0.9431818181818182,0.2316213837376432,0.8162195830284229
2,60,3,65,0.03225806451612903,0.9538461538461539,0.20687547123211955,0.8193526202040132
45,95,3,143,0.32142857142857145,0.9790209790209791,0.21032279610801588,0.8210241512873091
15,111,470,596,0.11904761904761904,0.21140939597315436,0.20762516533156733,0.7237529660966608
2,48,9,59,0.04,0.847457627118644,0.19081692852333054,0.7057205970384219
21,66,20,107,0.2413793103448276,0.8130841121495327,0.2252996871440202,0.8020952504224211
2,0,0,2,1.0,1.0,0.30222276406709714,0.8211428694700402
5,11,1,17,0.3125,0.9411764705882353,0.29523050933387857,0.8208563912423854
22,79,4,105,0.21782178217821782,0.9619047619047619,0.32173961185703404,0.8220076209650438
45,81,23,149,0.35714285714285715,0.8456375838926175,0.3268416526733606,0.8029528502324207
27,31,4,62,0.46551724137931033,0.9354838709677419,0.37633731300645934,0.9063920609459332
12,17,2,31,0.41379310344827586,0.9354838709677419,0.42973632778478443,0.9189672386386615
9,14,1,24,0.391304347826087,0.9583333333333334,0.4494657492735006,0.939863422456375
39,59,19,117,0.3979591836734694,0.8376068376068376,0.36345991836971053,0.9166643992573519
23,86,2,111,0.21100917431192662,0.9819819819819819,0.3489612289857,0.922493758027887
0,1,0,1,0.0,1.0,0.3206726858456717,0.9279359348986355
30,92,3,125,0.2459016393442623,0.976,0.30251350960687023,0.9465591371996902
151,211,55,417,0.4171270718232044,0.86810551558753,0.29672778863246113,0.9367873627824892
12,74,20,106,0.13953488372093023,0.8113207547169812,0.2575480429571261,0.9190497747466662
0,35,5,40,0.0,0.875,0.20164742183911363,0.9071450128419043
0,12,2,14,0.0,0.8571428571428571,0.14479610988576086,0.9099358727756213
1,13,2,16,0.07142857142857142,0.875,0.12485602375956725,0.894652732492481
36,172,59,267,0.17307692307692307,0.7790262172284644,0.14958129848484197,0.8630850492394045
43,106,22,171,0.28859060402684567,0.8713450292397661,0.15567972201092534,0.8481343391307996
3,19,4,26,0.13636363636363635,0.8461538461538461,0.11557065980241561,0.8449983863545592
10,23,93,126,0.30303030303030304,0.2619047619047619,0.13892714827518313,0.766510387381385
6,44,3,53,0.12,0.9433962264150944,0.1560700054180403,0.7762812768692556
9,169,27,205,0.05056179775280899,0.8682926829268293,0.1632931193827273,0.7778741091241088
23,143,3,169,0.13855421686746988,0.9822485207100592,0.17288249730256994,0.793195326368403
32,110,8,150,0.22535211267605634,0.9466666666666667,0.1803503815310175,0.8171439620024319
45,70,2,117,0.391304347826087,0.9829059829059829,0.1950237735023377,0.8330812410976056
52,165,8,225,0.23963133640552994,0.9644444444444444,0.2097763020797511,0.8499798979962625
25,76,1,102,0.24752475247524752,0.9901960784313726,0.20184693771474316,0.9540215146429212
6,48,5,59,0.1111111111111111,0.9152542372881356,0.20057709644490188,0.9500012304819271
2,28,9,39,0.06666666666666667,0.7692307692307693,0.2028777920040244,0.9358495285253471
7,153,4,164,0.04375,0.975609756097561,0.1893343324515287,0.9349011335807045
15,99,26,140,0.13157894736842105,0.8142857142857143,0.17593816597900938,0.9159895689548542
35,81,25,141,0.3017241379310345,0.8226950354609929,0.16314099313685904,0.893102290748427
9,98,2,109,0.08411214953271028,0.981651376146789,0.14092396644074193,0.895560423848762
11,54,1,66,0.16923076923076924,0.9848484848484849,0.12973911169153077,0.8947964819083494
9,112,12,133,0.0743801652892562,0.9097744360902256,0.12449183371698004,0.8940136531657908
13,36,1,50,0.2653061224489796,0.98,0.15286889882873902,0.924123543275681
22,77,1,100,0.2222222222222222,0.99,0.1783649305747708,0.9261792924046007
6,20,4,30,0.23076923076923078,0.8666666666666667,0.19253497106060077,0.9336622856018798
10,74,12,96,0.11904761904761904,0.875,0.16643832550582713,0.9411344233931666
21,34,1,56,0.38181818181818183,0.9821428571428571,0.20896775868946588,0.9412046349640333
0,4,58,62,0.0,0.06451612903225806,0.18479193451364173,0.8097285841331437
14,184,10,208,0.0707070707070707,0.9519230769230769,0.18426720671618663,0.8157498185378369
46,174,15,235,0.20909090909090908,0.9361702127659575,0.176236461950748,0.8094884203615449
49,100,4,153,0.3288590604026846,0.9738562091503268,0.19147029597652837,0.8071821645258774
7,51,7,65,0.1206896551724138,0.8923076923076924,0.1757446423198402,0.8108451681888811
38,184,6,228,0.17117117117117117,0.9736842105263158,0.18319086405177623,0.8249429125497834
0,10,55,65,0.0,0.15384615384615385,0.12864540950632167,0.7066148120788258
7,6,2,15,0.5384615384615384,0.8666666666666667,0.2055684864293986,0.8212077460265984
31,52,5,88,0.37349397590361444,0.9431818181818182,0.24882375860033343,0.8199589947778472
3,59,3,65,0.04838709677419355,0.9538461538461539,0.22586607112651694,0.8224841292178754
45,95,3,143,0.32142857142857145,0.9790209790209791,0.2248045727016436,0.8232219534851114
21,104,471,596,0.168,0.20973154362416108,0.2315631933912988,0.7257110751017496
2,48,9,59,0.04,0.847457627118644,0.21282445465256009,0.7076787060435109
19,68,20,107,0.21839080459770116,0.8130841121495327,0.24402314102366024,0.8018555572297077
2,0,0,2,1.0,1.0,0.30995720695772616,0.8209031762773268
5,11,1,17,0.3125,0.9411764705882353,0.30124378182863837,0.8206166980496722
21,80,4,105,0.2079207920792079,0.9619047619047619,0.3240343097293547,0.8217679277723304
47,79,23,149,0.373015873015873,0.8456375838926175,0.33140392424182635,0.8027131570397074
27,31,4,62,0.46551724137931033,0.9354838709677419,0.3739063872960136,0.9063920609459332
11,18,2,31,0.3793103448275862,0.9354838709677419,0.4223792936999545,0.9189672386386614
9,14,1,24,0.391304347826087,0.9583333333333334,0.4588629903334086,0.9382577289839105
39,61,17,117,0.39,0.8547008547008547,0.37172013319055147,0.9175007082268898
23,86,2,111,0.21100917431192662,0.9819819819819819,0.357221443806541,0.9233300669974248
0,1,0,1,0.0,1.0,0.32268455212679215,0.92934510459141
33,89,3,125,0.27049180327868855,0.976,0.3068468194232635,0.9483655127546751
136,201,80,417,0.4035608308605341,0.8081534772182254,0.30154437153166896,0.9300291614275736
11,75,20,106,0.12790697674418605,0.8113207547169812,0.256324733288775,0.912927200278768
0,35,5,40,0.0,0.875,0.20042411217076256,0.9010224383740061
0,13,1,14,0.0,0.9285714285714286,0.14470982645647684,0.9115753774983737
1,14,1,16,0.06666666666666667,0.9375,0.12408946822143971,0.9052208086438049
37,175,55,267,0.17452830188679244,0.7940074906367042,0.14902208277669576,0.8757933073061911
43,104,22,169,0.2925170068027211,0.8698224852071006,0.15216854042298614,0.8606250909072054
3,23,0,26,0.11538461538461539,1.0,0.11100050964071202,0.8880317370188876
9,47,70,126,0.16071428571428573,0.4444444444444444,0.11568726806501196,0.8356208355513823
6,44,3,53,0.12,0.9433962264150944,0.1328301252078691,0.845391725039253
11,166,27,204,0.062146892655367235,0.8676470588235294,0.14170825273006443,0.836688243646696
22,144,3,169,0.13253012048192772,0.9822485207100592,0.151117317560816,0.8430808894624188
30,112,8,150,0.2112676056338028,0.9466666666666667,0.15636578952467461,0.8648893431809849
44,71,2,117,0.3826086956521739,0.9829059829059829,0.1692360307888822,0.8810441285665396
52,165,7,224,0.23963133640552994,0.96875,0.18698556236329855,0.8765798428522539
25,76,1,102,0.24752475247524752,0.9901960784313726,0.1993870576148645,0.9545443619932436
5,53,1,59,0.08620689655172414,0.9830508474576272,0.19455947140796798,0.9602093078564625
2,28,9,39,0.06666666666666667,0.7692307692307693,0.1952051534095822,0.9461498379146395
6,154,4,164,0.0375,0.975609756097561,0.1816294219121639,0.945201442969997
15,100,25,140,0.13043478260869565,0.8214285714285714,0.17008187576572006,0.9273102865074119
36,80,25,141,0.3103448275862069,0.8226950354609929,0.15975846604201047,0.9044230083009847
8,99,2,109,0.07476635514018691,0.981651376146789,0.13620632586124717,0.9062660620362403
13,52,1,66,0.2,0.9848484848484849,0.1294170755076404,0.9055021200958278
9,76,48,133,0.10588235294117647,0.6390977443609023,0.1322278549918479,0.8563659625105814
14,35,1,50,0.2857142857142857,0.98,0.1635203719986506,0.8864758526204716
22,77,1,100,0.2222222222222222,0.99,0.18990926088753948,0.8885316017493913
6,20,4,30,0.23076923076923078,0.8666666666666667,0.20424275348190163,0.894994186783405
12,73,11,96,0.1411764705882353,0.8854166666666666,0.18007584533933427,0.9039544198127869
22,33,1,56,0.4,0.9821428571428571,0.22653779460502185,0.9040246313836539
0,4,58,62,0.0,0.06451612903225806,0.19796636603359327,0.7725485805527643
12,186,10,208,0.06060606060606061,0.9519230769230769,0.19149832427143387,0.817237913775932
48,174,13,235,0.21621621621621623,0.9446808510638298,0.1815700286288525,0.8121923210707649
51,99,3,153,0.34,0.9803921568627451,0.19839542545424935,0.8108197720511571
8,51,6,65,0.13559322033898305,0.9076923076923077,0.18479885253564254,0.8166805779119628
36,186,6,228,0.16216216216216217,0.9736842105263158,0.18779680847477492,0.82929022703477
5,59,1,65,0.078125,0.9846153846153847,0.14181466561763206,0.829643445245131
6,7,2,15,0.46153846153846156,0.8666666666666667,0.20774873155169798,0.9442363791929037
30,53,5,88,0.3614457831325301,0.9431818181818182,0.25072583476976507,0.9429876279441525
2,60,3,65,0.03225806451612903,0.9538461538461539,0.22444609881260977,0.9442969569130558
47,93,3,143,0.3357142857142857,0.9790209790209791,0.22383385391465055,0.9441010743642321
17,109,470,596,0.1349206349206349,0.21140939597315436,0.22373777028345798,0.8446320869757817
2,48,9,59,0.04,0.847457627118644,0.2062860328317205,0.8265997179175429
22,65,20,107,0.25287356321839083,0.8130841121495327,0.23125011329149064,0.8020952504224211
2,0,0,2,1.0,1.0,0.30817319021456757,0.8211428694700401
5,11,1,17,0.3125,0.9411764705882353,0.30118093548134894,0.8208563912423854
20,81,4,105,0.19801980198019803,0.9619047619047619,0.3248611836905017,0.8220076209650439
47,79,23,149,0.373015873015873,0.8456375838926175,0.3301899818764427,0.8029528502324207
27,32,4,63,0.4576271186440678,0.9365079365079365,0.3762909081226474,0.9065383560231038
12,17,2,31,0.41379310344827586,0.9354838709677419,0.4296899229009726,0.919113533715832
8,13,1,22,0.38095238095238093,0.9545454545454546,0.3875198203285374,0.9377166034427848
38,58,19,115,0.3958333333333333,0.8347826086956521,0.372638867947585,0.9141141189707351
17,77,2,96,0.18085106382978725,0.9791666666666666,0.36276044849469746,0.9195412898390825
0,1,0,1,0.0,1.0,0.32665369810223277,0.9255563274330675
30,76,3,109,0.2830188679245283,0.9724770642201835,0.3138161998154221,0.944073459056359
139,201,38,378,0.4088235294117647,0.8994708994708994,0.30442295099046834,0.9387824537653537
12,65,20,97,0.15584415584415584,0.7938144329896907,0.25790333304227897,0.9191795895126494
0,28,5,33,0.0,0.8484848484848485,0.203481564334796,0.9040280743611343
0,12,2,14,0.0,0.8571428571428571,0.14693394528717693,0.9072223955678779
1,8,2,11,0.1111111111111111,0.8181818181818182,0.13697109489879464,0.8842245600700424
40,140,59,239,0.2222222222222222,0.7531380753138075,0.16871712664482638,0.8489585708291577
40,94,22,156,0.29850746268656714,0.8589743589743589,0.17092978303940334,0.8327438986511828
3,18,4,25,0.14285714285714285,0.84,0.13293458496017166,0.8242480558696258
10,23,89,122,0.30303030303030304,0.27049180327868855,0.15396117741533555,0.7494876801966254
6,40,3,49,0.13043478260869565,0.9387755102040817,0.17259471778800634,0.7623863461565159
9,151,26,186,0.05625,0.8602150537634409,0.18063043207372062,0.7628252313880279
19,112,3,134,0.1450381679389313,0.9776119402985075,0.18547715447769497,0.7856009631189834
29,107,8,144,0.21323529411764705,0.9444444444444444,0.18419330760561278,0.8129304444233602
43,61,3,107,0.41346153846153844,0.9719626168224299,0.20061531843060867,0.8290716241159418
52,165,7,224,0.23963133640552994,0.96875,0.2144402032232354,0.8474644812587988
16,66,1,83,0.1951219512195122,0.9879518072289156,0.19902472439312244,0.9499587675374028
5,47,1,53,0.09615384615384616,0.9811320754716981,0.19412744775671537,0.9560097054327764
2,26,8,36,0.07142857142857142,0.7777777777777778,0.19629581510365415,0.9442329517205389
6,149,4,159,0.03870967741935484,0.9748427672955975,0.18110603074371465,0.943837355577266
15,90,26,131,0.14285714285714285,0.8015267175572519,0.17105200913507118,0.9234205374505242
33,66,25,124,0.3333333333333333,0.7983870967741935,0.15960512268818475,0.8986240345864905
7,93,2,102,0.07,0.9803921568627451,0.1353720746302519,0.900287199852597
12,52,1,65,0.1875,0.9846153846153847,0.13428322445603585,0.899810568050664
9,99,12,120,0.08333333333333333,0.9,0.13245172262453403,0.8882202715547071
6,40,1,47,0.13043478260869565,0.9787234042553191,0.14088118136455177,0.9169267896229273
24,72,1,97,0.25,0.9896907216494846,0.1710655131617868,0.9190479259591969
5,20,4,29,0.2,0.8620689655172413,0.17922877846790924,0.9276968185249096
8,61,11,80,0.11594202898550725,0.8625,0.14817287784679123,0.9368558047000247
22,29,1,52,0.43137254901960786,0.9807692307692307,0.19979752770673523,0.9369096724009512
0,2,58,60,0.0,0.03333333333333333,0.17301181342102095,0.8010122365035155
9,160,10,179,0.05325443786982249,0.9441340782122905,0.16871482835480509,0.807317104819557
47,137,15,199,0.2554347826086957,0.9246231155778895,0.18657197121194796,0.7995884921513527
50,86,3,139,0.36764705882352944,0.9784172661870504,0.2033786939010236,0.7979779985138621
9,47,7,63,0.16071428571428573,0.8888888888888888,0.1977664490030644,0.8018094161383832
34,171,6,211,0.16585365853658537,0.9715639810426541,0.2048966817960756,0.8173899848587624
1,9,55,65,0.1,0.15384615384615385,0.15755774622184585,0.6992581167268943
7,5,2,14,0.5833333333333334,0.8571428571428571,0.24089107955517924,0.8169451915568261
29,42,5,76,0.4084507042253521,0.9342105263157895,0.2916334033202549,0.8155275412858974
1,60,3,64,0.01639344262295082,0.953125,0.25748464046514846,0.8195992390604846
47,72,3,122,0.3949579831932773,0.9754098360655737,0.2613862010893982,0.8191696061859881
19,74,413,506,0.20430107526881722,0.18379446640316205,0.26761288531147415,0.7184418315451699
1,43,9,53,0.022727272727272728,0.8301886792452831,0.24716625876728657,0.6982453598598312
22,59,20,101,0.2716049382716049,0.801980198019802,0.27168124994894444,0.7908359375989237
2,0,0,2,1.0,1.0,0.33120505947275397,0.8112441008642299
5,11,1,17,0.3125,0.9411764705882353,0.3174978160119894,0.8122392357602937
22,69,4,95,0.24175824175824176,0.9578947368421052,0.34969278731703085,0.8129206267377372
45,73,22,140,0.3813559322033898,0.8428571428571429,0.3477496371756184,0.7939845277079615
26,33,4,63,0.4406779661016949,0.9365079365079365,0.38151776443745805,0.9015150234372148
12,15,2,29,0.4444444444444444,0.9310344827586207,0.4417630746827683,0.9159215667962631
7,14,1,22,0.3333333333333333,0.9545454545454546,0.43421472629496793,0.9385169277877327
38,57,20,115,0.4,0.8260869565217391,0.3485004405806822,0.9136722072908384
19,75,2,96,0.20212765957446807,0.9791666666666666,0.3416615348056062,0.9190993781591857
0,1,0,1,0.0,1.0,0.3119585645085765,0.924541555029934
31,74,3,108,0.29523809523809524,0.9722222222222222,0.30765017448590076,0.9434304439188229
127,215,35,377,0.3713450292397661,0.9071618037135278,0.2929028542078044,0.9392381392339073
12,65,20,97,0.15584415584415584,0.7938144329896907,0.2511268961756887,0.9189996480941858
0,28,5,33,0.0,0.8484848484848485,0.20350784855664109,0.9038481329426707
0,12,2,14,0.0,0.8571428571428571,0.14636499141378392,0.908284690174259
1,8,2,11,0.1111111111111111,0.8181818181818182,0.1333626273475901,0.8852868546764234
39,142,59,240,0.2154696132596685,0.7541666666666667,0.1641440006703999,0.8501678070573757
41,96,21,158,0.29927007299270075,0.8670886075949367,0.1647199974924864,0.8351487192534778
4,17,4,25,0.19047619047619047,0.84,0.13888159195483274,0.8255541758658309
8,22,92,122,0.26666666666666666,0.2459016393442623,0.1547133792151914,0.7472809196307697
6,40,3,49,0.13043478260869565,0.9387755102040817,0.17334691958786222,0.7601795855906603
7,154,26,187,0.043478260869565216,0.8609625668449198,0.1795580997120858,0.7607252584052405
21,110,3,134,0.16030534351145037,0.9776119402985075,0.18658584719784857,0.7835009901361962
26,111,7,144,0.1897810218978102,0.9513888888888888,0.18291604843186882,0.8116755933107994
44,60,3,107,0.4230769230769231,0.9719626168224299,0.2006027413010434,0.8266575946290127
52,165,7,224,0.23963133640552994,0.96875,0.20762490500523478,0.8450504517718699
16,66,1,83,0.1951219512195122,0.9879518072289156,0.197404231369927,0.9510576186125347
6,46,1,53,0.11538461538461539,0.9811320754716981,0.19525420748077268,0.9571085565079084
1,27,8,36,0.03571428571428571,0.7777777777777778,0.1941450681728756,0.9452250152126025
6,149,4,159,0.03870967741935484,0.9748427672955975,0.17677425873114766,0.9448294190693296
15,90,26,131,0.14285714285714285,0.8015267175572519,0.17007084743962378,0.9234205374505243
31,67,26,124,0.3163265306122449,0.7903225806451613,0.15482079137324117,0.8974719608537717
7,93,2,102,0.07,0.9803921568627451,0.13058774331530834,0.8991351261198781
11,52,1,64,0.1746031746031746,0.984375,0.1276564895129744,0.8986241536586045
10,98,12,120,0.09259259259259259,0.9,0.12440048625697113,0.8870338571626475
13,33,1,47,0.2826086956521739,0.9787234042553191,0.15967111624809802,0.9157403752308676
23,73,1,97,0.23958333333333334,0.9896907216494846,0.18836735280723782,0.9178615115671372
7,18,4,29,0.28,0.8620689655172413,0.20795918954193168,0.92651040413285
7,60,13,80,0.1044776119402985,0.8375,0.17769505830308224,0.9332500354692556
23,28,1,52,0.45098039215686275,0.9807692307692307,0.23212082861120548,0.9333039031701821
0,2,58,60,0.0,0.03333333333333333,0.20717751795360909,0.7974408079320868
10,159,10,179,0.05917159763313609,0.9441340782122905,0.20240309010225818,0.8037456762481284
48,137,14,199,0.2594594594594595,0.9296482412060302,0.19909605636044184,0.7967349386696585
48,88,3,139,0.35294117647058826,0.9784172661870504,0.21529003395147822,0.795124445032168
8,48,7,63,0.14285714285714285,0.8888888888888888,0.19569819721678433,0.7989558626566892
32,173,6,211,0.15609756097560976,0.9715639810426541,0.20307247565040024,0.8181078599484968
0,9,56,65,0.0,0.13846153846153847,0.138646705342277,0.6977781896188263
6,6,2,14,0.5,0.8571428571428571,0.21007527677084842,0.8154652644487584
30,41,5,76,0.4225352112676056,0.9342105263157895,0.26198436443291545,0.8140476141778297
1,60,3,64,0.01639344262295082,0.953125,0.22726064774198565,0.8174014368626825
48,71,3,122,0.40336134453781514,0.9754098360655737,0.2344635288944467,0.8169718039881858
20,73,412,505,0.21505376344086022,0.18415841584158416,0.2447773318349777,0.7162960221242851
1,43,9,53,0.022727272727272728,0.8301886792452831,0.2257244335137867,0.6960995504389464
21,60,20,101,0.25925925925925924,0.801980198019802,0.2627614705508238,0.7908879303758413
1,1,0,2,0.5,1.0,0.2627614705508238,0.8112960936411474
4,12,1,17,0.25,0.9411764705882353,0.23811358322688012,0.8122912285372111
23,68,4,95,0.25274725274725274,0.9578947368421052,0.2718784132446375,0.8129726195146547
44,74,22,140,0.3728813559322034,0.8428571428571429,0.2675241291581215,0.7940365204848788
28,31,4,63,0.4745762711864407,0.9365079365079365,0.30459877312177586,0.9015150234372149
13,14,2,29,0.48148148148148145,0.9310344827586207,0.37013508865809147,0.915921566796263
7,16,1,24,0.30434782608695654,0.9583333333333334,0.4290313944746519,0.9381056723764774
39,59,19,117,0.3979591836734694,0.8376068376068376,0.34302556357086184,0.9149066491774542
19,91,2,112,0.17272727272727273,0.9821428571428571,0.33198660253190077,0.9207589901138287
0,1,0,1,0.0,1.0,0.30369805939187244,0.926201166984577
31,89,3,123,0.25833333333333336,0.975609756097561,0.2937456784394915,0.9465263702366096
126,254,36,416,0.33157894736842103,0.9134615384615384,0.27331748932263156,0.9432340276585526
12,73,20,105,0.1411764705882353,0.8095238095238095,0.22944614768252722,0.9252397331665623
0,35,5,40,0.0,0.875,0.185967886812962,0.9133349712618004
0,12,2,14,0.0,0.8571428571428571,0.12911657485960928,0.9161258311955175
2,12,2,16,0.14285714285714285,0.875,0.1248494134495907,0.9008197087465379
40,169,58,267,0.19138755980861244,0.7827715355805244,0.15219049342224963,0.8697870709723271
41,109,21,171,0.2733333333333333,0.8771929824561403,0.15433335056510677,0.8557275318806956
3,19,4,26,0.13636363636363635,0.8461538461538461,0.12644544899299467,0.8461121472653109
11,22,93,126,0.3333333333333333,0.2619047619047619,0.15389642938515152,0.7678808547483041
6,44,3,53,0.12,0.9433962264150944,0.17103928652800868,0.7776517442361748
12,167,27,206,0.0670391061452514,0.8689320388349514,0.18061630169161602,0.779335913049331
19,147,3,169,0.1144578313253012,0.9822485207100592,0.1765592571870672,0.7946571302936253
29,113,7,149,0.20422535211267606,0.9530201342281879,0.17839322751621917,0.818978358671863
45,69,2,116,0.39473684210526316,0.9827586206896551,0.19573658591220913,0.8340591641337936
52,165,7,224,0.23963133640552994,0.96875,0.21048911448962251,0.8515729003975299
22,77,1,100,0.2222222222222222,0.99,0.19461609861660661,0.9555865058397067
5,50,5,60,0.09090909090909091,0.9166666666666666,0.19046025446076248,0.9517679973042171
2,28,9,39,0.06666666666666667,0.7692307692307693,0.19040704882096465,0.937524958789334
6,149,8,163,0.03870967741935484,0.950920245398773,0.17958588397725803,0.9330494908877215
15,99,26,140,0.13157894736842105,0.8142857142857143,0.16920782615665014,0.9132302880387968
33,83,25,141,0.28448275862068967,0.8226950354609929,0.1534572428017111,0.8903640615775593
8,99,2,109,0.07476635514018691,0.981651376146789,0.12990510262094782,0.8922071153128149
12,52,2,66,0.1875,0.9696969696969697,0.12494478516063036,0.889306682412382
9,111,12,132,0.075,0.9090909090909091,0.12267205788790307,0.8882244313301308
12,37,1,50,0.24489795918367346,0.98,0.14813367110461836,0.9183343214400209
21,77,1,99,0.21428571428571427,0.98989898989899,0.17321596208552684,0.9239027135114807
8,18,4,30,0.3076923076923077,0.8666666666666667,0.19837501356036777,0.9313857067087595
9,76,11,96,0.10588235294117647,0.8854166666666666,0.1728606698918659,0.9403459397381414
19,35,2,56,0.35185185185185186,0.9642857142857143,0.2124443122792466,0.9378651309008451
0,4,58,62,0.0,0.06451612903225806,0.18565859799353232,0.8085535822344577
10,188,10,208,0.050505050505050504,0.9519230769230769,0.18215931949425385,0.8146724633533388
45,176,14,235,0.20361990950226244,0.9404255319148936,0.17626245525405224,0.8090189679126094
41,98,13,152,0.2949640287769784,0.9144736842105263,0.18778792875280428,0.7982439242428289
8,50,7,65,0.13793103448275862,0.8923076923076924,0.16353631829429724,0.8019069279058325
33,189,6,228,0.14864864864864866,0.9736842105263158,0.16964578910965042,0.8145165770286394
0,9,56,65,0.0,0.13846153846153847,0.11938123884510017,0.696541694768043
6,7,2,15,0.46153846153846156,0.8666666666666667,0.18531530477916608,0.8111346287158155
29,54,5,88,0.3493975903614458,0.9431818181818182,0.2280142390443654,0.8098858774670644
2,60,3,65,0.03225806451612903,0.9538461538461539,0.20353397547491778,0.8118031091715301
46,82,17,145,0.359375,0.8827586206896552,0.21273554279249232,0.8072723858114056
14,110,472,596,0.11290322580645161,0.2080536912751678,0.20916014155301985,0.7095218142353307
1,49,9,59,0.02,0.847457627118644,0.1907817631746415,0.691489445177092
20,67,20,107,0.22988505747126436,0.8130841121495327,0.22362248567053641,0.787864098561091
2,0,0,2,1.0,1.0,0.30054556259361337,0.8069117176087103
4,12,1,17,0.25,0.9411764705882353,0.28634590682769245,0.8066252393810555
21,80,4,105,0.2079207920792079,0.9619047619047619,0.3114405821938466,0.8077764691037137
41,85,24,150,0.3253968253968254,0.84,0.306586557250536,0.8016680947194772
28,31,4,63,0.4745762711864407,0.9365079365079365,0.35825413516196297,0.9057329868955871
13,16,2,31,0.4482758620689655,0.9354838709677419,0.4194364011718152,0.9183081645883153
7,16,1,24,0.30434782608695654,0.9583333333333334,0.4187062530319362,0.9409628152336201
38,60,19,117,0.3877551020408163,0.8376068376068376,0.33124269618062424,0.917763792034597
18,92,2,112,0.16363636363636364,0.9821428571428571,0.3278336052715333,0.9236161329709717
0,1,0,1,0.0,1.0,0.3009594892885064,0.9290583098417199
31,89,3,123,0.25833333333333336,0.975609756097561,0.2909892511932684,0.9465263702366096
126,256,34,416,0.3298429319371728,0.9182692307692307,0.27031305987194437,0.9439208408453659
11,74,20,105,0.12941176470588237,0.8095238095238095,0.2247610459629325,0.9259265463533755
0,35,5,40,0.0,0.875,0.1812827850933673,0.9140217844486136
0,12,2,14,0.0,0.8571428571428571,0.12588919908753637,0.9168126443823306
2,12,2,16,0.14285714285714285,0.875,0.12292073897621912,0.9015065219333511
42,166,59,267,0.20192307692307693,0.7790262172284644,0.15176689282237296,0.8699388386802746
42,108,21,171,0.28,0.8771929824561403,0.15486213091761106,0.855879299588643
3,19,4,26,0.13636363636363635,0.8461538461538461,0.127222231549963,0.8455771017864453
9,25,92,126,0.2647058823529412,0.2698412698412698,0.14654996264239997,0.768479596117511
6,44,3,53,0.12,0.9433962264150944,0.16369281978525713,0.7782504856053816
12,167,27,206,0.0670391061452514,0.8689320388349514,0.17326983494886444,0.7799346544185379
21,145,3,169,0.12650602409638553,0.9822485207100592,0.17093396084018483,0.795255871662832
27,115,7,149,0.19014084507042253,0.9530201342281879,0.1692507848612342,0.8201121455199355
45,69,2,116,0.39473684210526316,0.9827586206896551,0.18564176230484322,0.8351929509818662
52,165,7,224,0.23963133640552994,0.96875,0.2003942908822566,0.8527066872456024
22,77,1,100,0.2222222222222222,0.99,0.19432519657786815,0.9555865058397066
8,47,5,60,0.14545454545454545,0.9166666666666666,0.1979615602142318,0.951767997304217
3,27,9,39,0.1,0.7692307692307693,0.20267025933633873,0.9375249587893338
6,153,4,163,0.03773584905660377,0.9754601226993865,0.1899888057592271,0.936555187644952
15,99,26,140,0.13157894736842105,0.8142857142857143,0.18162282037322686,0.9167359847960272
34,81,26,141,0.2956521739130435,0.8156028368794326,0.16746786777433836,0.8928565871088525
10,97,2,109,0.09345794392523364,0.981651376146789,0.14658595456286744,0.8946996408441082
11,53,2,66,0.171875,0.9696969696969697,0.13939349424540712,0.8917992079436754
9,112,12,133,0.0743801652892562,0.9097744360902256,0.12924001136465152,0.8908146035756123
12,37,1,50,0.24489795918367346,0.98,0.14993971981946203,0.9209244936855024
21,78,1,100,0.21212121212121213,0.99,0.1748519145429775,0.9230016190141616
7,19,4,30,0.2692307692307692,0.8666666666666667,0.19451646052331295,0.9304846122114404
10,76,10,96,0.11627906976744186,0.8958333333333334,0.16889173135965557,0.9419461117048549
19,35,2,56,0.35185185185185186,0.9642857142857143,0.2058051467777439,0.9394653028675582
0,4,58,62,0.0,0.06451612903225806,0.18125157534917244,0.8101537542011709
11,188,10,209,0.05527638190954774,0.9521531100478469,0.17852246343778552,0.8162078504808312
47,174,14,235,0.21266968325791855,0.9404255319148936,0.17391842401982055,0.8105543550401018
39,100,13,152,0.2805755395683453,0.9144736842105263,0.18369761365512524,0.7997648813558912
7,51,7,65,0.1206896551724138,0.8923076923076924,0.16247745450393164,0.8034278850188948
31,191,6,228,0.13963963963963963,0.9736842105263158,0.16581467877138847,0.8145494389036066
0,9,56,65,0.0,0.13846153846153847,0.1155501285068382,0.6965745566430102
6,7,2,15,0.46153846153846156,0.8666666666666667,0.18148419444090416,0.8111674905907827
29,54,5,88,0.3493975903614458,0.9431818181818182,0.22350150993403245,0.8098858774670644
2,60,3,65,0.03225806451612903,0.9538461538461539,0.1977284215423482,0.8118031091715301
44,84,17,145,0.34375,0.8827586206896552,0.206753344461156,0.8072723858114056
14,109,473,596,0.11382113821138211,0.2063758389261745,0.20577212775243722,0.7092821210426175
1,49,9,59,0.02,0.847457627118644,0.18868075066106016,0.6912497519843787
20,67,20,107,0.22988505747126436,0.8130841121495327,0.22152147315695506,0.7876244053683777
2,0,0,2,1.0,1.0,0.298444550080032,0.8066720244159968
4,12,1,17,0.25,0.9411764705882353,0.28424489431411115,0.8063855461883421
20,81,4,105,0.19801980198019803,0.9619047619047619,0.30792514252326386,0.8075367759110004
41,84,25,150,0.328,0.8333333333333334,0.30567514252326383,0.8004760205743829
28,31,4,63,0.4745762711864407,0.9365079365079365,0.35721159009112935,0.9047806059432062
13,16,2,31,0.4482758620689655,0.9354838709677419,0.4183938561009816,0.9173557836359344
8,15,1,24,0.34782608695652173,0.9583333333333334,0.4272982432815073,0.940910486609863
37,60,20,117,0.38144329896907214,0.8290598290598291,0.338933000277089,0.9164904621898387
20,90,2,112,0.18181818181818182,0.9821428571428571,0.3291927405368293,0.9223428031262132
0,1,0,1,0.0,1.0,0.30347845482254365,0.9278373086207187
32,88,3,123,0.26666666666666666,0.975609756097561,0.29023440720349597,0.9453053690156084
133,248,35,416,0.34908136482939633,0.9158653846153846,0.2723065634382039,0.942356433030958
13,72,20,105,0.15294117647058825,0.8095238095238095,0.23996811081577565,0.9243621385389675
0,35,5,40,0.0,0.875,0.1902786698219868,0.9124573766342058
0,12,2,14,0.0,0.8571428571428571,0.13578676996926223,0.9164692377889241
2,12,2,16,0.14285714285714285,0.875,0.1302209072605424,0.9011631153399444
41,167,59,267,0.1971153846153846,0.7790262172284644,0.15838024791988303,0.869595432086868
43,106,22,171,0.28859060402684567,0.8713450292397661,0.16151223897133718,0.854700471107183
4,18,4,26,0.18181818181818182,0.8461538461538461,0.1376174985411637,0.8447416798983918
9,22,95,126,0.2903225806451613,0.24603174603174602,0.15724341342324552,0.7642428136852398
6,44,3,53,0.12,0.9433962264150944,0.1743862705661027,0.7740137031731104
9,170,27,206,0.05027932960893855,0.8689320388349514,0.1815690319388082,0.7756978719862667
20,146,3,169,0.12048192771084337,0.9822485207100592,0.178372572632194,0.791019089230561
28,113,8,149,0.19858156028368795,0.9463087248322147,0.17858202629909448,0.814916590316811
47,67,2,116,0.41228070175438597,0.9827586206896551,0.19625204026017165,0.8308328176667951
53,164,7,224,0.24423963133640553,0.96875,0.20516939019134645,0.8483465539305314
23,76,1,100,0.23232323232323232,0.99,0.19688376900249946,0.9546277330688534
5,50,5,60,0.09090909090909091,0.9166666666666666,0.1927279248466553,0.9508092245333638
2,28,9,39,0.06666666666666667,0.7692307692307693,0.1950689729977593,0.9365661860184806
6,153,4,163,0.03773584905660377,0.9754601226993865,0.18324810461858224,0.9355964148740988
15,99,26,140,0.13157894736842105,0.8142857142857143,0.17367630277354412,0.9167359847960272
37,79,25,141,0.31896551724137934,0.8226950354609929,0.16034556212882886,0.8938697583347899
8,99,2,109,0.07476635514018691,0.981651376146789,0.13613509410079766,0.8957128120700454
11,54,1,66,0.16923076923076924,0.9848484848484849,0.12712188508758865,0.8949768813341147
10,111,12,133,0.08264462809917356,0.9097744360902256,0.12594124754331473,0.8939922769660517
13,36,1,50,0.2653061224489796,0.98,0.15431831265507373,0.9241021670759417
23,76,1,100,0.23232323232323232,0.99,0.18211651026459208,0.9261792924046007
5,21,4,30,0.19230769230769232,0.8666666666666667,0.1907920452559166,0.9336622856018797
9,76,11,96,0.10588235294117647,0.8854166666666666,0.1603515932130304,0.9426225186312617
18,36,1,55,0.3333333333333333,0.9818181818181818,0.1972897329549085,0.9426463480128893
0,4,58,62,0.0,0.06451612903225806,0.17311390877908428,0.8111702971819996
10,189,10,209,0.05025125628140704,0.9521531100478469,0.1684862842336891,0.8172243934616599
44,177,14,235,0.19909502262443438,0.9404255319148936,0.1590275556873255,0.8115708980209304
48,100,4,152,0.32432432432432434,0.9736842105263158,0.17217056883033863,0.8092400709532612
9,49,7,65,0.15517241379310345,0.8923076923076924,0.16686552904254023,0.8129030746162649
34,188,6,228,0.15315315315315314,0.9736842105263158,0.17361850050139402,0.8255127237390719
0,10,55,65,0.0,0.15384615384615385,0.1259994528823464,0.7072310054573537
7,6,2,15,0.5384615384615384,0.8666666666666667,0.20292252980542333,0.8218239394051263
29,54,5,88,0.3493975903614458,0.9431818181818182,0.24565772038828598,0.8205423262814079
2,60,3,65,0.03225806451612903,0.9538461538461539,0.2218238692299567,0.8224595579858737
46,82,17,145,0.359375,0.8827586206896552,0.22683110861219605,0.8094701880092078
15,110,471,596,0.12,0.20973154362416108,0.22180647807032414,0.7119593096258463
1,49,9,59,0.02,0.847457627118644,0.20278459904844512,0.6939269405676074
22,65,20,107,0.25287356321839083,0.8130841121495327,0.2389093937939295,0.7881037917538044
2,0,0,2,1.0,1.0,0.3048434597279955,0.8071514108014235
3,13,1,17,0.1875,0.9411764705882353,0.28171523253350317,0.8068649325737687
19,82,4,105,0.18811881188118812,0.9619047619047619,0.30398105358565447,0.808016162296427
42,86,22,150,0.328125,0.8533333333333334,0.29951676787136877,0.8038125498169525
28,31,4,63,0.4745762711864407,0.9365079365079365,0.35017052089800316,0.907637748800349
13,16,2,31,0.4482758620689655,0.9354838709677419,0.4113527869078554,0.9202129264930773
7,16,1,24,0.30434782608695654,0.9583333333333334,0.4240655669272333,0.9413317320311085
38,59,20,117,0.3917525773195876,0.8290598290598291,0.33717307797288865,0.916911707611084
19,91,2,112,0.17272727272727273,0.9821428571428571,0.3261341169339276,0.9227640485474585
0,1,0,1,0.0,1.0,0.29784557379389925,0.9268849276683377
32,88,3,123,0.26666666666666666,0.975609756097561,0.28419727983064474,0.9453053690156084
130,250,36,416,0.34210526315789475,0.9134615384615384,0.265272850112281,0.9420130264375516
11,74,20,105,0.12941176470588237,0.8095238095238095,0.22957305295203762,0.9240187319455612
0,35,5,40,0.0,0.875,0.1860947920824724,0.9121139700407992
0,12,2,14,0.0,0.8571428571428571,0.13013013817967414,0.9161258311955175
3,11,2,16,0.21428571428571427,0.875,0.13606705840230865,0.9008197087465379
40,173,55,268,0.18779342723004694,0.7947761194029851,0.16289469086374392,0.8715020115183928
43,106,22,171,0.28859060402684567,0.8713450292397661,0.1660266819151981,0.8566070505387078
3,19,4,26,0.13636363636363635,0.8461538461538461,0.13663502094458974,0.8469916659233233
10,24,92,126,0.29411764705882354,0.2698412698412698,0.16016443270929562,0.7698941602543891
5,45,3,53,0.1,0.9433962264150944,0.1744501469950099,0.7796650497422597
9,170,27,206,0.05027932960893855,0.8689320388349514,0.18163290836771542,0.7813492185554161
20,146,3,169,0.12048192771084337,0.9822485207100592,0.16823236742844813,0.7966704357997102
29,113,7,149,0.20422535211267606,0.9530201342281879,0.17057978526882372,0.8192767236318821
44,70,2,116,0.38596491228070173,0.9827586206896551,0.1844904007336603,0.8351929509818662
53,164,7,224,0.24423963133640553,0.96875,0.19990125715834164,0.8527066872456024
23,76,1,100,0.23232323232323232,0.99,0.19107348362468574,0.9555865058397067
6,49,5,60,0.10909090909090909,0.9166666666666666,0.19237218492338704,0.951767997304217
1,29,9,39,0.03333333333333333,0.7692307692307693,0.18995132831258627,0.9375249587893338
6,153,4,163,0.03773584905660377,0.9754601226993865,0.1781304599334092,0.936555187644952
14,99,27,140,0.12389380530973451,0.8071428571428572,0.16665452467584613,0.9157155766327618
38,78,25,141,0.3275862068965517,0.8226950354609929,0.15831470962096755,0.8928493501715246
8,99,2,109,0.07476635514018691,0.981651376146789,0.13410424159293632,0.8946924039067801
11,54,1,66,0.16923076923076924,0.9848484848484849,0.12509103257972728,0.8939564731708494
10,111,12,133,0.08264462809917356,0.9097744360902256,0.1213129924380508,0.8929718688027863
14,35,1,50,0.2857142857142857,0.98,0.1573674142067583,0.9230817589126765
22,77,1,100,0.2222222222222222,0.99,0.1837226103732752,0.9251588842413356
6,20,4,30,0.23076923076923078,0.8666666666666667,0.1989905282960604,0.9336622856018798
10,76,10,96,0.11627906976744186,0.8958333333333334,0.16880379442047327,0.9441106138693568
19,35,1,55,0.35185185185185186,0.9818181818181818,0.208387436807854,0.9441344432509845
0,4,58,62,0.0,0.06451612903225806,0.18421161263202981,0.8126583924200949
9,190,10,209,0.04522613065326633,0.9521531100478469,0.1788661129969002,0.8187124886997551
42,178,15,235,0.19090909090909092,0.9361702127659575,0.16532251373901521,0.8124510905234633
49,101,2,152,0.32666666666666666,0.9868421052631579,0.18024314865965013,0.8119999627039146
9,49,7,65,0.15517241379310345,0.8923076923076924,0.16944360337734624,0.815662966366918
34,188,6,228,0.15315315315315314,0.9736842105263158,0.17471132957530497,0.82678452025163
0,11,54,65,0.0,0.16923076923076924,0.12444677931075472,0.7107006041677139
6,7,2,15,0.46153846153846156,0.8666666666666667,0.19038084524482063,0.8252935381154864
29,54,5,88,0.3493975903614458,0.9431818181818182,0.23383391091741773,0.8240119249917681
2,60,3,65,0.03225806451612903,0.9538461538461539,0.21116947857556603,0.8265370594317962
48,79,18,145,0.3779527559055118,0.8758620689655172,0.2184960627525439,0.8106827685321332
16,109,471,596,0.128,0.20973154362416108,0.21461428935352908,0.7131718901487716
1,49,9,59,0.02,0.847457627118644,0.19559241033165006,0.6951395210905328
22,65,20,107,0.25287356321839083,0.8130841121495327,0.2317172050771345,0.7871185700789276
2,0,0,2,1.0,1.0,0.3086402820002115,0.8061661891265466
4,12,1,17,0.25,0.9411764705882353,0.2944406262342906,0.8058797108988919
18,82,4,104,0.18,0.9615384615384616,0.31554661701770076,0.806978611997793
46,82,22,150,0.359375,0.8533333333333334,0.31289265188834187,0.8037602211931952
28,31,4,63,0.4745762711864407,0.9365079365079365,0.36240354777211914,0.9075854201765919
11,18,2,31,0.3793103448275862,0.9354838709677419,0.41373359703320295,0.9201605978693201
9,14,1,24,0.391304347826087,0.9583333333333334,0.45027401294903174,0.937173331059007
40,60,17,117,0.4,0.8547008547008547,0.364559727234746,0.9164163103019863
20,90,2,112,0.18181818181818182,0.9821428571428571,0.35481946749448634,0.9222686512383608
0,1,0,1,0.0,1.0,0.3183115309865498,0.9283476785939839
34,86,3,123,0.2833333333333333,0.975609756097561,0.3026216652966841,0.9483327457915945
129,254,33,416,0.3368146214099217,0.9206730769230769,0.280520122108271,0.9460706229937575
11,74,20,105,0.12941176470588237,0.8095238095238095,0.24609746415620126,0.9287119553887846
0,35,5,40,0.0,0.875,0.19019684303818885,0.9168071934840226
0,13,1,14,0.0,0.9285714285714286,0.1330539858953317,0.9273601326083902
2,13,1,16,0.13333333333333333,0.9375,0.12612757896892476,0.9209825815879821
42,171,55,268,0.19718309859154928,0.7947761194029851,0.15429659305343182,0.8916648843598372
43,106,22,171,0.28859060402684567,0.8713450292397661,0.15504763172393357,0.8767699233801522
3,23,0,26,0.11538461538461539,1.0,0.12341477372031838,0.8881023409625699
12,52,62,126,0.1875,0.5079365079365079,0.13171309304804948,0.8450184407358124
6,44,3,53,0.12,0.9433962264150944,0.1488559501909066,0.854789330223683
9,170,26,205,0.05027932960893855,0.8731707317073171,0.15603871156361213,0.8468749449573814
23,143,3,169,0.13855421686746988,0.9822485207100592,0.15678455206848876,0.8532675907731041
30,111,8,149,0.2127659574468085,0.9463087248322147,0.15901067476209724,0.8749151058344227
45,69,2,116,0.39473684210526316,0.9827586206896551,0.17417442305901404,0.8908313331844067
53,164,7,224,0.24423963133640553,0.96875,0.19258228248069834,0.886367047470121
22,77,1,100,0.2222222222222222,0.99,0.1975425999410158,0.9552332606220484
5,54,1,60,0.0847457627118644,0.9833333333333333,0.192506280328425,0.9609385616103684
1,29,9,39,0.03333333333333333,0.7692307692307693,0.19008542371762424,0.9460899955422901
6,153,4,163,0.03773584905660377,0.9754601226993865,0.17568279974464335,0.9451202243979083
15,100,25,140,0.13043478260869565,0.8214285714285714,0.1639212033391987,0.9272802024831021
34,82,25,141,0.29310344827586204,0.8226950354609929,0.14940214707785565,0.9044139760218647
8,99,2,109,0.07476635514018691,0.981651376146789,0.12519167904982442,0.9062570297571202
12,53,1,66,0.18461538461538463,0.9848484848484849,0.11981927367741907,0.9055210990211895
10,72,51,133,0.12195121951219512,0.6165413533834586,0.12513433893460915,0.853122244742636
14,35,1,50,0.2857142857142857,0.98,0.16118876070331664,0.883232134852526
22,77,1,100,0.2222222222222222,0.99,0.18754395686983358,0.8853092601811852
6,20,4,30,0.23076923076923078,0.8666666666666667,0.20187744946419572,0.8917718452151987
11,80,5,96,0.12087912087912088,0.9479166666666666,0.17727397412180412,0.9096606496731521
20,34,1,55,0.37037037037037035,0.9818181818181818,0.21950311915468748,0.9096844790547797
0,4,58,62,0.0,0.06451612903225806,0.19312949278106112,0.7782084282238902
12,187,10,209,0.06030150753768844,0.9521531100478469,0.18432239107041729,0.8261529648902313
48,173,14,235,0.2171945701357466,0.9404255319148936,0.17453386027348314,0.8204994694495019
49,100,3,152,0.3288590604026846,0.9802631578947368,0.18976769429926346,0.8191084920058928
9,49,7,65,0.15517241379310345,0.8923076923076924,0.17896814901695954,0.8227714956688964
32,190,6,228,0.14414414414414414,0.9736842105263158,0.18229172376910577,0.826452573363132
6,58,1,65,0.09375,0.9846153846153847,0.14277452800190998,0.8268521737627326
6,7,2,15,0.46153846153846156,0.8666666666666667,0.2087085939359759,0.941445107710505
29,54,5,88,0.3493975903614458,0.9431818181818182,0.25000803433936986,0.9401634945867867
2,60,3,65,0.03225806451612903,0.9538461538461539,0.22358853353656732,0.9420807262912525
45,65,35,145,0.4090909090909091,0.7586206896551724,0.2350502262063137,0.9104175165427433
19,109,468,596,0.1484375,0.21476510067114093,0.23408809566444175,0.8136257177375217
1,49,9,59,0.02,0.847457627118644,0.216353217929564,0.7955933486792829
20,67,20,107,0.22988505747126436,0.8130841121495327,0.2358010832826018,0.7710888811841611
2,0,0,2,1.0,1.0,0.3127241602056787,0.7901365002317802
4,12,1,17,0.25,0.9411764705882353,0.29852450443975787,0.7898500220041255
20,81,3,104,0.19801980198019803,0.9711538461538461,0.3222047526489106,0.792322549476653
46,81,23,150,0.36220472440944884,0.8466666666666667,0.3155067262658448,0.8049005461925808
28,31,4,63,0.4745762711864407,0.9365079365079365,0.36209797929247917,0.9080066655978373
11,18,2,31,0.3793103448275862,0.9354838709677419,0.4134280285535629,0.9205818432905655
7,14,1,22,0.3333333333333333,0.9545454545454546,0.4294977023863643,0.9364633610016577
37,58,21,116,0.3894736842105263,0.8189655172413793,0.34227965727358234,0.9106012920361405
17,77,2,96,0.18085106382978725,0.9791666666666666,0.34132980924926626,0.9160284629044878
0,1,0,1,0.0,1.0,0.30640917432863135,0.922107490260111
32,74,3,109,0.3018867924528302,0.9724770642201835,0.2953486668465234,0.9418138745628915
126,216,36,378,0.3684210526315789,0.9047619047619048,0.27776232811834695,0.9372787271706012
12,65,20,97,0.15584415584415584,0.7938144329896907,0.2471157260431735,0.917675862917897
0,28,5,33,0.0,0.8484848484848485,0.19949667842412586,0.9025243477663818
0,12,2,14,0.0,0.8571428571428571,0.14385758067976498,0.9079782534665929
1,8,2,11,0.1111111111111111,0.8181818181818182,0.13389473029138266,0.8849804179687574
36,147,59,242,0.19672131147540983,0.756198347107438,0.16199777478786978,0.8501516104126772
41,94,22,157,0.3037037037037037,0.8598726114649682,0.16225733353799457,0.8340652600190749
3,18,4,25,0.14285714285714285,0.84,0.13003391785593227,0.8248135593388027
11,22,90,123,0.3333333333333333,0.2682926829268293,0.15538951464010048,0.7497390236155369
5,40,3,48,0.1111111111111111,0.9375,0.17126253051311635,0.7624554738319871
12,149,26,187,0.07453416149068323,0.8609625668449198,0.18191026786892822,0.7630011466465676
24,107,3,134,0.183206106870229,0.9776119402985075,0.19220955297737366,0.7857768783775231
26,110,8,144,0.19117647058823528,0.9444444444444444,0.19141743285063442,0.8126691779970955
41,63,2,106,0.3942307692307692,0.9811320754716981,0.20434987078307237,0.8299919585694855
54,163,7,224,0.2488479262672811,0.96875,0.219491411270235,0.8483848157123426
17,62,4,83,0.21518987341772153,0.9518072289156626,0.2026137741394333,0.9460297508536045
5,47,1,53,0.09615384615384616,0.9811320754716981,0.2004770220026812,0.9522629044924186
1,27,8,36,0.03571428571428571,0.7777777777777778,0.19493132546319578,0.9403793631971125
6,149,4,159,0.03870967741935484,0.9748427672955975,0.17428897839878524,0.9399837670538397
15,89,27,131,0.14423076923076922,0.7938931297709924,0.1675824496334329,0.9184764363862037
30,70,25,125,0.3,0.8,0.15412091117189444,0.8926004256045326
8,92,2,102,0.08,0.9803921568627451,0.12999977884799715,0.894263590870639
10,54,1,65,0.15625,0.9846153846153847,0.12157979693117979,0.8989504702563135
9,100,12,121,0.08256880733944955,0.9008264462809917,0.1196390771005517,0.8874782375147839
13,33,1,47,0.2826086956521739,0.9787234042553191,0.15490970709167856,0.9161847555830043
23,73,1,97,0.23958333333333334,0.9896907216494846,0.18360594365081837,0.9183058919192738
7,18,4,29,0.28,0.8620689655172413,0.20300154804642276,0.9280452970258807
8,62,11,81,0.11428571428571428,0.8641975308641975,0.17647093580152481,0.9372163728636232
19,31,1,51,0.38,0.9803921568627451,0.21932807865866769,0.9372163728636232
0,2,58,60,0.0,0.03333333333333333,0.1970066500872391,0.8013189369661874
10,161,10,181,0.05847953216374269,0.9447513812154696,0.1935653250621381,0.8075939276711129
48,137,14,199,0.2594594594594595,0.9296482412060302,0.19025829132032177,0.8005831900926429
49,87,3,139,0.3602941176470588,0.9784172661870504,0.20750268907942543,0.7989726964551523
6,50,7,63,0.10714285714285714,0.8888888888888888,0.18280881152840497,0.8028041140796736
27,179,6,212,0.13106796116504854,0.9716981132075472,0.18520627536830991,0.8181613401287233
0,11,54,65,0.0,0.16923076923076924,0.1309205610825956,0.702281141895584
6,6,2,14,0.5,0.8571428571428571,0.20234913251116704,0.8199682167255159
29,42,5,76,0.4084507042253521,0.9342105263157895,0.2523450142342541,0.8184623803112759
1,60,3,64,0.01639344262295082,0.953125,0.21762129754332427,0.8218162029961288
46,60,36,142,0.4339622641509434,0.7464788732394366,0.22814531847245068,0.7886821468607553
19,75,412,506,0.20212765957446807,0.1857707509881423,0.2417145759626808,0.6882366985892201
1,43,9,53,0.022727272727272728,0.8301886792452831,0.22623733475728428,0.6680210651660395
21,60,20,101,0.25925925925925924,0.801980198019802,0.2632743717943213,0.7584138407073299
2,0,0,2,1.0,1.0,0.33470294322289273,0.7788220039726361
4,12,1,17,0.25,0.9411764705882353,0.3120671283335567,0.7798171388686999
23,67,4,94,0.25555555555555554,0.9574468085106383,0.346233144466786,0.7804345400845053
46,71,23,140,0.39316239316239315,0.8357142857142857,0.34040459146842167,0.7931824561523408
29,30,4,63,0.4915254237288136,0.9365079365079365,0.3817471292047567,0.9004306255123115
10,17,2,29,0.37037037037037035,0.9310344827586207,0.43141042886805636,0.9148371688713597
9,12,1,22,0.42857142857142855,0.9545454545454546,0.4247859883746286,0.934861013809238
38,59,19,116,0.3917525773195876,0.8362068965517241,0.33789349942028396,0.9114619990309131
18,76,2,96,0.19148936170212766,0.9791666666666666,0.3384634082348736,0.9168891698992604
0,1,0,1,0.0,1.0,0.3101748650948453,0.9223313467700087
33,73,3,109,0.3113207547169811,0.9724770642201835,0.3051554453525018,0.9403042607062254
127,216,35,378,0.37026239067055394,0.9074074074074074,0.2878321549156076,0.9361470422632926
12,65,20,97,0.15584415584415584,0.7938144329896907,0.2641772384035482,0.9205168460544465
0,28,5,33,0.0,0.8484848484848485,0.20295274860762982,0.9053653309029315
0,12,2,14,0.0,0.8571428571428571,0.1469880947048316,0.9083561824159504
1,8,2,11,0.1111111111111111,0.8181818181818182,0.1355054874775435,0.8853583469181149
35,146,59,240,0.19337016574585636,0.7541666666666667,0.1631297968698087,0.8502392992990673
42,93,22,157,0.3111111111111111,0.8598726114649682,0.16309984778325584,0.8341529489054651
3,18,4,25,0.14285714285714285,0.84,0.13061338380991142,0.8245233192758354
9,20,93,122,0.3103448275862069,0.23770491803278687,0.1526849083444901,0.7450791028534206
5,41,3,49,0.10869565217391304,0.9387755102040817,0.16821285865504912,0.7579777688133111
9,153,26,188,0.05555555555555555,0.8617021276595744,0.17614936659155706,0.7586290931728422
20,111,3,134,0.15267175572519084,0.9776119402985075,0.1820866015364256,0.7814048249037978
26,110,8,144,0.19117647058823528,0.9444444444444444,0.18177321651390832,0.8085873645863375
45,59,2,106,0.4326923076923077,0.9811320754716981,0.19914195888265068,0.8259101451587274
54,163,7,224,0.2488479262672811,0.96875,0.2142834993698133,0.8443030023015846
17,62,4,83,0.21518987341772153,0.9518072289156626,0.2006899344886011,0.9463176181419956
5,47,1,53,0.09615384615384616,0.9811320754716981,0.1988982479143058,0.9523685560373691
1,27,8,36,0.03571428571428571,0.7777777777777778,0.19606378079412443,0.9403793631971125
6,149,4,159,0.03870967741935484,0.9748427672955975,0.1797834838932907,0.9399837670538397
16,89,26,131,0.1523809523809524,0.8015267175572519,0.17424126700653603,0.9195669489270978
33,67,26,126,0.33,0.7936507936507936,0.15957093733620636,0.8927839086669687
9,91,2,102,0.09,0.9803921568627451,0.13687837644088047,0.8944470739330751
9,55,1,65,0.140625,0.9846153846153847,0.12622625166692023,0.8991339533187496
10,98,12,120,0.09259259259259259,0.9,0.12571750115816974,0.8875436568227928
13,33,1,47,0.2826086956521739,0.9787234042553191,0.16098813114929664,0.9162501748910129
24,73,1,98,0.24742268041237114,0.9897959183673469,0.1908042744340132,0.9183863393298344
7,18,4,29,0.28,0.8620689655172413,0.20903556695102005,0.9270352318955472
10,61,10,81,0.14084507042253522,0.8765432098765432,0.18201343415423935,0.9388770056420829
21,29,1,51,0.42,0.9803921568627451,0.2291562912970965,0.9388770056420829
0,2,58,60,0.0,0.03333333333333333,0.20906700558281077,0.8029795697446469
11,161,10,182,0.06395348837209303,0.945054945054945,0.20497570497988224,0.8094159904667818
45,141,14,200,0.24193548387096775,0.93,0.19916524615399567,0.8024555041445935
50,87,3,140,0.36496350364963503,0.9785714285714285,0.21595679233074766,0.8008520056023194
7,49,7,63,0.125,0.8888888888888888,0.1938139351878905,0.8046834232268404
29,177,6,212,0.1407766990291262,0.9716981132075472,0.19380416784597493,0.8182769808455552
0,11,54,65,0.0,0.16923076923076924,0.13380416784597493,0.7023967826124159
6,6,2,14,0.5,0.8571428571428571,0.20523273927454636,0.8200838574423478
29,42,5,76,0.4084507042253521,0.9342105263157895,0.25444662725358336,0.8185346547653257
1,60,3,64,0.01639344262295082,0.953125,0.2222263356467238,0.821838226193897
48,60,34,142,0.4444444444444444,0.7605633802816901,0.23358075576026804,0.7906942192953629
25,85,397,507,0.22727272727272727,0.21696252465483234,0.24819114537065762,0.6947047386904978
1,43,9,53,0.022727272727272728,0.8301886792452831,0.23132694161324996,0.6744891052673172
19,62,20,101,0.2345679012345679,0.801980198019802,0.2648366417896168,0.7648818808086075
2,0,0,2,1.0,1.0,0.3362652132181883,0.7852900440739138
3,13,1,17,0.1875,0.9411764705882353,0.30470082690028083,0.7862851789699775
22,68,4,94,0.24444444444444444,0.9574468085106383,0.3372795414462084,0.7869025801857829
44,72,23,139,0.3793103448275862,0.8345323741007195,0.3279746700723716,0.7974695793027872
29,30,4,63,0.4915254237288136,0.9365079365079365,0.36572505528038385,0.9002617809960878
10,17,2,29,0.37037037037037035,0.9310344827586207,0.41538835494368354,0.9146683243551358
8,15,1,24,0.34782608695652173,0.9583333333333334,0.4082595577521646,0.9400104342812393
38,59,20,117,0.3917525773195876,0.8290598290598291,0.32136706879781995,0.9155904098612149
17,93,2,112,0.15454545454545454,0.9821428571428571,0.3166592765900278,0.9214427507975894
0,1,0,1,0.0,1.0,0.29402844207800516,0.9268849276683377
31,91,3,125,0.2540983606557377,0.976,0.278584675827475,0.9453611181445282
125,255,35,415,0.32894736842105265,0.9156626506024096,0.25535923935493765,0.9423832201580243
12,74,20,106,0.13953488372093023,0.8113207547169812,0.2309578188027553,0.9246456321222014
0,34,5,39,0.0,0.8717948717948718,0.18126837780896649,0.912282994759564
0,12,2,14,0.0,0.8571428571428571,0.12530372390616826,0.9162948559142822
2,12,2,16,0.14285714285714285,0.875,0.1236339650935523,0.9009887334653026
37,171,59,267,0.1778846153846154,0.7790262172284644,0.1490460530056402,0.8694210502122262
41,109,21,171,0.2733333333333333,0.8771929824561403,0.15179390624529673,0.8553057619916747
4,18,4,26,0.18181818181818182,0.8461538461538461,0.1307754510163152,0.8453759327847372
8,23,95,126,0.25806451612903225,0.24603174603174602,0.14770825564604406,0.7646203601154179
6,44,3,53,0.12,0.9433962264150944,0.1648511127889012,0.7748491250611639
10,168,27,205,0.056179775280898875,0.8682926829268293,0.17287679497188674,0.7764419573160171
23,143,3,169,0.13855421686746988,0.9822485207100592,0.17226209125907635,0.7917631745603113
26,116,8,150,0.18309859154929578,0.9466666666666667,0.17300694499688782,0.8157118101943402
47,67,2,116,0.41228070175438597,0.9827586206896551,0.19285656905703816,0.8307926156562708
53,164,7,224,0.24423963133640553,0.96875,0.201773918988213,0.8483063519200071
23,73,6,102,0.23958333333333334,0.9411764705882353,0.1991337500173989,0.9476127411423628
6,49,5,60,0.10909090909090909,0.9166666666666666,0.1975753084589573,0.943794232606873
1,29,9,39,0.03333333333333333,0.7692307692307693,0.19431153103787652,0.9296425306502931
5,155,4,164,0.03125,0.975609756097561,0.17898235719966651,0.9286941357056505
16,98,26,140,0.14035087719298245,0.8142857142857143,0.17287554086305032,0.9097825710798001
33,83,25,141,0.28448275862068967,0.8226950354609929,0.15461869184395088,0.8869163446185626
9,98,2,109,0.08411214953271028,0.981651376146789,0.13174333730056584,0.8887593983538181
10,54,2,66,0.15625,0.9696969696969697,0.11983857539580393,0.8928337553693516
10,108,13,131,0.0847457627118644,0.9007633587786259,0.11636069734165469,0.8905618542424888
13,36,1,50,0.2653061224489796,0.98,0.14949966721531843,0.9206717443523788
21,78,1,100,0.21212121212121213,0.99,0.17533841180406304,0.9227274934812988
7,19,4,30,0.2692307692307692,0.8666666666666667,0.19374982495231827,0.9302104866785775
8,77,11,96,0.09411764705882353,0.8854166666666666,0.1665548090149088,0.9391707197079596
16,37,2,55,0.3018867924528302,0.9636363636363636,0.1976654722892117,0.9365971464921845
0,4,58,62,0.0,0.06451612903225806,0.17534404371778312,0.8072855978257971
10,189,10,209,0.05025125628140704,0.9521531100478469,0.17041625708486063,0.8146269908642573
47,174,14,235,0.21266968325791855,0.9404255319148936,0.1628967657718519,0.8089734954235278
41,98,13,152,0.2949640287769784,0.9144736842105263,0.17473145386553282,0.7981840217393174
5,53,7,65,0.08620689655172414,0.8923076923076924,0.14858518633995493,0.8018470254023209
29,193,6,228,0.13063063063063063,0.9736842105263158,0.1538013268502131,0.8144566745251279
0,8,57,65,0.0,0.12307692307692308,0.11067464221409451,0.694376754445208
6,7,2,15,0.46153846153846156,0.8666666666666667,0.17660870814816043,0.8089696883929806
30,53,5,88,0.3614457831325301,0.9431818181818182,0.2210650691268923,0.8076880752692622
2,60,3,65,0.03225806451612903,0.9538461538461539,0.19529198073520807,0.8096053069737279
45,65,34,144,0.4090909090909091,0.7638888888888888,0.21159582078005532,0.7880931933563511
19,126,451,596,0.1310344827586207,0.24328859060402686,0.21799976166675483,0.695376178827256
1,49,9,59,0.02,0.847457627118644,0.20219538586237903,0.6773438097690173
21,66,20,107,0.2413793103448276,0.8130841121495327,0.2366781444830687,0.7759162653508186
2,0,0,2,1.0,1.0,0.3136012214061456,0.7949638843984376
3,13,1,17,0.1875,0.9411764705882353,0.2887518238157841,0.794677406170783
20,81,4,105,0.19801980198019803,0.9619047619047619,0.3124320720249369,0.7958286358934412
44,83,23,150,0.3464566929133858,0.8466666666666667,0.3034843268567192,0.8076540327188381
29,30,4,63,0.4915254237288136,0.9365079365079365,0.3549830327096039,0.9066853678479679
9,19,3,31,0.32142857142857145,0.9032258064516129,0.3980442571993999,0.9146522506098208
8,15,1,24,0.34782608695652173,0.9583333333333334,0.41925092156250404,0.9400104342812392
39,58,20,117,0.4020618556701031,0.8290598290598291,0.333831186658233,0.9155904098612149
20,90,2,112,0.18181818181818182,0.9821428571428571,0.33301949834654476,0.9214427507975893
0,1,0,1,0.0,1.0,0.3019021008925136,0.9268849276683377
31,91,3,125,0.2540983606557377,0.976,0.2864583346419835,0.9453611181445281
119,263,34,416,0.31151832460732987,0.9182692307692307,0.2631643422735391,0.9427555887532845
12,74,20,106,0.13953488372093023,0.8113207547169812,0.23383681334697243,0.9250180007174615
0,34,5,39,0.0,0.8717948717948718,0.18414737235318362,0.9126553633548241
0,12,2,14,0.0,0.8571428571428571,0.12670996440031176,0.9166672245095425
2,12,2,16,0.14285714285714285,0.875,0.12114410169159191,0.9013611020605629
36,173,59,268,0.1722488038277512,0.7798507462686567,0.14575107366698492,0.869911208670371
43,107,21,171,0.2866666666666667,0.8771929824561403,0.15040368881140337,0.8557959204498197
4,18,4,26,0.18181818181818182,0.8461538461538461,0.1318750969843822,0.8454937226476218
8,24,94,126,0.25,0.25396825396825395,0.14765582788139217,0.765871936826375
7,43,3,53,0.14,0.9433962264150944,0.1676558278813922,0.7761007017721211
9,169,27,205,0.05056179775280899,0.8682926829268293,0.1748789418460792,0.7776935340269742
23,143,3,169,0.13855421686746988,0.9822485207100592,0.17426423813326877,0.7930147512712685
26,116,8,150,0.18309859154929578,0.9466666666666667,0.17581420780777512,0.8168455970424127
50,64,2,116,0.43859649122807015,0.9827586206896551,0.19751846845940418,0.8319264025043435
53,164,7,224,0.24423963133640553,0.96875,0.206435818390579,0.8494401387680798
23,73,6,102,0.23958333333333334,0.9411764705882353,0.20494772315248375,0.9476127411423627
4,51,5,60,0.07272727272727272,0.9166666666666666,0.19533733354209418,0.943794232606873
1,29,9,39,0.03333333333333333,0.7692307692307693,0.19287612433931195,0.929642530650293
5,155,4,164,0.03125,0.975609756097561,0.17754695050110195,0.9286941357056504
16,98,26,140,0.14035087719298245,0.8142857142857143,0.17144013416448572,0.9097825710798001
33,83,25,141,0.28448275862068967,0.8226950354609929,0.1494238866491457,0.8869163446185626
10,97,2,109,0.09345794392523364,0.981651376146789,0.12788364559040682,0.8887593983538181
11,53,2,66,0.171875,0.9696969696969697,0.11821102654278778,0.8928337553693517
9,111,12,132,0.075,0.9090909090909091,0.11853570186746311,0.8917515042871006
13,36,1,50,0.2653061224489796,0.98,0.15167467174112687,0.9218613943969907
21,78,1,100,0.21212121212121213,0.99,0.17751341632987147,0.9239171435259106
7,19,4,30,0.2692307692307692,0.8666666666666667,0.1959248294781267,0.9314001367231894
8,77,11,96,0.09411764705882353,0.8854166666666666,0.16872981354071723,0.9403603697525714
15,38,2,55,0.2830188679245283,0.9636363636363636,0.1958099455406165,0.9377867965367964
0,4,58,62,0.0,0.06451612903225806,0.17125637411204506,0.808475247870409
10,189,10,209,0.05025125628140704,0.9521531100478469,0.16772083929510323,0.8146269908642572
47,174,14,235,0.21266968325791855,0.9404255319148936,0.16020134798209448,0.8089734954235278
40,96,15,151,0.29411764705882354,0.9006622516556292,0.1719151244017533,0.7962109599457605
7,51,7,65,0.1206896551724138,0.8923076923076924,0.15069496525055961,0.7998739636087642
34,188,6,228,0.15315315315315314,0.9736842105263158,0.159128608978321,0.8124836127315713
0,10,55,65,0.0,0.15384615384615385,0.11869734213195983,0.6967992970472555
6,7,2,15,0.46153846153846156,0.8666666666666667,0.1846314080660258,0.8113922309950282
30,53,5,88,0.3614457831325301,0.9431818181818182,0.22908776904475764,0.8101106178713098
2,60,3,65,0.03225806451612903,0.9538461538461539,0.2033146806530734,0.8120278495757757
47,64,34,145,0.42342342342342343,0.7655172413793103,0.2217869344194448,0.7927214195363016
17,128,452,597,0.11724137931034483,0.24288107202680068,0.2212943235820064,0.6999461880676027
1,49,9,59,0.02,0.847457627118644,0.20227244456012738,0.6819138190093639
22,66,19,107,0.25,0.822429906542056,0.2379867302744131,0.7774257836802071
2,0,0,2,1.0,1.0,0.31490980719749,0.7964734027278261
3,13,1,17,0.1875,0.9411764705882353,0.2900604096071286,0.7961869245001713
16,85,4,105,0.15841584158415842,0.9619047619047619,0.30808294918827567,0.7973381542228296
46,81,23,150,0.36220472440944884,0.8466666666666667,0.2993374207577078,0.8089309292638804
29,30,4,63,0.4915254237288136,0.9365079365079365,0.3528065699603462,0.9080204813326143
9,20,2,31,0.3103448275862069,0.9354838709677419,0.39428440247266144,0.9205956590253425
8,15,1,24,0.34782608695652173,0.9583333333333334,0.4233292446651116,0.9376975091111711
39,58,20,117,0.4020618556701031,0.8290598290598291,0.3379095097608406,0.9132774846911469
21,89,2,112,0.19090909090909092,0.9821428571428571,0.33839652274785365,0.9191298256275214
0,1,0,1,0.0,1.0,0.309825094176425,0.9259325467159567
32,90,3,125,0.26229508196721313,0.976,0.2962754120084759,0.9453611181445282
129,251,36,416,0.3394736842105263,0.9134615384615384,0.27455373493443486,0.9420687755664713
11,75,20,106,0.12790697674418605,0.8113207547169812,0.23863896806537768,0.9243311875306482
0,34,5,39,0.0,0.8717948717948718,0.18894952707158888,0.9119685501680109
0,12,2,14,0.0,0.8571428571428571,0.13151211911871702,0.9159804113227292
2,12,2,16,0.14285714285714285,0.875,0.12464755511129587,0.9006742888737496
42,167,59,268,0.20095693779904306,0.7798507462686567,0.15335568908258773,0.8692243954835578
43,106,22,171,0.28859060402684567,0.8713450292397661,0.1571121922339638,0.854273685374953
4,18,4,26,0.18181818181818182,0.8461538461538461,0.13458997760648603,0.8446583007595683
7,22,97,126,0.2413793103448276,0.23015873015873015,0.15080031097800625,0.7616351543941038
7,43,3,53,0.14,0.9433962264150944,0.17080031097800624,0.77186391933985
8,170,27,205,0.0449438202247191,0.8682926829268293,0.1772208567243947,0.7734567515947032
25,141,3,169,0.15060240963855423,0.9822485207100592,0.17832732340745344,0.7887779688389973
26,116,8,150,0.18309859154929578,0.9466666666666667,0.17577613108606097,0.8126088146101414
49,65,2,116,0.4298245614035088,0.9827586206896551,0.19595241071129857,0.8285250419601258
53,164,7,224,0.24423963133640553,0.96875,0.2048697606424734,0.8460387782238621
22,74,6,102,0.22916666666666666,0.9411764705882353,0.20312509725987896,0.9476127411423627
3,52,5,60,0.05454545454545454,0.9166666666666666,0.19091730505208676,0.943794232606873
2,28,9,39,0.06666666666666667,0.7692307692307693,0.19402056882950783,0.929642530650293
5,155,4,164,0.03125,0.975609756097561,0.1769702245954287,0.9286941357056504
15,98,27,140,0.13274336283185842,0.8071428571428572,0.16977662049293762,0.9087621629165348
34,81,26,141,0.2956521739130435,0.8156028368794326,0.15060913656572827,0.88488276522936
9,98,2,109,0.08411214953271028,0.981651376146789,0.12773378202234326,0.8867258189646157
11,54,1,66,0.16923076923076924,0.9848484848484849,0.11917151096007218,0.8929646781446514
11,109,12,132,0.09166666666666666,0.9090909090909091,0.12447454126310249,0.8918824270624003
14,35,1,50,0.2857142857142857,0.98,0.1557670582699052,0.9219923171722905
24,75,1,100,0.24242424242424243,0.99,0.18593480718765412,0.9240480663012102
6,20,4,30,0.23076923076923078,0.8666666666666667,0.19993850260727877,0.9325514676617546
7,77,12,96,0.08333333333333333,0.875,0.16960723966732014,0.9410367766789784
18,36,1,55,0.3333333333333333,0.9818181818181818,0.20521026592455202,0.9410606060606058
0,4,58,62,0.0,0.06451612903225806,0.18103444174872782,0.8095845552297164
12,188,9,209,0.06,0.9569377990430622,0.17651063222491833,0.8164198252228811
46,174,15,235,0.20909090909090908,0.9361702127659575,0.16556443556443592,0.8101584270465894
52,95,4,151,0.35374149659863946,0.9735099337748344,0.18146690044649263,0.8078027033001371
9,49,7,65,0.15517241379310345,0.8923076923076924,0.17066735516418877,0.8114657069631408
32,189,6,227,0.14479638009049775,0.973568281938326,0.17944779041521225,0.8255468900971873
0,10,55,65,0.0,0.15384615384615385,0.13182874279616463,0.7072651718154691
6,7,2,15,0.46153846153846156,0.8666666666666667,0.19776280873023058,0.8218581057632417
30,53,5,88,0.3614457831325301,0.9431818181818182,0.24082649203487771,0.8198929656402069
3,59,3,65,0.04838709677419355,0.9538461538461539,0.21786880456106122,0.8224181000802349
46,66,33,145,0.4107142857142857,0.7724137931034483,0.22600777443472495,0.7936900799843226
29,116,452,597,0.2,0.24288107202680068,0.23241171532142446,0.7009148485156239
1,49,9,59,0.02,0.847457627118644,0.21458366102278195,0.6828990406842407
21,66,20,107,0.2413793103448276,0.8130841121495327,0.2490664196434716,0.7770758918704377
2,0,0,2,1.0,1.0,0.3259894965665485,0.7961235109180568
3,13,1,17,0.1875,0.9411764705882353,0.30114009897618704,0.7958370326904021
22,79,4,105,0.21782178217821782,0.9619047619047619,0.32534505403390485,0.7969882624130603
46,81,23,150,0.36220472440944884,0.8466666666666667,0.3184151167046424,0.8075958157792343
28,31,4,63,0.4745762711864407,0.9365079365079365,0.35764029830270533,0.9066853678479679
10,19,2,31,0.3448275862068966,0.9354838709677419,0.40404423918940485,0.9192605455406964
11,12,1,24,0.4782608695652174,0.9583333333333334,0.43560025746877656,0.9400104342812393
40,59,18,117,0.40404040404040403,0.8461538461538461,0.35046317233169144,0.9180324123032173
21,89,2,112,0.19090909090909092,0.9821428571428571,0.3509501853187044,0.9238847532395917
0,1,0,1,0.0,1.0,0.32124721502167475,0.9293269301103402
32,90,3,125,0.26229508196721313,0.976,0.310348987136226,0.9478031205865306
122,258,36,416,0.32105263157894737,0.9134615384615384,0.2908383461269231,0.9445107780084738
12,74,20,106,0.13953488372093023,0.8113207547169812,0.25658470882597223,0.9267731899726508
0,34,5,39,0.0,0.8717948717948718,0.1882617274595126,0.9144105526100134
0,12,2,14,0.0,0.8571428571428571,0.13054166973945489,0.9159804113227292
2,12,2,16,0.14285714285714285,0.875,0.12367710573203373,0.9006742888737497
40,169,59,268,0.19138755980861244,0.7798507462686567,0.15101818570469266,0.8692243954835578
43,105,23,171,0.2905405405405405,0.8654970760233918,0.15505325121516803,0.8534382634868996
3,19,4,26,0.13636363636363635,0.8461538461538461,0.12866910904155215,0.8438228788715147
7,24,95,126,0.22580645161290322,0.24603174603174602,0.14099361874040545,0.7630673062021955
9,41,3,53,0.18,0.9433962264150944,0.16670790445469114,0.7732960711479416
7,171,27,205,0.03932584269662921,0.8682926829268293,0.17232588198278104,0.7748889034027948
27,139,3,169,0.16265060240963855,0.9822485207100592,0.175153519061709,0.790210120647089
25,117,8,150,0.176056338028169,0.9466666666666667,0.17296334452164563,0.8140409664182332
47,67,2,116,0.41228070175438597,0.9827586206896551,0.19035479612362358,0.8307926156562707
53,164,7,224,0.24423963133640553,0.96875,0.20576565254830487,0.8483063519200071
22,73,7,102,0.23157894736842105,0.9313725490196079,0.20659029479909316,0.9462121809182731
4,55,1,60,0.06779661016949153,0.9833333333333333,0.1905612391090205,0.9519174819065929
1,29,9,39,0.03333333333333333,0.7692307692307693,0.18970516634283535,0.9377657799500129
5,155,4,164,0.03125,0.975609756097561,0.170933651712887,0.9368173850053703
15,98,27,140,0.13274336283185842,0.8071428571428572,0.16474608382769976,0.9168854122162546
36,80,25,141,0.3103448275862069,0.8226950354609929,0.1501838160893885,0.8940191857550174
10,97,2,109,0.09345794392523364,0.981651376146789,0.12864357503064966,0.8958622394902729
12,53,1,66,0.18461538461538463,0.9848484848484849,0.12193449463735874,0.9035016588943982
11,109,12,132,0.09166666666666666,0.9090909090909091,0.12534450270838376,0.8928955982883374
13,36,1,50,0.2653061224489796,0.98,0.1584834725820475,0.9230054883982276
24,75,1,100,0.24242424242424243,0.99,0.18865122149979643,0.9250612375271475
6,20,4,30,0.23076923076923078,0.8666666666666667,0.20265491691942103,0.9335646388876916
8,76,12,96,0.09523809523809523,0.875,0.1719253837268337,0.9410367766789783
21,34,1,56,0.38181818181818183,0.9821428571428571,0.21311970342582628,0.9411069882498452
0,4,58,62,0.0,0.06451612903225806,0.1867460770521999,0.8096309374189559
11,189,9,209,0.055,0.9569377990430622,0.18150798181410463,0.8164662074121205
45,176,14,235,0.20361990950226244,0.9404255319148936,0.17269566567885933,0.8108127119713909
54,95,3,152,0.3624161073825503,0.9802631578947368,0.18983736067290333,0.809421734527782
7,51,7,65,0.1206896551724138,0.8923076923076924,0.1741117070162152,0.8130847381907856
34,187,6,227,0.15384615384615385,0.973568281938326,0.18248428681736642,0.8271659213248322
0,11,54,65,0.0,0.16923076923076924,0.12793883227191188,0.7110356230516769
6,7,2,15,0.46153846153846156,0.8666666666666667,0.1938728982059778,0.8256285569994494
30,53,5,88,0.3614457831325301,0.9431818181818182,0.2376508672249107,0.8236634168764146
2,60,3,65,0.03225806451612903,0.9538461538461539,0.21317060365546306,0.8255806485808803
47,65,33,145,0.41964285714285715,0.7724137931034483,0.22134585362122117,0.7958878821821249
25,120,452,597,0.1724137931034483,0.24288107202680068,0.22873501618279754,0.7031126507134261
1,49,9,59,0.02,0.847457627118644,0.2096141370619184,0.6850968428820429
21,66,20,107,0.2413793103448276,0.8130841121495327,0.24409689568260803,0.7770758918704376
2,0,0,2,1.0,1.0,0.321019972605685,0.7961235109180568
3,13,1,17,0.1875,0.9411764705882353,0.2961705750153235,0.795837032690402
20,80,5,105,0.2,0.9523809523809523,0.32013370865587654,0.7956277181953731
45,81,24,150,0.35714285714285715,0.84,0.31120513722730514,0.8052828906091662
29,30,4,63,0.4915254237288136,0.9365079365079365,0.3567925130309287,0.9043724426779
11,18,2,31,0.3793103448275862,0.9354838709677419,0.40812256229201244,0.9169476203706283
10,13,1,24,0.43478260869565216,0.9583333333333334,0.439135162375767,0.9381937392222722
41,60,16,117,0.40594059405940597,0.8632478632478633,0.35426953295568214,0.9186577196862526
21,89,2,112,0.19090909090909092,0.9821428571428571,0.3547565459426952,0.9245100606226274
0,1,0,1,0.0,1.0,0.32301051419666343,0.9305890879782505
35,87,3,125,0.28688524590163933,0.976,0.3143573168799484,0.9496094961415158
125,257,33,415,0.32722513089005234,0.9204819277108434,0.29330715398046436,0.9473200663133595
12,74,20,106,0.13953488372093023,0.8113207547169812,0.25503965059668193,0.930218105164554
0,34,5,39,0.0,0.8717948717948718,0.1929278493544459,0.9178554678019165
0,13,1,14,0.0,0.9285714285714286,0.13493633591738793,0.927187405705283
2,13,1,16,0.13333333333333333,0.9375,0.1267112276922797,0.9208098546848749
42,171,55,268,0.19718309859154928,0.7947761194029851,0.15488024177678675,0.8914921574567298
42,106,23,171,0.28378378378378377,0.8654970760233918,0.15443717575995025,0.8757060254600715
3,23,0,26,0.11538461538461539,1.0,0.12417424497345923,0.8870657500728082
8,54,64,126,0.12903225806451613,0.49206349206349204,0.12267386987968579,0.8414575696937383
8,42,3,53,0.16,0.9433962264150944,0.14553101273682864,0.8516863346394844
8,169,27,204,0.04519774011299435,0.8676470588235294,0.1519878327529707,0.8429828532469273
28,138,3,169,0.1686746987951807,0.9822485207100592,0.1570365992475203,0.8493754990626501
29,113,8,150,0.20422535211267606,0.9466666666666667,0.15804263546482414,0.8710741486717476
50,64,2,116,0.43859649122807015,0.9827586206896551,0.18015873652829364,0.8878257979097851
53,164,7,224,0.24423963133640553,0.96875,0.19856659594997791,0.8833615121954994
22,73,7,102,0.23157894736842105,0.9313725490196079,0.21321612299339293,0.946119948903516
4,55,1,60,0.06779661016949153,0.9833333333333333,0.20004421016046314,0.9518252498918358
1,29,9,39,0.03333333333333333,0.7692307692307693,0.19834929490622583,0.9377657799500129
5,155,4,164,0.03125,0.975609756097561,0.17871719507834288,0.9368173850053704
17,98,25,140,0.14782608695652175,0.8214285714285714,0.1706601571988923,0.9189262285427853
38,77,26,141,0.33043478260869563,0.8156028368794326,0.15520848453898164,0.8950468308556107
12,95,2,109,0.11214953271028037,0.981651376146789,0.1363384704495352,0.8968898845908662
12,53,1,66,0.18461538461538463,0.9848484848484849,0.12962939005624427,0.9045293039949914
12,71,49,132,0.14457831325301204,0.6287878787878788,0.1405982047824615,0.8538799533456408
13,36,1,50,0.2653061224489796,0.98,0.17373717465612523,0.8839898434555309
22,77,1,100,0.2222222222222222,0.99,0.20101892068787125,0.8860455925844508
6,20,4,30,0.23076923076923078,0.8666666666666667,0.212867941232544,0.8925081776184645
8,81,7,96,0.0898876404494382,0.9270833333333334,0.1785040637812215,0.9084339628261645
25,30,1,56,0.45454545454545453,0.9821428571428571,0.22741776690053211,0.9085041743970315
0,4,58,62,0.0,0.06451612903225806,0.20104414052690572,0.7770281235661418
14,186,9,209,0.07,0.9569377990430622,0.19039009577647545,0.8239066836025967
42,179,14,235,0.19004524886877827,0.9404255319148936,0.17963854240787525,0.8182531881618672
53,96,3,152,0.35570469798657717,0.9802631578947368,0.1987074675170688,0.8168622107182582
10,48,7,65,0.1724137931034483,0.8923076923076924,0.19037097642195702,0.8205252143812618
31,190,6,227,0.14027149321266968,0.973568281938326,0.19756866967384723,0.8271659213248322
6,58,1,65,0.09375,0.9846153846153847,0.14602646188163942,0.8275191395351934
6,7,2,15,0.46153846153846156,0.8666666666666667,0.21196052781570537,0.942112073482966
28,55,5,88,0.3373493975903614,0.9431818181818182,0.25015329890004273,0.940146933359931
2,60,3,65,0.03225806451612903,0.9538461538461539,0.22761227256394997,0.9420641650643968
50,66,29,145,0.43103448275862066,0.8,0.23837367038852758,0.9163122853651487
23,131,443,597,0.14935064935064934,0.25795644891122277,0.2350789355666992,0.8256906791656531
1,49,9,59,0.02,0.847457627118644,0.21789729367917496,0.80767487133427
21,66,20,107,0.2413793103448276,0.8130841121495327,0.23898719515700748,0.7831704038391482
2,0,0,2,1.0,1.0,0.3159102720800844,0.8022180228867672
3,13,1,17,0.1875,0.9411764705882353,0.29450321528146134,0.8019315446591125
21,80,4,105,0.2079207920792079,0.9619047619047619,0.31959789064761546,0.8030827743817709
43,84,23,150,0.33858267716535434,0.8466666666666667,0.3063904898485775,0.8097494410484376
27,32,4,63,0.4576271186440678,0.9365079365079365,0.3504299854619229,0.9066853678479679
11,18,2,31,0.3793103448275862,0.9354838709677419,0.40176003472300664,0.9192605455406964
11,10,1,22,0.5238095238095238,0.9545454545454546,0.45465079628838395,0.9378118263023654
39,57,20,116,0.40625,0.8275862068965517,0.36982936771695535,0.9131812844304442
18,76,2,96,0.19148936170212766,0.9791666666666666,0.37039927653154503,0.9186084552987915
0,1,0,1,0.0,1.0,0.3402405463728148,0.9246874826544147
36,70,3,109,0.33962264150943394,0.9724770642201835,0.33473645794499085,0.9430454016564875
131,213,35,379,0.3808139534883721,0.9076517150395779,0.3213418411309811,0.938923084303865
10,67,20,97,0.12987012987012986,0.7938144329896907,0.2816936586256557,0.9193202200511605
0,28,5,33,0.0,0.8484848484848485,0.20686372665286662,0.9041687048996455
0,12,2,14,0.0,0.8571428571428571,0.14882801236715235,0.9083910835062605
2,7,2,11,0.2222222222222222,0.8181818181818182,0.1532184210128801,0.885393248008425
38,144,59,241,0.2087912087912088,0.7551867219917012,0.18304573655448136,0.850419922578668
41,94,23,158,0.3037037037037037,0.8544303797468354,0.17791445972509132,0.8335561105110469
3,18,4,25,0.14285714285714285,0.84,0.14392062963491573,0.8238915797911072
6,26,90,122,0.1875,0.26229508196721313,0.15215346822489714,0.7479602439307532
6,40,3,49,0.13043478260869565,0.9387755102040817,0.17078700859756799,0.7608589098906436
7,153,26,186,0.04375,0.8602150537634409,0.17703700859756796,0.7612977951221557
25,106,3,134,0.19083969465648856,0.9776119402985075,0.17255379037389176,0.7840735268531113
28,108,8,144,0.20588235294117646,0.9444444444444444,0.17213823953817284,0.8111103443463603
49,55,2,106,0.47115384615384615,0.9811320754716981,0.19605968845962177,0.8292105865927691
53,164,7,224,0.24423963133640553,0.96875,0.21054290109951643,0.8476034437356263
17,61,5,83,0.21794871794871795,0.9397590361445783,0.21489271794933332,0.9443840086181071
5,46,2,53,0.09803921568627451,0.9622641509433962,0.2102647798175588,0.9477395287237236
1,27,8,36,0.03571428571428571,0.7777777777777778,0.20911682063388537,0.935962775011486
5,150,4,159,0.03225806451612903,0.9748427672955975,0.18646230204240544,0.9355671788682132
16,89,26,131,0.1523809523809524,0.8015267175572519,0.17881924481951628,0.9151503607414713
34,65,25,124,0.3434343434343434,0.7983870967741935,0.16057360157387301,0.8890439352132563
8,92,2,102,0.08,0.9803921568627451,0.13711079709724366,0.8907071004793627
9,55,1,65,0.140625,0.9846153846153847,0.12606455167599825,0.8971151502609065
10,99,12,121,0.09174311926605505,0.9008264462809917,0.12516510933025263,0.8883383353091344
13,33,1,47,0.2826086956521739,0.9787234042553191,0.1604357393213795,0.9170448533773546
23,73,1,97,0.23958333333333334,0.9896907216494846,0.1900536348666944,0.9191659897136243
6,19,4,29,0.24,0.8620689655172413,0.2025706416694155,0.9278148822793371
7,61,12,80,0.10294117647058823,0.85,0.1682144749603076,0.9351881541687378
23,28,1,52,0.45098039215686275,0.9807692307692307,0.22121167383985943,0.9352420218696645
0,2,58,60,0.0,0.03333333333333333,0.2011223881255737,0.7993445859722286
11,160,9,180,0.06432748538011696,0.95,0.1972058689990111,0.8063693793606583
42,144,15,201,0.22580645161290322,0.9253731343283582,0.18909126270768675,0.7987479122282354
53,84,3,140,0.38686131386861317,0.9785714285714285,0.2101309742127267,0.797159441788513
8,48,7,63,0.14285714285714285,0.8888888888888888,0.19625342319231853,0.800990859413034
26,180,6,212,0.1262135922330097,0.9716981132075472,0.19957805401552164,0.8183763041569695
0,12,53,65,0.0,0.18461538461538463,0.13515228370739837,0.7046400404207057
6,6,2,14,0.5,0.8571428571428571,0.2065808551359698,0.8223271152506377
30,41,5,76,0.4225352112676056,0.9342105263157895,0.257753387405611,0.8200714761528933
1,60,3,64,0.01639344262295082,0.953125,0.22783724326418925,0.8240360283916992
46,64,33,143,0.41818181818181815,0.7692307692307693,0.23231160102321854,0.7941302199144623
24,87,397,508,0.21621621621621623,0.21850393700787402,0.2427914686459433,0.6983609410743172
1,43,9,53,0.022727272727272728,0.8301886792452831,0.22800770871655232,0.6781453076511366
21,60,20,101,0.25925925925925924,0.801980198019802,0.26504474575358933,0.7663402809946247
2,0,0,2,1.0,1.0,0.3364733171821608,0.7867484442599311
3,13,1,17,0.1875,0.9411764705882353,0.3028968584296457,0.7877435791559947
20,70,4,94,0.2222222222222222,0.9574468085106383,0.3323009698009702,0.7883609803718002
41,77,22,140,0.3474576271186441,0.8428571428571429,0.32219751393480245,0.7988790337469964
28,31,4,63,0.4745762711864407,0.9365079365079365,0.35910609321626313,0.9014510336755768
11,16,2,29,0.4074074074074074,0.9310344827586207,0.41406039817056806,0.915857577034625
10,11,1,22,0.47619047619047616,0.9545454545454546,0.4130284315958884,0.9385169277877328
39,57,20,116,0.40625,0.8275862068965517,0.3282070030244598,0.9138863859158116
19,75,2,96,0.20212765957446807,0.9791666666666666,0.33922524010652666,0.9193135567841589
0,1,0,1,0.0,1.0,0.3123511241234998,0.9247557336549072
36,70,3,109,0.33962264150943394,0.9724770642201835,0.3132495967200857,0.9436810285435049
130,212,36,378,0.38011695906432746,0.9047619047619048,0.30701933179222923,0.9391458811512147
10,67,20,97,0.12987012987012986,0.7938144329896907,0.27631112374411976,0.918907390011493
0,28,5,33,0.0,0.8484848484848485,0.208283912859766,0.9037558748599779
0,12,2,14,0.0,0.8571428571428571,0.15024819857405172,0.9079782534665928
1,8,2,11,0.1111111111111111,0.8181818181818182,0.13724583450785785,0.8849804179687574
37,145,59,241,0.2032967032967033,0.7551867219917012,0.16628822069310117,0.8500070925390004
42,93,23,158,0.3111111111111111,0.8544303797468354,0.16221514492191222,0.8331432804713793
3,18,4,25,0.14285714285714285,0.84,0.12832088546374298,0.8238915797911072
6,24,92,122,0.2,0.2459016393442623,0.1383394383394387,0.745618323556046
5,42,3,50,0.10638297872340426,0.94,0.15353700672849646,0.758691916629639
7,153,26,186,0.04375,0.8602150537634409,0.1597870067284965,0.759130801861151
26,106,3,135,0.19696969696969696,0.9777777777777777,0.17205251899400872,0.7819302246605738
27,109,8,144,0.19852941176470587,0.9444444444444444,0.1713714773465805,0.8089670421538229
49,55,2,106,0.47115384615384615,0.9811320754716981,0.1942347252098284,0.8270672844002318
52,165,7,224,0.23963133640552994,0.96875,0.20805961000245515,0.845460141543089
17,61,5,83,0.21794871794871795,0.9397590361445783,0.21062371256655768,0.944582626800277
4,48,1,53,0.07692307692307693,0.9811320754716981,0.20641515516651093,0.9504586375819482
1,27,8,36,0.03571428571428571,0.7777777777777778,0.20526719598283744,0.9386818838697105
5,150,4,159,0.03225806451612903,0.9748427672955975,0.1817369627751849,0.9382625966579704
18,87,26,131,0.17142857142857143,0.8015267175572519,0.17786541415573714,0.9178457785312286
33,68,24,125,0.32673267326732675,0.808,0.1572338180290915,0.8931126248924146
12,88,2,102,0.12,0.9803921568627451,0.1401436271140158,0.894775790158521
10,53,1,64,0.15873015873015872,0.984375,0.13168383293993588,0.9011494992807242
10,97,13,120,0.09345794392523364,0.8916666666666667,0.13404595679738684,0.8883687265942911
13,33,1,47,0.2826086956521739,0.9787234042553191,0.16931658678851375,0.9170752446625113
23,73,1,97,0.23958333333333334,0.9896907216494846,0.19893448233382863,0.919196380998781
6,19,4,29,0.24,0.8620689655172413,0.20873040070117557,0.9278452735644936
7,62,11,80,0.10144927536231885,0.8625,0.1765470581433173,0.9356309878502079
22,29,1,52,0.43137254901960786,0.9807692307692307,0.22102885086040414,0.9356848555511345
0,2,58,60,0.0,0.03333333333333333,0.19835311389895288,0.7998217603130394
11,160,9,180,0.06432748538011696,0.95,0.1941916198210791,0.8081550936463726
44,143,14,201,0.23529411764705882,0.9303482587064676,0.1874323943917769,0.8012443585679653
52,83,4,139,0.3851851851851852,0.9712230215827338,0.2082326589420415,0.7986061157012865
6,50,7,63,0.10714285714285714,0.8888888888888888,0.1892530671053068,0.8024375333258077
29,177,6,212,0.1407766990291262,0.9716981132075472,0.19487127048627925,0.8180372637840287
0,11,54,65,0.0,0.16923076923076924,0.13324662062633527,0.7021031978499627
6,6,2,14,0.5,0.8571428571428571,0.20467519205490672,0.8197902726798947
30,41,5,76,0.4225352112676056,0.9342105263157895,0.25584772432454794,0.8175346335821504
1,60,3,64,0.01639344262295082,0.953125,0.22457619932110393,0.8207884537669407
48,61,33,142,0.44036697247706424,0.7676056338028169,0.23245931179137239,0.7917002555126669
25,87,396,508,0.22321428571428573,0.2204724409448819,0.24904094444443362,0.6962121915206658
1,43,9,53,0.022727272727272728,0.8301886792452831,0.23217674068702596,0.6759965580974853
22,60,20,102,0.2682926829268293,0.803921568627451,0.27050426681943013,0.7666666722970114
2,0,0,2,1.0,1.0,0.3419328382480016,0.7870748355623174
3,13,1,17,0.1875,0.9411764705882353,0.3083563794954865,0.788069970458381
19,71,4,94,0.2111111111111111,0.9574468085106383,0.3361731892795094,0.7886873716741866
45,74,22,141,0.37815126050420167,0.8439716312056738,0.3272852304262433,0.7995967998745945
28,31,4,63,0.4745762711864407,0.9365079365079365,0.36319408549369403,0.9018875849550311
11,16,2,29,0.4074074074074074,0.9310344827586207,0.4181483904479989,0.9162941283140792
11,12,1,24,0.4782608695652174,0.9583333333333334,0.41654401737409114,0.9390580533288582
38,58,21,117,0.3958333333333333,0.8205128205128205,0.3302344935645673,0.9134170276878326
18,91,2,111,0.1651376146788991,0.9819819819819819,0.33596843851869573,0.9192463864583679
0,1,0,1,0.0,1.0,0.306265468221666,0.9246885633291162
35,87,3,125,0.28688524590163933,0.976,0.3041651745522857,0.9441171347576878
127,257,30,414,0.3307291666666667,0.927536231884058,0.2908795107104778,0.9428354626685621
11,75,20,106,0.12790697674418605,0.8113207547169812,0.25496474384142065,0.9250978746327391
1,34,5,40,0.02857142857142857,0.875,0.19072339512802225,0.9131931127279772
0,12,2,14,0.0,0.8571428571428571,0.1341757760804032,0.9184259751036967
3,11,2,16,0.21428571428571427,0.875,0.1411969331670911,0.9031428348205566
40,170,59,269,0.19047619047619047,0.7806691449814126,0.1684078175208326,0.8718098555321869
44,105,22,171,0.2953020134228188,0.8713450292397661,0.1696102128810011,0.856859145423582
3,19,4,26,0.13636363636363635,0.8461538461538461,0.14184370855199674,0.8452330903192661
5,26,95,126,0.16129032258064516,0.24603174603174602,0.1466127579572052,0.7644775176499469
6,44,3,53,0.12,0.9433962264150944,0.1596739824470011,0.7742484071378174
8,171,27,206,0.0446927374301676,0.8689320388349514,0.16605865922273932,0.7759325759509738
24,142,3,169,0.14457831325301204,0.9822485207100592,0.15610045907521045,0.7912537931952678
25,117,8,150,0.176056338028169,0.9466666666666667,0.15404048015406452,0.8149677248645899
48,67,2,117,0.41739130434782606,0.9829059829059829,0.17148180742906557,0.8309050039597637
52,165,7,224,0.23963133640552994,0.96875,0.18623433600647893,0.8484187402235
23,72,7,102,0.24210526315789474,0.9313725490196079,0.1977793275175146,0.9463245692217658
4,51,5,60,0.07272727272727272,0.9166666666666666,0.19102608076426783,0.9425060606862763
1,29,9,39,0.03333333333333333,0.7692307692307693,0.18940330875043435,0.9282630221713931
5,155,4,164,0.03125,0.975609756097561,0.17321354971428976,0.9273146272267505
17,97,26,140,0.14912280701754385,0.8142857142857143,0.1693659024270576,0.9084030626009001
34,81,26,141,0.2956521739130435,0.8156028368794326,0.15197459807923153,0.8845026131685357
11,96,2,109,0.102803738317757,0.981651376146789,0.13242779835240684,0.8863456669037914
10,54,2,66,0.15625,0.9696969696969697,0.12016276075842185,0.8918205841434146
10,111,12,133,0.08264462809917356,0.9097744360902256,0.12157952581155056,0.8908359797753516
13,36,1,50,0.2653061224489796,0.98,0.1547184956852143,0.9209458698852416
21,78,1,100,0.21212121212121213,0.99,0.1805572402739589,0.9230016190141616
7,19,4,30,0.2692307692307692,0.8666666666666667,0.19771552059013395,0.9304846122114404
8,77,11,96,0.09411764705882353,0.8854166666666666,0.16892487389667396,0.9404580164667596
20,34,2,56,0.37037037037037035,0.9642857142857143,0.2071486784756187,0.9379772076294631
0,4,58,62,0.0,0.06451612903225806,0.18482724990419014,0.8086656589630757
9,190,9,208,0.04522613065326633,0.9567307692307693,0.17948175026906052,0.8153737065545821
43,177,15,235,0.19545454545454546,0.9361702127659575,0.16950295355556996,0.8091123083782902
44,92,15,151,0.3235294117647059,0.9006622516556292,0.18541841064749764,0.796349772900523
9,49,7,65,0.15517241379310345,0.8923076923076924,0.16912435987068825,0.8000127765635268
27,195,6,228,0.12162162162162163,0.9736842105263158,0.17305349909394513,0.8126224256863336
0,9,56,65,0.0,0.13846153846153847,0.1201434461838922,0.6946475434257371
6,7,2,15,0.46153846153846156,0.8666666666666667,0.18607751211795814,0.8092404773735097
31,52,5,88,0.37349397590361444,0.9431818181818182,0.23297291858229358,0.8073049129379453
1,61,3,65,0.016129032258064516,0.9538461538461539,0.20735498812565348,0.8098300473779734
48,64,33,145,0.42857142857142855,0.7724137931034483,0.2223609905266138,0.7915088390133762
22,118,456,596,0.15714285714285714,0.2348993288590604,0.22264248243372148,0.6975933585207142
1,49,9,59,0.02,0.847457627118644,0.208125107916347,0.6795609894624756
22,66,20,108,0.25,0.8148148148148148,0.2438393936306327,0.7761828860843722
2,0,0,2,1.0,1.0,0.3207624705537096,0.7952305051319912
2,14,1,17,0.125,0.9411764705882353,0.28526333113890756,0.7949440269043365
19,82,4,105,0.18811881188118812,0.9619047619047619,0.30983329965649664,0.7960952566269948
42,84,24,150,0.3333333333333333,0.84,0.29622785747962593,0.8057504290407879
25,34,4,63,0.423728813559322,0.9365079365079365,0.3343115655391209,0.9059802301334845
10,19,2,31,0.3448275862068966,0.9354838709677419,0.38071550642582036,0.9185554078262127
11,12,1,24,0.4782608695652174,0.9583333333333334,0.42719501265043086,0.9409628152336201
39,57,21,117,0.40625,0.8205128205128205,0.3423735840790023,0.9153217895925946
17,92,2,111,0.1559633027522936,0.9819819819819819,0.34679691304361565,0.9211511483631297
0,1,0,1,0.0,1.0,0.31850836990358733,0.9265933252338782
35,87,3,125,0.28688524590163933,0.976,0.3092687621752502,0.9441171347576878
131,250,33,414,0.3438320209973753,0.9202898550724637,0.2978549346664006,0.9418002659811915
11,75,20,106,0.12790697674418605,0.8113207547169812,0.2570140594229592,0.9240626779453686
1,34,5,40,0.02857142857142857,0.875,0.19277271070956079,0.9121579160406067
0,12,2,14,0.0,0.8571428571428571,0.13473699642384648,0.9173907784163261
3,11,2,16,0.21428571428571427,0.875,0.14306876950004946,0.902107638133186
43,167,59,269,0.20476190476190476,0.7806691449814126,0.17232047018032157,0.8707746588448162
45,104,22,171,0.30201342281879195,0.8713450292397661,0.1744816383113434,0.8558239487362115
3,19,4,26,0.13636363636363635,0.8461538461538461,0.14484329764938067,0.8452330903192661
6,20,100,126,0.23076923076923078,0.20634920634920634,0.1595379053672442,0.7588085834095839
6,44,3,53,0.12,0.9433962264150944,0.17259912985704012,0.7685794728974545
7,172,27,206,0.03910614525139665,0.8689320388349514,0.1781857220358111,0.7702636417106109
25,141,3,169,0.15060240963855423,0.9822485207100592,0.16908810708621674,0.7855848589549052
23,119,8,150,0.1619718309859155,0.9466666666666667,0.16297523940393258,0.8092987906242269
48,67,2,117,0.41739130434782606,0.9829059829059829,0.1794577939080803,0.8252360697194009
53,164,7,224,0.24423963133640553,0.96875,0.19486865033276166,0.8427498059831372
23,72,7,102,0.24210526315789474,0.9313725490196079,0.1964880835311422,0.946324569221766
4,51,5,60,0.07272727272727272,0.9166666666666666,0.18973483677789543,0.9425060606862762
1,29,9,39,0.03333333333333333,0.7692307692307693,0.18891014936102926,0.928263022171393
5,155,4,164,0.03125,0.975609756097561,0.17185980512695007,0.9273146272267504
17,97,26,140,0.14912280701754385,0.8142857142857143,0.17002423027432556,0.9084030626009002
37,79,25,141,0.31896551724137934,0.8226950354609929,0.15596340354483315,0.885515784394473
10,97,2,109,0.09345794392523364,0.981651376146789,0.13442316248609434,0.8873588381297285
9,55,2,66,0.140625,0.9696969696969697,0.1199259820349665,0.8928337553693516
10,111,12,133,0.08264462809917356,0.9097744360902256,0.1213427470880952,0.8918491510012887
13,36,1,50,0.2653061224489796,0.98,0.15448171696175894,0.9219590411111788
22,77,1,100,0.2222222222222222,0.99,0.181763462993505,0.9240147902400987
7,19,4,30,0.2692307692307692,0.8666666666666667,0.19892174330968002,0.9314977834373775
9,77,10,96,0.10465116279069768,0.8958333333333334,0.16830540695958265,0.9419461117048548
22,32,2,56,0.4074074074074074,0.9642857142857143,0.2131553303141789,0.9394653028675585
0,4,58,62,0.0,0.06451612903225806,0.1930660445998932,0.8101537542011711
10,189,9,208,0.05025125628140704,0.9567307692307693,0.18843842005449798,0.8168618017926772
43,176,16,235,0.1963470319634703,0.9319148936170213,0.17858712141371091,0.8099925008808232
44,91,16,151,0.32592592592592595,0.8940397350993378,0.19340193622852572,0.7962838916093
11,47,7,65,0.1896551724137931,0.8923076923076924,0.18203399382610058,0.7999468952723037
27,195,6,228,0.12162162162162163,0.9736842105263158,0.18445834508766115,0.8110684491570154
0,9,56,65,0.0,0.13846153846153847,0.12625728688660295,0.6930935668964189
6,7,2,15,0.46153846153846156,0.8666666666666667,0.1921913528206689,0.8076865008441916
30,53,5,88,0.3614457831325301,0.9431818181818182,0.23664771379940075,0.805750936408627
1,61,3,65,0.016129032258064516,0.9538461538461539,0.21090228527005708,0.8088839735842175
47,65,33,145,0.41964285714285715,0.7724137931034483,0.22429041830104726,0.7915088390133762
20,121,455,596,0.14184397163120568,0.23657718120805368,0.21746024676067763,0.6978330517134277
1,49,9,59,0.02,0.847457627118644,0.2029428722433031,0.6798006826551889
23,65,20,108,0.26136363636363635,0.8148148148148148,0.2402805345809654,0.7764225792770855
2,0,0,2,1.0,1.0,0.3172036115040423,0.7954701983247047
2,14,1,17,0.125,0.9411764705882353,0.2834256424851095,0.7951837200970499
21,80,4,105,0.2079207920792079,0.9619047619047619,0.3108244653167014,0.7963349498197081
38,88,24,150,0.30158730158730157,0.84,0.29395938595162197,0.8059901222335012
25,34,4,63,0.423728813559322,0.9365079365079365,0.33422864908421,0.9059802301334845
11,18,2,31,0.3793103448275862,0.9354838709677419,0.38555869834529377,0.9185554078262127
11,12,1,24,0.4782608695652174,0.9583333333333334,0.42120071105190365,0.9390580533288582
39,57,21,117,0.40625,0.8205128205128205,0.33637928248047505,0.9134170276878326
17,92,2,111,0.1559633027522936,0.9819819819819819,0.34080261144508844,0.9192463864583679
0,1,0,1,0.0,1.0,0.3181717769330658,0.9246885633291162
36,86,3,125,0.29508196721311475,0.976,0.3104397223626037,0.9441171347576878
132,248,34,414,0.3473684210526316,0.9178743961352657,0.299531094861648,0.9414552004187347
11,75,20,106,0.12790697674418605,0.8113207547169812,0.25869021961820654,0.9237176123829116
1,34,5,40,0.02857142857142857,0.875,0.19444887090480817,0.9118128504781498
0,12,2,14,0.0,0.8571428571428571,0.13641315661909387,0.9170457128538693
2,12,2,16,0.14285714285714285,0.875,0.13454084806264377,0.9017625725707291
40,170,59,269,0.19047619047619047,0.7806691449814126,0.16175173241638527,0.8704295932823595
44,104,23,171,0.2972972972972973,0.8654970760233918,0.16206820814269704,0.8546434612857011
4,18,4,26,0.18181818181818182,0.8461538461538461,0.1384181739663471,0.8443976684312126
7,21,98,126,0.25,0.2222222222222222,0.15586003443146337,0.7602407352176757
6,44,3,53,0.12,0.9433962264150944,0.16892125892125925,0.7700116247055462
10,169,27,206,0.055865921787709494,0.8689320388349514,0.17690210489093205,0.7716957935187025
25,141,3,169,0.15060240963855423,0.9822485207100592,0.17800857157399083,0.7870170107629966
23,119,8,150,0.1619718309859155,0.9466666666666667,0.17393652021823727,0.8107309424323187
51,64,2,117,0.4434782608695652,0.9829059829059829,0.19481951501427552,0.827503643415546
53,164,7,224,0.24423963133640553,0.96875,0.20373686494545037,0.8450173796792823
22,73,7,102,0.23157894736842105,0.9313725490196079,0.20110528599808195,0.9463245692217658
5,51,4,60,0.08928571428571429,0.9333333333333333,0.19671753089604113,0.9448870130672287
2,28,9,39,0.06666666666666667,0.7692307692307693,0.19826049445017785,0.9306439745523454
5,155,4,164,0.03125,0.975609756097561,0.1812101502160987,0.9296955796077029
16,98,26,140,0.14035087719298245,0.8142857142857143,0.17812144253139398,0.9107840149818526
35,81,25,141,0.3017241379310345,0.8226950354609929,0.1578708535401753,0.8878967367754254
10,97,2,109,0.09345794392523364,0.981651376146789,0.13633061248143646,0.8897397905106809
10,55,1,66,0.15384615384615385,0.9848484848484849,0.12522592769254112,0.8973792099148064
9,112,12,133,0.0743801652892562,0.9097744360902256,0.12309656355018997,0.8940136531657908
14,35,1,50,0.2857142857142857,0.98,0.15438908055699269,0.924123543275681
22,77,1,100,0.2222222222222222,0.99,0.18167082658873873,0.9261792924046007
6,20,4,30,0.23076923076923078,0.8666666666666667,0.19458773424248849,0.9336622856018797
10,76,10,96,0.11627906976744186,0.8958333333333334,0.16809558164768953,0.9441106138693568
20,35,1,56,0.36363636363636365,0.9821428571428571,0.20669249874927953,0.9441808254402239
0,4,58,62,0.0,0.06451612903225806,0.18471447677125757,0.8127047746093342
11,188,9,208,0.05527638190954774,0.9567307692307693,0.18198536485987063,0.8194128222008406
44,175,16,235,0.2009132420091324,0.9319148936170213,0.16987093004484874,0.8125435212889863
52,92,7,151,0.3611111111111111,0.9536423841059603,0.1897121998861186,0.8073495761612665
11,47,7,65,0.1896551724137931,0.8923076923076924,0.18383876297819893,0.8110125798242701
27,195,6,228,0.12162162162162163,0.9736842105263158,0.18460198467165315,0.8221341337089819
0,12,53,65,0.0,0.18461538461538463,0.13265393272360124,0.7082016376336286
6,7,2,15,0.46153846153846156,0.8666666666666667,0.19858799865766713,0.8227945715814012
30,53,5,88,0.3614457831325301,0.9431818181818182,0.24232648454666464,0.8208590071458369
1,61,3,65,0.016129032258064516,0.9538461538461539,0.21592874029651207,0.8239920443214273
48,64,33,145,0.42857142857142855,0.7724137931034483,0.22556592850512885,0.7981022456067827
22,105,469,596,0.1732283464566929,0.21308724832214765,0.22321923908268596,0.7010707536088479
1,49,9,59,0.02,0.847457627118644,0.20870186456531145,0.683038384550609
23,65,20,108,0.26136363636363635,0.8148148148148148,0.24603952690297382,0.773066874579099
2,0,0,2,1.0,1.0,0.32296260382605074,0.792114493626718
2,14,1,17,0.125,0.9411764705882353,0.2891846348071178,0.7918280153990633
20,81,4,105,0.19801980198019803,0.9619047619047619,0.31516903048170836,0.7929792451217216
45,83,22,150,0.3515625,0.8533333333333334,0.30416775497150433,0.8045391794402766
25,34,4,63,0.423728813559322,0.9365079365079365,0.33995353598616557,0.9078849920382464
12,17,2,31,0.41379310344827586,0.9354838709677419,0.39620969362163355,0.9204601697309747
11,12,1,24,0.4782608695652174,0.9583333333333334,0.42086173291497697,0.9413709784989263
42,59,16,117,0.4158415841584158,0.8632478632478633,0.3374105306518936,0.9218349589629068
21,88,2,111,0.1926605504587156,0.9819819819819819,0.3470763235745672,0.9276643177334422
0,1,0,1,0.0,1.0,0.3232667997650434,0.9317459503865033
36,86,3,125,0.29508196721311475,0.976,0.31705241262900913,0.9502221408626939
132,247,35,414,0.3482849604221636,0.9154589371980676,0.3062747193237008,0.9472151409612838
14,72,20,106,0.16279069767441862,0.8113207547169812,0.27041723278457835,0.929477552925461
1,34,5,40,0.02857142857142857,0.875,0.20617588407117995,0.9175727910206991
0,12,2,14,0.0,0.8571428571428571,0.14676994347712055,0.9167006472914123
3,11,2,16,0.21428571428571427,0.875,0.14985925259526317,0.9014175070082722
43,167,59,269,0.20476190476190476,0.7806691449814126,0.1791109532755353,0.8700845277199026
44,104,23,171,0.2972972972972973,0.8654970760233918,0.17942742900184713,0.8542983957232442
4,18,4,26,0.18181818181818182,0.8461538461538461,0.15564646062984971,0.8443976684312126
7,26,93,126,0.21212121212121213,0.2619047619047619,0.16269367697939163,0.7659096694580383
5,45,3,53,0.1,0.9433962264150944,0.17289775861204473,0.7756805589459089
9,170,27,206,0.05027932960893855,0.8689320388349514,0.18008051998475022,0.7773647277590653
25,141,3,169,0.15060240963855423,0.9822485207100592,0.1709829050351559,0.7926859450033595
26,116,8,150,0.18309859154929578,0.9466666666666667,0.16788814600478322,0.8163998766726814
49,66,2,117,0.4260869565217391,0.9829059829059829,0.186286668751132,0.8331725776559088
53,164,7,224,0.24423963133640553,0.96875,0.19520401868230683,0.8506863139196451
22,73,7,102,0.23157894736842105,0.9313725490196079,0.1979836951461938,0.946324569221766
4,51,5,60,0.07272727272727272,0.9166666666666666,0.19408759125008992,0.9425060606862763
1,29,9,39,0.03333333333333333,0.7692307692307693,0.1916667346392892,0.9282630221713931
5,148,11,164,0.032679738562091505,0.9329268292682927,0.17482063877122306,0.9212170662511407
16,98,26,140,0.14035087719298245,0.8142857142857143,0.16871382243460692,0.9023055016252904
36,80,25,141,0.3103448275862069,0.8226950354609929,0.15217923258667373,0.8794182234188632
8,99,2,109,0.07476635514018691,0.981651376146789,0.1279687645586425,0.8812612771541188
10,55,1,66,0.15384615384615385,0.9848484848484849,0.11686407976974718,0.8889006965582441
9,112,12,133,0.0743801652892562,0.9097744360902256,0.11710020727860196,0.8879160921901811
14,35,1,50,0.2857142857142857,0.98,0.15315462904730945,0.9180259823000713
22,77,1,100,0.2222222222222222,0.99,0.18023212671304242,0.9261792924046007
5,21,4,30,0.19230769230769232,0.8666666666666667,0.18765452887228665,0.9336622856018798
10,75,11,96,0.11764705882352941,0.8854166666666666,0.16012627619190417,0.9426225186312617
20,35,1,56,0.36363636363636365,0.9821428571428571,0.20139342026278653,0.9426927302021285
0,4,58,62,0.0,0.06451612903225806,0.17941539828476458,0.8112166793712391
10,189,9,208,0.05025125628140704,0.9567307692307693,0.1759684112836433,0.8179247269627453
42,178,15,235,0.19090909090909092,0.9361702127659575,0.16242481202575831,0.8116633287864534
49,98,4,151,0.3333333333333333,0.9735099337748344,0.17829782789877416,0.8093076050400013
7,51,7,65,0.1206896551724138,0.8923076923076924,0.16806667973659153,0.812970608703005
32,190,6,228,0.14414414414414414,0.9736842105263158,0.17185197763953647,0.825580257825812
0,12,53,65,0.0,0.18461538461538463,0.11990392569148454,0.7116477617504586
6,7,2,15,0.46153846153846156,0.8666666666666667,0.18583799162555045,0.8262406956982314
29,54,5,88,0.3493975903614458,0.9431818181818182,0.22857318220841316,0.824305131262667
1,61,3,65,0.016129032258064516,0.9538461538461539,0.20360460240112369,0.826830265702695
48,64,33,145,0.42857142857142855,0.7724137931034483,0.21721004457799445,0.7981022456067828
20,106,470,596,0.15873015873015872,0.21140939597315436,0.2226444022291008,0.7008310604161344
1,49,9,59,0.02,0.847457627118644,0.20490952449422312,0.6827986913578956
23,65,20,108,0.26136363636363635,0.8148148148148148,0.24224718683188545,0.7728271813863856
2,0,0,2,1.0,1.0,0.3191702637549624,0.7918748004340047
2,14,1,17,0.125,0.9411764705882353,0.28711346513189867,0.7915883222063499
16,85,4,105,0.15841584158415842,0.9619047619047619,0.3074401521784835,0.7927395519290082
44,82,24,150,0.3492063492063492,0.84,0.29610228369775793,0.8023947243428013
25,34,4,63,0.423728813559322,0.9365079365079365,0.33395923438763836,0.9059802301334845
12,17,2,31,0.41379310344827586,0.9354838709677419,0.39021539202310634,0.9185554078262127
10,13,1,24,0.43478260869565216,0.9583333333333334,0.43851974671797844,0.9373397806175537
43,60,14,117,0.4174757281553398,0.8803418803418803,0.35530199359731274,0.9202457635235367
22,87,2,111,0.2018348623853211,0.9819819819819819,0.36627840250950144,0.9260751222940719
0,1,0,1,0.0,1.0,0.340881577112676,0.932154149649695
36,86,3,125,0.29508196721311475,0.976,0.3346099937363413,0.9520285164176788
132,248,33,413,0.3473684210526316,0.9200968523002422,0.31643744371722576,0.9496840758165798
14,72,20,106,0.16279069767441862,0.8113207547169812,0.26561918359664005,0.932582114667774
1,34,5,40,0.02857142857142857,0.875,0.20758901500746527,0.9206773527630121
0,13,1,14,0.0,0.9285714285714286,0.14794962527098815,0.9275672882243763
3,12,1,16,0.2,0.9375,0.14768750207308515,0.9212127193698073
43,171,55,269,0.20093457943925233,0.7955390334572491,0.17639244199297832,0.8920040098637001
48,100,23,171,0.32432432432432434,0.8654970760233918,0.180569921580294,0.8762178778670418
3,23,0,26,0.11538461538461539,1.0,0.14742937791343455,0.8876326132527215
7,57,62,126,0.109375,0.5079365079365079,0.13979856395994616,0.8442920065697966
7,43,3,53,0.14,0.9433962264150944,0.15571693130688494,0.8540628960576673
9,170,27,206,0.05027932960893855,0.8689320388349514,0.16289969267959045,0.8455429832381706
25,141,3,169,0.15060240963855423,0.9822485207100592,0.1558428940565268,0.8519356290538933
29,113,8,150,0.20422535211267606,0.9466666666666667,0.15631300443844443,0.8735252909409529
49,66,2,117,0.4260869565217391,0.9829059829059829,0.1708505233237894,0.8902979919241802
53,164,7,224,0.24423963133640553,0.96875,0.18925838274547369,0.8858337062098945
21,73,8,102,0.22340425531914893,0.9215686274509803,0.20554827636249498,0.9449240089976764
5,54,1,60,0.0847457627118644,0.9833333333333333,0.19765481389276135,0.950629309985996
1,29,9,39,0.03333333333333333,0.7692307692307693,0.19523395728196058,0.9363862714711129
5,155,4,164,0.03125,0.975609756097561,0.17818361304788138,0.9354378765264703
16,99,25,140,0.1391304347826087,0.8214285714285714,0.16888433914358608,0.9175467200638854
41,76,24,141,0.3504273504273504,0.8297872340425532,0.15807582398724485,0.8956726130833953
8,99,2,109,0.07476635514018691,0.981651376146789,0.1338653559592136,0.8975156668186509
10,55,1,66,0.15384615384615385,0.9848484848484849,0.1239284843202143,0.9065556464468658
9,73,51,133,0.10975609756097561,0.6165413533834586,0.12750138929865876,0.8541567921683123
14,35,1,50,0.2857142857142857,0.98,0.16355581106736622,0.8842666822782024
23,76,1,100,0.23232323232323232,0.99,0.1922805585421137,0.8863224314071224
4,22,4,30,0.15384615384615385,0.8666666666666667,0.19438280412262016,0.8927850164411358
11,80,5,96,0.12087912087912088,0.9479166666666666,0.1615901999014445,0.9096606496731522
24,31,1,56,0.43636363636363634,0.9821428571428571,0.2132469543619373,0.909730861244019
0,4,58,62,0.0,0.06451612903225806,0.19126893238391535,0.7782548104131294
12,187,9,208,0.06030150753768844,0.9567307692307693,0.18420399095201714,0.8268532983913167
43,178,14,235,0.19457013574660634,0.9404255319148936,0.17118339809949154,0.8211998029505871
50,98,3,151,0.33783783783783783,0.9801324503311258,0.18625691317300658,0.819790152997891
8,55,2,65,0.12698412698412698,0.9692307692307692,0.18241948076414563,0.8344421676499055
35,187,6,228,0.15765765765765766,0.9736842105263158,0.18767355744679373,0.8381232453441411
8,56,1,65,0.125,0.9846153846153847,0.14319303796627425,0.8384764635545022
6,7,2,15,0.46153846153846156,0.8666666666666667,0.20912710390034017,0.9530693975022749
30,53,5,88,0.3614457831325301,0.9431818181818182,0.2521477146996033,0.9511338330667105
1,61,3,65,0.016129032258064516,0.9538461538461539,0.22665612848695443,0.9530510647711762
52,65,28,145,0.4444444444444444,0.8068965517241379,0.24188564371646964,0.9283030792558922
24,104,468,596,0.1875,0.21476510067114093,0.25053076843302297,0.8205222694616596
1,49,9,59,0.02,0.847457627118644,0.2308653887676433,0.8024899004034208
23,65,20,108,0.26136363636363635,0.8148148148148148,0.2503459082481628,0.7782326761461966
2,0,0,2,1.0,1.0,0.3272689851712397,0.7972802951938156
2,14,1,17,0.125,0.9411764705882353,0.2934910161523068,0.7969938169661608
17,85,3,105,0.16666666666666666,0.9714285714285714,0.3149963924963929,0.7995055909065061
43,84,23,150,0.33858267716535434,0.8466666666666667,0.29987328288509424,0.805187035898296
25,34,4,63,0.423728813559322,0.9365079365079365,0.3336202562507117,0.9082931553035526
12,17,2,31,0.41379310344827586,0.9354838709677419,0.38987641388617966,0.9208683329962808
10,11,1,22,0.47619047619047616,0.9545454545454546,0.43797074820077275,0.9366322055178814
41,57,17,115,0.41836734693877553,0.8521739130434782,0.35488036919202637,0.9155141930955212
21,73,2,96,0.22340425531914893,0.9791666666666666,0.3689381199519048,0.9209413639638685
0,1,0,1,0.0,1.0,0.345128596142381,0.9270203913194918
35,71,3,109,0.330188679245283,0.9724770642201835,0.3434583586230869,0.9465579311060486
132,210,35,377,0.38596491228070173,0.9071618037135278,0.33079959306512424,0.942365626421133
11,66,20,97,0.14285714285714285,0.7938144329896907,0.28242468754736155,0.9227627621684287
0,28,5,33,0.0,0.8484848484848485,0.21439747666300776,0.9076112470169135
0,12,2,14,0.0,0.8571428571428571,0.15463071281461124,0.9083210961739676
2,7,2,11,0.2222222222222222,0.8181818181818182,0.15446185094362175,0.8853232606761322
44,139,59,242,0.24043715846994534,0.756198347107438,0.1888100164393282,0.8504944531200519
44,90,23,157,0.3283582089552239,0.8535031847133758,0.1885485206836055,0.8334981846190793
4,17,4,25,0.19047619047619047,0.84,0.16062156042581816,0.8239036412314326
6,25,91,122,0.1935483870967742,0.2540983606557377,0.1678631667457655,0.7468013451837249
5,41,3,49,0.10869565217391304,0.9387755102040817,0.18339111705632452,0.7597000111436154
8,152,26,186,0.05,0.8602150537634409,0.19053397419918167,0.7601388963751273
24,108,3,135,0.18181818181818182,0.9777777777777777,0.18476196842717588,0.7829383191745501
25,112,7,144,0.18248175182481752,0.9513888888888888,0.17648262462072908,0.810822682286186
46,58,2,106,0.4423076923076923,0.9811320754716981,0.19276112224251027,0.8290553809659463
53,164,7,224,0.24423963133640553,0.96875,0.20044161379396955,0.8474482381088035
10,72,1,83,0.12195121951219512,0.9879518072289156,0.19021344699617254,0.9522844447621146
5,48,1,54,0.09433962264150944,0.9814814814814815,0.1881625856344006,0.9583852978017432
1,27,8,36,0.03571428571428571,0.7777777777777778,0.18612176930786997,0.9466085440895056
5,150,4,159,0.03225806451612903,0.9748427672955975,0.1647560382647196,0.9461892568777656
14,91,27,132,0.13333333333333333,0.7954545454545454,0.157734835623079,0.9239129221014307
33,68,24,125,0.32673267326732675,0.808,0.1412241186173125,0.8991797684626166
10,90,2,102,0.1,0.9803921568627451,0.12061845699782596,0.900842933728723
10,53,1,64,0.15873015873015872,0.984375,0.12587259117182076,0.9003319612674494
10,59,51,120,0.14492753623188406,0.575,0.13309943597044574,0.8422631781986665
12,34,1,47,0.2608695652173913,0.9787234042553191,0.1652644758994608,0.8709696962668866
22,74,1,97,0.22916666666666666,0.9896907216494846,0.19339427620668048,0.8730908326031562
3,22,4,29,0.12,0.8620689655172413,0.19148951430191857,0.8826071783263985
9,62,10,81,0.1267605633802817,0.8765432098765432,0.1629220700323407,0.8923990654516191
24,27,1,52,0.47058823529411764,0.9807692307692307,0.21586324650292893,0.8924529331525454
0,2,58,60,0.0,0.03333333333333333,0.1931875095414777,0.7565898379144503
9,162,9,180,0.05263157894736842,0.95,0.1800023727865469,0.8101612664858787
43,141,15,199,0.23369565217391305,0.9246231155778895,0.17612038520890713,0.8024326538176745
51,83,4,138,0.3805970149253731,0.9710144927536232,0.19775329210300804,0.7997646211182657
8,48,7,63,0.14285714285714285,0.8888888888888888,0.20101859822545703,0.8035960387427867
33,174,6,213,0.15942028985507245,0.971830985915493,0.20568427343614143,0.8172085781769224
0,11,54,65,0.0,0.16923076923076924,0.1384573826798389,0.7012745122428566
6,6,2,14,0.5,0.8571428571428571,0.20988595410841032,0.8189615870727884
30,41,5,76,0.4225352112676056,0.9342105263157895,0.2627293301541585,0.8167059479750443
1,60,3,64,0.01639344262295082,0.953125,0.2316861573611639,0.8207776457496314
49,60,33,142,0.44954128440366975,0.7676056338028169,0.2415353387152063,0.7917192373280876
25,71,410,506,0.2604166666666667,0.18972332015810275,0.2583295564022811,0.6918384417951183
1,43,9,53,0.022727272727272728,0.8301886792452831,0.23880198252688115,0.6716038265565167
21,60,20,101,0.25925925925925924,0.801980198019802,0.2758390195639182,0.7619966020978072
2,0,0,2,1.0,1.0,0.3472675909924896,0.7824047653631133
2,14,1,17,0.125,0.9411764705882353,0.3047625608114031,0.7833999002591769
16,74,4,94,0.17777777777777778,0.9574468085106383,0.3278174658335212,0.7840173014749825
40,78,23,141,0.3389830508474576,0.8368794326241135,0.31202343246834807,0.7939135584494534
28,31,4,63,0.4745762711864407,0.9365079365079365,0.34261766168545865,0.9005970750708583
14,13,2,29,0.5185185185185185,0.9310344827586207,0.41344498251277945,0.9150036184299066
8,13,1,22,0.38095238095238093,0.9545454545454546,0.4040123926548051,0.9394693087401137
40,59,16,115,0.40404040404040403,0.8608695652173913,0.31887530751772003,0.9195935323425982
20,74,2,96,0.2127659574468085,0.9791666666666666,0.33141330143869263,0.9250207032109454
0,1,0,1,0.0,1.0,0.3101968940836714,0.9304628800816938
35,71,3,109,0.330188679245283,0.9724770642201835,0.3191214860568446,0.9484357940179106
129,214,35,378,0.3760932944606414,0.9074074074074074,0.3074737968877837,0.9442785755749779
11,66,20,97,0.14285714285714285,0.7938144329896907,0.26384255128609474,0.9240400844352562
0,28,5,33,0.0,0.8484848484848485,0.2094207825786117,0.9088885692837411
0,12,2,14,0.0,0.8571428571428571,0.15170072485855401,0.9083561824159504
2,7,2,11,0.2222222222222222,0.8181818181818182,0.15305161982647025,0.8853583469181149
36,147,59,242,0.19672131147540983,0.756198347107438,0.18115466432295738,0.8505295393620347
46,88,23,157,0.34328358208955223,0.8535031847133758,0.18302536472928158,0.833533270861062
5,16,4,25,0.23809523809523808,0.84,0.1633113566770811,0.8239036412314326
5,23,94,122,0.17857142857142858,0.22950819672131148,0.16841339749340764,0.7432884646216641
5,34,10,49,0.1282051282051282,0.7959183673469388,0.18672841580842595,0.7357789673162483
10,150,26,186,0.0625,0.8602150537634409,0.19565698723699737,0.7362178525477603
24,109,3,136,0.18045112781954886,0.9779411764705882,0.18968968803661548,0.7590406180175846
26,111,7,144,0.1897810218978102,0.9513888888888888,0.18869821809695836,0.7869249811292204
45,59,2,106,0.4326923076923077,0.9811320754716981,0.20147089318306627,0.8051576798089809
53,164,7,224,0.24423963133640553,0.96875,0.20234866364609022,0.823550536951838
8,74,1,83,0.0975609756097561,0.9879518072289156,0.1907757417944227,0.93189962416721
4,44,5,53,0.08333333333333333,0.9056603773584906,0.1843654853841663,0.9475770541688602
2,26,8,36,0.07142857142857142,0.7777777777777778,0.18564099558824793,0.9358003004566227
5,150,4,159,0.03225806451612903,0.9748427672955975,0.16447055797347368,0.935357670574481
14,91,27,132,0.13333333333333333,0.7954545454545454,0.15640660246426272,0.9130813357981464
33,68,24,125,0.32673267326732675,0.808,0.14126951183212255,0.8883481821593323
8,92,2,102,0.08,0.9803921568627451,0.11780670735549321,0.8900113474254387
11,52,1,64,0.1746031746031746,0.984375,0.1288127357831244,0.8895003749641651
10,60,51,121,0.14285714285714285,0.5785123966942148,0.13731613714366864,0.8427649491549828
13,33,1,47,0.2826086956521739,0.9787234042553191,0.16748472631846897,0.871471467223203
22,74,1,97,0.22916666666666666,0.9896907216494846,0.19561452662568862,0.8735926035594727
3,22,4,29,0.12,0.8620689655172413,0.19370976472092674,0.8831089492827148
9,62,10,81,0.1267605633802817,0.8765432098765432,0.16514232045134888,0.8929008364079353
20,31,1,52,0.39215686274509803,0.9807692307692307,0.2097361579863629,0.8929547041088618
0,2,58,60,0.0,0.03333333333333333,0.18479284732876652,0.7570916088707665
9,162,9,180,0.05263157894736842,0.95,0.17190348105594158,0.8101612664858787
40,144,15,199,0.21739130434782608,0.9246231155778895,0.1625867108696062,0.8024326538176745
50,85,3,138,0.37037037037037035,0.9782608695652174,0.18275866854156386,0.8007998178056364
8,48,7,63,0.14285714285714285,0.8888888888888888,0.18602397466401285,0.8046312354301575
33,173,6,212,0.16019417475728157,0.9716981132075472,0.19080020486072713,0.8182247930488723
0,12,53,65,0.0,0.18461538461538463,0.13477779589714167,0.7044885293126085
6,6,2,14,0.5,0.8571428571428571,0.2062063673257131,0.8221756041425404
29,43,5,77,0.4027777777777778,0.935064935064935,0.2562272528729145,0.8200420234375312
1,60,3,64,0.01639344262295082,0.953125,0.22751327262650367,0.8241137212121185
51,59,33,143,0.4636363636363636,0.7692307692307693,0.24083698595021705,0.7942522783071972
20,75,412,507,0.21052631578947367,0.1873767258382643,0.2505040106548357,0.694036255014251
1,43,9,53,0.022727272727272728,0.8301886792452831,0.2308658817934059,0.6738206215910704
20,61,20,101,0.24691358024691357,0.801980198019802,0.26613925040010783,0.7620155949345585
2,0,0,2,1.0,1.0,0.3375678218286792,0.7824237581998646
2,14,1,17,0.125,0.9411764705882353,0.2978852821461396,0.7832968347031933
15,75,4,94,0.16666666666666666,0.9574468085106383,0.3193528855809561,0.7839142359189987
40,77,23,140,0.3418803418803419,0.8357142857142857,0.3019591681872387,0.7934118811309298
28,31,4,63,0.4745762711864407,0.9365079365079365,0.33968059038680537,0.9004306255123113
13,14,2,29,0.48148148148148145,0.9310344827586207,0.40521690592312093,0.9148371688713597
4,19,1,24,0.17391304347826086,0.9583333333333334,0.39120830626934205,0.9400104342812392
39,60,18,117,0.3939393939393939,0.8461538461538461,0.30462821968925546,0.9180324123032173
18,91,2,111,0.1651376146788991,0.9819819819819819,0.3103621646433839,0.9238617710737523
0,1,0,1,0.0,1.0,0.28914575728836267,0.9293039479445009
35,86,3,124,0.2892561983471074,0.9758064516129032,0.28772341442006416,0.9477524886511061
128,255,34,417,0.3342036553524804,0.9184652278177458,0.26767018358664124,0.9451749588382217
11,75,20,106,0.12790697674418605,0.8113207547169812,0.21205098322004717,0.9274373708023987
0,35,5,40,0.0,0.875,0.18720626272315277,0.9155326088976369
0,12,2,14,0.0,0.8571428571428571,0.13092920644609649,0.9171024676103526
4,10,2,16,0.2857142857142857,0.875,0.14815444516543744,0.9018193273272124
41,169,59,269,0.19523809523809524,0.7806691449814126,0.17604560162802246,0.8704863480388427
48,101,22,171,0.3221476510067114,0.8713450292397661,0.18074438057939446,0.8555632876998231
5,17,4,26,0.22727272727272727,0.8461538461538461,0.1654685337108583,0.8452330903192661
4,23,99,126,0.14814814814814814,0.21428571428571427,0.16836012962571,0.7599423702576564
7,36,10,53,0.16279069767441862,0.8113207547169812,0.1916159435791984,0.7508453352172252
10,169,27,206,0.055865921787709494,0.8689320388349514,0.1995967895488712,0.7525295040303815
24,142,3,169,0.14457831325301204,0.9822485207100592,0.17943450776868924,0.7678507212746757
24,119,7,150,0.16783216783216784,0.9533333333333334,0.1755193752821282,0.7925170338963786
49,66,2,117,0.4260869565217391,0.9829059829059829,0.1903678474985607,0.8084543129915526
53,164,7,224,0.24423963133640553,0.96875,0.19279169093622903,0.8259680492552887
14,87,1,102,0.13861386138613863,0.9901960784313726,0.19142964997022768,0.9368123869903827
3,52,5,60,0.05454545454545454,0.9166666666666666,0.17596604380894706,0.951861802983195
2,28,9,39,0.06666666666666667,0.7692307692307693,0.17750900736308384,0.9376187644683119
5,155,4,164,0.03125,0.975609756097561,0.16131924832693925,0.9366703695236692
15,99,26,140,0.13157894736842105,0.8142857142857143,0.15614021683211826,0.916806423945438
34,82,25,141,0.29310344827586204,0.8226950354609929,0.137142572796993,0.8939191457390108
13,94,2,109,0.12149532710280374,0.981651376146789,0.11960767219219273,0.8957621994742665
9,55,2,66,0.140625,0.9696969696969697,0.11989497770845865,0.8928337553693517
9,112,12,133,0.0743801652892562,0.9097744360902256,0.12272850781471602,0.8918491510012887
12,37,1,50,0.24489795918367346,0.98,0.14819012103143128,0.9219590411111788
20,79,1,100,0.20202020202020202,0.99,0.17258586417717442,0.9240147902400987
4,22,4,30,0.15384615384615385,0.8666666666666667,0.1757668936739934,0.9314977834373775
8,78,10,96,0.09302325581395349,0.8958333333333334,0.14718400903657788,0.9419461117048549
18,36,2,56,0.3333333333333333,0.9642857142857143,0.17744658135522498,0.9394653028675585
0,4,58,62,0.0,0.06451612903225806,0.15735729564093925,0.8101537542011711
8,192,9,209,0.04,0.9569377990430622,0.1524458434567598,0.8168913774801476
40,181,14,235,0.18099547511312217,0.9404255319148936,0.14331691716096676,0.8112378820394183
41,94,16,151,0.3037037037037037,0.8940397350993378,0.15784313168718128,0.797529272767895
8,50,7,65,0.13793103448275862,0.8923076923076924,0.15556954320669622,0.8011922764308987
35,187,6,228,0.15765765765765766,0.9736842105263158,0.1648030291843683,0.8123138303156104
0,10,55,65,0.0,0.15384615384615385,0.11718398156532064,0.6965367502528161
6,7,2,15,0.46153846153846156,0.8666666666666667,0.1831180474993866,0.8111296842005887
32,51,5,88,0.3855421686746988,0.9431818181818182,0.23248121445291497,0.8091645440775539
1,61,3,65,0.016129032258064516,0.9538461538461539,0.20892886547362102,0.8110817757820197
49,63,33,145,0.4375,0.7724137931034483,0.22804262208737766,0.7937066412111784
13,113,470,596,0.10317460317460317,0.21140939597315436,0.22307741761478403,0.69643545602053
1,49,9,59,0.02,0.847457627118644,0.20341203794940438,0.6784030869622912
23,64,20,107,0.26436781609195403,0.8130841121495327,0.2411788688196835,0.7725799381484881
2,0,0,2,1.0,1.0,0.31810194574276046,0.7916275571961072
2,14,1,17,0.125,0.9411764705882353,0.2808816359320892,0.7913410789684525
15,86,4,105,0.1485148514851485,0.9619047619047619,0.2997938958216726,0.7924923086911109
34,93,23,150,0.2677165354330709,0.8466666666666667,0.27553911516925417,0.8030998620572849
27,32,4,63,0.4576271186440678,0.9365079365079365,0.3261751888077491,0.9066853678479679
13,16,2,31,0.4482758620689655,0.9354838709677419,0.38735745481760137,0.9192605455406964
4,19,1,24,0.17391304347826086,0.9583333333333334,0.3705312512425036,0.9386498900635523
40,60,17,117,0.4,0.8547008547008547,0.2848169655282179,0.9178928693065312
23,86,2,111,0.21100917431192662,0.9819819819819819,0.30603256185849315,0.9237222280770666
0,1,0,1,0.0,1.0,0.28031827614420746,0.930524949165502
36,85,3,124,0.2975206611570248,0.9758064516129032,0.27670199264245504,0.9489734898721072
128,254,35,417,0.33507853403141363,0.9160671462829736,0.26161635948955775,0.9460533769828269
11,75,20,106,0.12790697674418605,0.8113207547169812,0.22077548424611634,0.9283157889470038
0,35,5,40,0.0,0.875,0.19593076374922194,0.916411027042242
0,12,2,14,0.0,0.8571428571428571,0.1387879066063648,0.9167598845339567
4,10,2,16,0.2857142857142857,0.875,0.1494600653781304,0.9014767442508163
36,174,59,269,0.17142857142857143,0.7806691449814126,0.17394986129649773,0.8701437649624467
45,104,22,171,0.30201342281879195,0.8713450292397661,0.17459168439103587,0.8552207046234271
5,17,4,26,0.22727272727272727,0.8461538461538461,0.15919085485408072,0.845233090319266
5,25,96,126,0.16666666666666666,0.23809523809523808,0.16472795341443505,0.7633437308018741
7,36,10,53,0.16279069767441862,0.8113207547169812,0.18798376736792344,0.754246695761443
13,166,27,206,0.07262569832402235,0.8689320388349514,0.19835886712849807,0.7559308645745993
24,142,3,169,0.14457831325301204,0.9822485207100592,0.1781965853483161,0.7712520818188934
24,119,7,150,0.16783216783216784,0.9533333333333334,0.17768281340597275,0.7959183944405963
51,64,2,117,0.4434782608695652,0.9829059829059829,0.1978920759846546,0.8118556735357702
53,164,7,224,0.24423963133640553,0.96875,0.20031591942232294,0.8293694097995065
14,87,1,102,0.13861386138613863,0.9901960784313726,0.19630837581081897,0.9368123869903828
5,50,5,60,0.09090909090909091,0.9166666666666666,0.18603957484434355,0.951861802983195
2,28,9,39,0.06666666666666667,0.7692307692307693,0.18518828460757847,0.9376187644683119
5,155,4,164,0.03125,0.975609756097561,0.16899852557143388,0.9366703695236692
15,99,26,140,0.13157894736842105,0.8142857142857143,0.1638194940766129,0.916806423945438
34,81,26,141,0.2956521739130435,0.8156028368794326,0.14270148165425267,0.8929059745130736
12,95,2,109,0.11214953271028037,0.981651376146789,0.12383146756480623,0.8947490282483291
10,54,2,66,0.15625,0.9696969696969697,0.12635091593821499,0.8918205841434145
10,111,12,133,0.08264462809917356,0.9097744360902256,0.12517027839394107,0.8908359797753516
10,39,1,50,0.20408163265306123,0.98,0.14480098782056888,0.9209458698852416
20,79,1,100,0.20202020202020202,0.99,0.16919673096631202,0.9230016190141613
4,22,4,30,0.15384615384615385,0.8666666666666667,0.172377760463131,0.9304846122114404
7,78,11,96,0.08235294117647059,0.8854166666666666,0.14190644150076343,0.9404580164667594
18,36,2,56,0.3333333333333333,0.9642857142857143,0.1735041273040567,0.9379772076294631
0,4,58,62,0.0,0.06451612903225806,0.15118269873262813,0.8086656589630757
9,191,9,209,0.045,0.9569377990430622,0.1458048947184605,0.8154032822420525
41,180,14,235,0.18552036199095023,0.9404255319148936,0.14315328462387322,0.809749786801323
40,96,15,151,0.29411764705882354,0.9006622516556292,0.15631006248653342,0.7969872513235556
7,51,7,65,0.1206896551724138,0.8923076923076924,0.15157341981885628,0.8006502549865593
32,190,6,228,0.14414414414414414,0.9736842105263158,0.16040073452852394,0.8132599041093664
0,7,58,65,0.0,0.1076923076923077,0.1127816869094763,0.6908894174531655
6,7,2,15,0.46153846153846156,0.8666666666666667,0.17871575284354227,0.8054823514009382
31,52,5,88,0.37349397590361444,0.9431818181818182,0.22564346368691574,0.8035172112779032
1,61,3,65,0.016129032258064516,0.9538461538461539,0.20144470229650352,0.805434442982369
50,62,33,145,0.44642857142857145,0.7724137931034483,0.22320340577789605,0.7871132346177718
18,107,471,596,0.144,0.20973154362416108,0.2265334550389798,0.6896023562344101
1,49,9,59,0.02,0.847457627118644,0.20879857730410206,0.6715699871761712
23,64,20,107,0.26436781609195403,0.8130841121495327,0.2465654081743812,0.7723402449557749
2,0,0,2,1.0,1.0,0.3234884850974581,0.7913878640033939
2,14,1,17,0.125,0.9411764705882353,0.28798934568265605,0.7911013857757391
15,86,4,105,0.1485148514851485,0.9619047619047619,0.30690160557223944,0.7922526154983974
38,89,23,150,0.2992125984251969,0.8466666666666667,0.28587075228604314,0.8028601688645715
28,31,4,63,0.4745762711864407,0.9365079365079365,0.3330959338841061,0.9066853678479679
15,14,2,31,0.5172413793103449,0.9354838709677419,0.40413041664272675,0.9192605455406964
6,17,1,24,0.2608695652173913,0.9583333333333334,0.37153520828287734,0.9413709784989264
40,60,17,117,0.4,0.8547008547008547,0.28582092256859154,0.9206139577419056
24,85,2,111,0.22018348623853212,0.9819819819819819,0.30834713488838184,0.9264433165124408
0,1,0,1,0.0,1.0,0.28453761107885805,0.930524949165502
37,84,3,124,0.30578512396694213,0.9758064516129032,0.2843516839065315,0.9489734898721072
132,250,35,417,0.34554973821989526,0.9160671462829736,0.27802585958443415,0.9460533769828269
12,74,20,106,0.13953488372093023,0.8113207547169812,0.2388461139090991,0.9283157889470038
0,35,5,40,0.0,0.875,0.20157903316375747,0.916411027042242
0,12,2,14,0.0,0.8571428571428571,0.14443617602090034,0.9167598845339567
3,11,2,16,0.21428571428571427,0.875,0.14359363717049778,0.9014767442508163
38,172,59,269,0.18095238095238095,0.7806691449814126,0.1694439773065522,0.8701437649624467
45,104,23,172,0.30201342281879195,0.8662790697674418,0.16890516285681642,0.8544969961273808
5,17,4,26,0.22727272727272727,0.8461538461538461,0.15200844700722102,0.8445093818232197
6,27,93,126,0.18181818181818182,0.2619047619047619,0.15804891816397126,0.7660213828500455
8,35,10,53,0.18604651162790697,0.8113207547169812,0.18462699125367224,0.7569243478096143
8,171,27,206,0.0446927374301676,0.8689320388349514,0.19101166802941047,0.7586085166227706
27,139,3,169,0.16265060240963855,0.9822485207100592,0.18363522347568537,0.7739297338670647
24,119,7,150,0.16783216783216784,0.9533333333333334,0.18176090731565495,0.7985960464887677
50,64,3,117,0.43859649122807015,0.9743589743589743,0.2012727742312661,0.8140360328589866
54,163,7,224,0.2488479262672811,0.96875,0.20435494551620237,0.8315497691227229
13,88,1,102,0.12871287128712872,0.9901960784313726,0.19676847258319477,0.9355913857693816
5,50,5,60,0.09090909090909091,0.9166666666666666,0.18317741248050678,0.9506408017621938
2,28,9,39,0.06666666666666667,0.7692307692307693,0.18631654522857807,0.9363977632473105
5,155,4,164,0.03125,0.975609756097561,0.1675450305986297,0.9354493683026679
14,99,27,140,0.12389380530973451,0.8071428571428572,0.1612681216668535,0.9145650145611715
37,80,24,141,0.3162393162393162,0.8297872340425532,0.14378852523988866,0.8939119088016827
13,94,2,109,0.12149532710280374,0.981651376146789,0.12559529678782047,0.8957549625369382
11,54,1,66,0.16923076923076924,0.9848484848484849,0.13138356792262626,0.8949910205965257
11,110,12,133,0.09090909090909091,0.9097744360902256,0.13138356792262626,0.8940064162284627
12,37,1,50,0.24489795918367346,0.98,0.1568451811393415,0.9241163063383528
22,77,1,100,0.2222222222222222,0.99,0.18412692717108753,0.9261720554672728
3,23,4,30,0.11538461538461539,0.8666666666666667,0.18291132861035625,0.9346754568278168
8,77,11,96,0.09411764705882353,0.8854166666666666,0.15117966158457158,0.9426225186312617
20,35,1,56,0.36363636363636365,0.9821428571428571,0.185771238232223,0.9426927302021285
0,4,58,62,0.0,0.06451612903225806,0.16159541405639882,0.811216679371239
10,190,9,209,0.05,0.9569377990430622,0.15575125821224298,0.8179543026502157
41,178,16,235,0.1872146118721461,0.9319148936170213,0.1475107800248819,0.8110850017383616
50,98,3,151,0.33783783783783783,0.9801324503311258,0.16402729654139844,0.8096753517856652
6,52,7,65,0.10344827586206896,0.8923076923076924,0.16232210518103465,0.813338355448669
35,187,6,228,0.15765765765765766,0.9736842105263158,0.17139924955229668,0.825948004571476
0,11,54,65,0.0,0.16923076923076924,0.11945119760424472,0.7098177062983205
6,7,2,15,0.46153846153846156,0.8666666666666667,0.18538526353831067,0.8244106402460932
32,51,5,88,0.3855421686746988,0.9431818181818182,0.23331985906326763,0.8224455001230584
1,61,3,65,0.016129032258064516,0.9538461538461539,0.20887906197554168,0.8255785372986487
50,62,33,145,0.44642857142857145,0.7724137931034483,0.22439202391707508,0.7959044434089806
17,107,472,596,0.13709677419354838,0.2080536912751678,0.22919895225014358,0.6981538718329056
1,49,9,59,0.02,0.847457627118644,0.20953357258476388,0.6801215027746668
21,66,20,107,0.2413793103448276,0.8130841121495327,0.24401633120545352,0.7721005517630617
2,0,0,2,1.0,1.0,0.32093940812853045,0.7911481708106807
1,15,1,17,0.0625,0.9411764705882353,0.2747905268892878,0.7908616925830259
18,82,5,105,0.18,0.9523809523809523,0.2982006651381357,0.790652378087997
41,86,23,150,0.3228346456692913,0.8466666666666667,0.2805443900296671,0.8012599314541712
26,33,4,63,0.4406779661016949,0.9365079365079365,0.3239131317308309,0.905324823630281
12,17,2,31,0.41379310344827586,0.9354838709677419,0.3801692893662989,0.9179000013230093
6,17,1,24,0.2608695652173913,0.9583333333333334,0.3604174861547315,0.9427315227166134
41,60,16,117,0.40594059405940597,0.8632478632478633,0.2755518567346466,0.9231955031805938
21,88,2,111,0.1926605504587156,0.9819819819819819,0.2941462210858917,0.9290248619511291
0,1,0,1,0.0,1.0,0.269180895149692,0.9317459503865033
33,88,3,124,0.2727272727272727,0.9758064516129032,0.2642724178002697,0.9501944910931085
130,252,35,417,0.3403141361256545,0.9160671462829736,0.25961995782790565,0.9472743782038281
11,75,20,106,0.12790697674418605,0.8113207547169812,0.22863129933323267,0.9295367901680052
0,35,5,40,0.0,0.875,0.19136421858789107,0.9176320282632433
0,12,2,14,0.0,0.8571428571428571,0.13337270515083308,0.9167598845339565
4,10,2,16,0.2857142857142857,0.875,0.1466660959016288,0.9014767442508164
44,166,59,269,0.20952380952380953,0.7806691449814126,0.17659806869074446,0.8701437649624466
47,102,23,172,0.31543624161073824,0.8662790697674418,0.18269934995981094,0.8544969961273807
4,18,4,26,0.18181818181818182,0.8461538461538461,0.16005707077302914,0.8445093818232198
5,27,94,126,0.15625,0.25396825396825395,0.16410607409528827,0.764887596001973
7,36,10,53,0.16279069767441862,0.8113207547169812,0.18736188804877665,0.7557905609615416
11,168,27,206,0.061452513966480445,0.8689320388349514,0.1961408186154167,0.757474729774698
27,139,3,169,0.16265060240963855,0.9822485207100592,0.17856029242903856,0.7727959470189922
26,117,7,150,0.18181818181818182,0.9533333333333334,0.17460234561394888,0.7974622596406952
45,70,2,117,0.391304347826087,0.9829059829059829,0.18544064650185585,0.8141232472319153
67,150,7,224,0.3087557603686636,0.96875,0.2035745862947818,0.8316369834956515
13,88,1,102,0.12871287128712872,0.9901960784313726,0.19964071076437162,0.9368123869903828
5,50,5,60,0.09090909090909091,0.9166666666666666,0.18937190979789623,0.951861802983195
2,28,9,39,0.06666666666666667,0.7692307692307693,0.19011678875506569,0.9376187644683119
5,155,4,164,0.03125,0.975609756097561,0.17134527412511733,0.9366703695236692
14,99,27,140,0.12389380530973451,0.8071428571428572,0.16307036319533916,0.9157860157821727
37,80,24,141,0.3162393162393162,0.8297872340425532,0.15234678725437187,0.8939119088016827
12,95,2,109,0.11214953271028037,0.981651376146789,0.1242601833031743,0.8957549625369383
9,56,1,66,0.13846153846153847,0.9848484848484849,0.1256528500423757,0.8949910205965257
10,111,12,133,0.08264462809917356,0.9097744360902256,0.12447221249810178,0.8940064162284627
12,37,1,50,0.24489795918367346,0.98,0.14993382571481703,0.9241163063383527
22,77,1,100,0.2222222222222222,0.99,0.17721557174656308,0.9261720554672727
4,22,4,30,0.15384615384615385,0.8666666666666667,0.18149447868033725,0.9346754568278169
9,76,11,96,0.10588235294117647,0.8854166666666666,0.15144348392346016,0.9426225186312617
21,34,1,56,0.38181818181818183,0.9821428571428571,0.18996757665316036,0.9426927302021285
0,4,58,62,0.0,0.06451612903225806,0.1701873568729406,0.8112166793712391
8,192,9,209,0.04,0.9569377990430622,0.16409526714448722,0.8179543026502156
31,188,16,235,0.1415525114155251,0.9319148936170213,0.14933163174903746,0.8110850017383616
48,100,3,151,0.32432432432432434,0.9801324503311258,0.16391764633505204,0.8096753517856653
8,50,7,65,0.13793103448275862,0.8923076923076924,0.161644057854567,0.8133383554486688
37,185,6,228,0.16666666666666666,0.9736842105263158,0.17032753124392275,0.825948004571476
0,12,53,65,0.0,0.18461538461538463,0.1157820766984682,0.7120155084961227
6,7,2,15,0.46153846153846156,0.8666666666666667,0.18171614263253413,0.8266084424438953
30,53,5,88,0.3614457831325301,0.9431818181818182,0.22763696879432413,0.8246433023208606
2,60,3,65,0.03225806451612903,0.9538461538461539,0.2120234763801247,0.8277763394964509
49,63,33,145,0.4375,0.7724137931034483,0.22819143004807835,0.7981022456067828
20,105,471,596,0.16,0.20973154362416108,0.2313441394076843,0.7005913672234211
1,49,9,59,0.02,0.847457627118644,0.21039175845530336,0.6825589981651824
21,66,20,107,0.2413793103448276,0.8130841121495327,0.244874517075993,0.7723402449557748
2,0,0,2,1.0,1.0,0.32179759399906993,0.7913878640033938
1,15,1,17,0.0625,0.9411764705882353,0.2790910535515656,0.7911013857757393
17,85,3,105,0.16666666666666666,0.9714285714285714,0.2982922824302139,0.7936131597160846
39,88,23,150,0.30708661417322836,0.8466666666666667,0.27966179874067504,0.8042207130822586
23,36,4,63,0.3898305084745763,0.9365079365079365,0.31249472852275734,0.9080459120656552
12,17,2,31,0.41379310344827586,0.9354838709677419,0.3687508861582253,0.9206210897583834
7,16,1,24,0.30434782608695654,0.9583333333333334,0.3841366830036694,0.9403792942953654
40,63,14,117,0.3883495145631068,0.8803418803418803,0.2967580422269704,0.9232852772013482
22,87,2,111,0.2018348623853211,0.9819819819819819,0.3166630225677305,0.9291146359718835
0,1,0,1,0.0,1.0,0.2840543269155566,0.932154149649695
36,85,3,124,0.2975206611570248,0.9758064516129032,0.2817630896474318,0.9520008666480937
133,249,34,416,0.3481675392670157,0.9182692307692307,0.2782325444095478,0.9493953372568499
11,75,20,106,0.12790697674418605,0.8113207547169812,0.23830391145765908,0.9322933761080442
0,35,5,40,0.0,0.875,0.19482565058809387,0.9203886142032823
0,13,1,14,0.0,0.9285714285714286,0.13934714850765004,0.9272785496646464
4,11,1,16,0.26666666666666666,0.9375,0.14860883483355655,0.9209239808100776
47,163,59,269,0.22380952380952382,0.7806691449814126,0.18058162394920282,0.889591001521708
46,103,23,172,0.3087248322147651,0.8662790697674418,0.1821822198145943,0.8739442326866421
7,19,0,26,0.2692307692307692,1.0,0.1709055383808448,0.8856200568624663
7,48,71,126,0.12727272727272726,0.4365079365079365,0.1708149313134935,0.8320753685468885
8,42,3,53,0.16,0.9433962264150944,0.1936720741706364,0.841846258034759
13,166,27,206,0.07262569832402235,0.8689320388349514,0.20404717393121102,0.8333263452152622
28,138,3,169,0.1686746987951807,0.9822485207100592,0.19004832137814162,0.8397189910309849
27,116,7,150,0.1888111888111888,0.9533333333333334,0.1850485592355223,0.864385303652688
50,65,2,117,0.43478260869565216,0.9829059829059829,0.20305681301850617,0.881046291243908
67,150,7,224,0.3087557603686636,0.96875,0.20870324032391968,0.8765820055296223
13,88,1,102,0.12871287128712872,0.9901960784313726,0.20890897518311985,0.9556803115186846
3,56,1,60,0.05084745762711865,0.9833333333333333,0.19331575484413682,0.9613856125070045
2,28,9,39,0.06666666666666667,0.7692307692307693,0.1924644646073717,0.9471425739921214
5,155,4,164,0.03125,0.975609756097561,0.17283236477948874,0.9461941790474787
15,100,25,140,0.13043478260869565,0.8214285714285714,0.16449287817913258,0.9273506416325129
37,78,26,141,0.3217391304347826,0.8156028368794326,0.1483438098561512,0.9034501922001485
12,95,2,109,0.11214953271028037,0.981651376146789,0.1202572059049536,0.9052932459354041
10,55,1,66,0.15384615384615385,0.9848484848484849,0.12384767484195722,0.9045293039949917
13,68,51,132,0.16049382716049382,0.6136363636363636,0.13951144191815365,0.8517154511811388
12,37,1,50,0.24489795918367346,0.98,0.16497305513486893,0.8818253412910287
23,76,1,100,0.23232323232323232,0.99,0.1936978026096164,0.8838810904199487
4,22,4,30,0.15384615384615385,0.8666666666666667,0.19704228421496753,0.8903436754539623
11,79,6,96,0.12222222222222222,0.9375,0.16853986875603036,0.9077575558997576
21,34,1,56,0.38181818181818183,0.9821428571428571,0.20706396148573056,0.9078277674706244
0,4,58,62,0.0,0.06451612903225806,0.1850859395077086,0.776351716639735
9,191,9,209,0.045,0.9569377990430622,0.16858682134192376,0.8253947788406918
33,188,14,235,0.1493212669683258,0.9404255319148936,0.15493300816830266,0.8197412833999624
48,99,4,151,0.32653061224489793,0.9735099337748344,0.1683912052999692,0.8173855596535101
8,50,7,65,0.13793103448275862,0.8923076923076924,0.16611761681948417,0.8210485633165138
36,186,6,228,0.16216216216216217,0.9736842105263158,0.1718233225251899,0.8262177362488446
7,57,1,65,0.109375,0.9846153846153847,0.1329028679797353,0.8265709544592058
6,7,2,15,0.46153846153846156,0.8666666666666667,0.19883693391380125,0.9411638884069785
31,52,5,88,0.37349397590361444,0.9431818181818182,0.24576464475717477,0.9391987482839435
1,61,3,65,0.016129032258064516,0.9538461538461539,0.22673718265570883,0.9411159799884093
52,64,28,144,0.4482758620689655,0.8055555555555556,0.2441293612020042,0.9171224973856551
20,106,470,596,0.15873015873015872,0.21140939597315436,0.24710066466591848,0.8198513121950068
1,49,9,59,0.02,0.847457627118644,0.2267917843570382,0.801818943136768
21,66,20,107,0.2413793103448276,0.8130841121495327,0.24564954297772787,0.7773144756416464
2,0,0,2,1.0,1.0,0.3225726199008048,0.7963620946892654
1,15,1,17,0.0625,0.9411764705882353,0.2781449090574313,0.7960756164616107
18,85,2,105,0.17475728155339806,0.9809523809523809,0.3008060875281932,0.7999479346196432
39,88,23,150,0.30708661417322836,0.8466666666666667,0.2806361949716593,0.8058209504926591
22,37,4,63,0.3728813559322034,0.9365079365079365,0.31122922314338003,0.9094064562833423
10,19,2,31,0.3448275862068966,0.9354838709677419,0.35763316403007955,0.9219816339760705
8,13,1,22,0.38095238095238093,0.9545454545454546,0.3943959082855287,0.9406921273589584
41,59,15,115,0.41,0.8695652173913043,0.3101101939998143,0.9220585869862875
18,76,2,96,0.19148936170212766,0.9791666666666666,0.32853724567154685,0.9274857578546348
0,1,0,1,0.0,1.0,0.29903414008148477,0.9305252715324464
35,70,3,108,0.3333333333333333,0.9722222222222222,0.2970163838264403,0.9490059971560292
127,215,35,377,0.3713450292397661,0.9071618037135278,0.2992182160907169,0.9448136924711136
12,65,20,97,0.15584415584415584,0.7938144329896907,0.26328060872453807,0.9252108282184094
0,28,5,33,0.0,0.8484848484848485,0.20885884001705507,0.9100593130668942
0,12,2,14,0.0,0.8571428571428571,0.15028741144562652,0.9082846901742588
2,7,2,11,0.2222222222222222,0.8181818181818182,0.1546778200913543,0.8852868546764234
40,142,59,241,0.21978021978021978,0.7551867219917012,0.1860749943456714,0.8503135292466665
44,90,24,158,0.3283582089552239,0.8481012658227848,0.18536426229165578,0.8325819640467468
4,17,4,25,0.19047619047619047,0.84,0.1595258567540021,0.8229874206590999
5,25,92,122,0.16666666666666666,0.2459016393442623,0.1610719297286465,0.7447141644240387
4,35,10,49,0.10256410256410256,0.7959183673469388,0.17572394438066116,0.737204667118623
14,147,26,187,0.08695652173913043,0.8609625668449198,0.18814630462910836,0.7377503399332035
24,108,3,135,0.18181818181818182,0.9777777777777777,0.1823742988571026,0.7605497627326263
25,112,7,144,0.18248175182481752,0.9513888888888888,0.17704594629204515,0.7885786437179387
47,57,2,106,0.4519230769230769,0.9811320754716981,0.19469807028745273,0.8075830450963549
67,150,7,224,0.3087557603686636,0.96875,0.21159515170066315,0.825975902239212
7,75,1,83,0.08536585365853659,0.9879518072289156,0.1999807498423589,0.9319830690798768
4,44,5,53,0.08333333333333333,0.9056603773584906,0.19723349709510613,0.9476604990815272
1,27,8,36,0.03571428571428571,0.7777777777777778,0.18991317766298546,0.935776957786221
6,149,4,159,0.03870967741935484,0.9748427672955975,0.16946910560601017,0.9353576705744812
15,90,26,131,0.14285714285714285,0.8015267175572519,0.16380844718205664,0.9139487889556758
33,67,25,125,0.33,0.8,0.14639086476447424,0.8880727781740047
10,90,2,102,0.1,0.9803921568627451,0.11656861328323657,0.8897359434401111
8,55,1,64,0.12698412698412698,0.984375,0.12251408090117806,0.8892249709788375
12,96,12,120,0.1111111111111111,0.9,0.12648233486943203,0.8884163456419102
11,35,1,47,0.2391304347826087,0.9787234042553191,0.15554178473633531,0.9171228637101303
23,74,0,97,0.23711340206185566,1.0,0.1838851739709783,0.9207167540964736
6,19,4,29,0.24,0.8620689655172413,0.19776272499138645,0.9293656466621864
8,62,11,81,0.11428571428571428,0.8641975308641975,0.16694639846077422,0.9385367224999289
19,32,1,52,0.37254901960784315,0.9807692307692307,0.2058819726904661,0.9385905902008554
0,2,58,60,0.0,0.03333333333333333,0.1877413831213051,0.8027274949627602
7,164,9,180,0.04093567251461988,0.95,0.17771632046466346,0.8098703521056173
32,152,14,198,0.17391304347826086,0.9292929292929293,0.16839955027832806,0.8028088556824188
50,85,3,138,0.37037037037037035,0.9782608695652174,0.18743626003668729,0.799703265620307
8,48,7,63,0.14285714285714285,0.8888888888888888,0.17355870901627915,0.803534683244828
29,177,6,212,0.1407766990291262,0.9716981132075472,0.17734313540819513,0.818891909293878
0,11,54,65,0.0,0.16923076923076924,0.12412184689278896,0.702957843359812
6,6,2,14,0.5,0.8571428571428571,0.1955504183213604,0.820644918189744
30,41,5,76,0.4225352112676056,0.9342105263157895,0.2500646381432155,0.8183892790919997
1,60,3,64,0.01639344262295082,0.953125,0.22756183802102833,0.8217938606215812
48,61,33,142,0.44036697247706424,0.7676056338028169,0.2375613526076989,0.7917002555126668
17,77,412,506,0.18085106382978725,0.1857707509881423,0.24298905560379097,0.6912548072411316
2,42,9,53,0.045454545454545456,0.8301886792452831,0.22937160509313656,0.671039173817951
21,60,20,101,0.25925925925925924,0.801980198019802,0.2664086421301736,0.7614319493592413
2,0,0,2,1.0,1.0,0.337837213558745,0.7818401126245477
1,15,1,17,0.0625,0.9411764705882353,0.2864036119490871,0.7828352475206113
21,71,2,94,0.22826086956521738,0.9787234042553191,0.3166703872265538,0.7864921624142284
37,81,23,141,0.3135593220338983,0.8368794326241135,0.2985550085918157,0.7963884193886992
22,37,4,63,0.3728813559322034,0.9365079365079365,0.3259879074635895,0.9036365887486698
11,16,2,29,0.4074074074074074,0.9310344827586207,0.3776954591711412,0.9180431321077182
6,15,1,22,0.2857142857142857,0.9545454545454546,0.38116165588760836,0.940285635270726
40,58,17,115,0.40816326530612246,0.8521739130434782,0.2966135509313402,0.9191676228483657
18,76,2,96,0.19148936170212766,0.9791666666666666,0.30611203117450125,0.9245947937167129
0,1,0,1,0.0,1.0,0.27837278013427935,0.9273158821520872
33,73,3,109,0.3113207547169811,0.9724770642201835,0.2759900308081337,0.9471935579930657
126,214,36,376,0.37058823529411766,0.9042553191489362,0.2780837496516034,0.9425860412274943
11,66,20,97,0.14285714285714285,0.7938144329896907,0.24430472079868285,0.9223475500877727
0,28,5,33,0.0,0.8484848484848485,0.2034883942680706,0.9071960349362576
0,12,2,14,0.0,0.8571428571428571,0.14517935636719598,0.9079058840933116
2,7,2,11,0.2222222222222222,0.8181818181818182,0.1495697650129238,0.8849080485954762
38,144,59,241,0.2087912087912088,0.7551867219917012,0.17939708055452505,0.8499347231657193
44,90,24,158,0.3283582089552239,0.8481012658227848,0.1818310025885597,0.8321667519660909
5,16,4,25,0.23809523809523808,0.84,0.16290343156014833,0.8229874206590999
4,24,94,122,0.14285714285714285,0.22950819672131148,0.16290343156014833,0.7423722440493314
4,35,10,49,0.10256410256410256,0.7959183673469388,0.177555446212163,0.7348627467439158
12,149,26,187,0.07453416149068323,0.8609625668449198,0.1882031835679749,0.7354084195584962
23,108,3,134,0.17557251908396945,0.9776119402985075,0.18153894026251022,0.7581841512894518
24,113,7,144,0.17518248175182483,0.9513888888888888,0.17673769354259822,0.7862130322747644
43,62,2,107,0.4095238095238095,0.9813084112149533,0.18833277933811043,0.8052426244736456
66,151,7,224,0.30414746543778803,0.96875,0.1977688118156176,0.8236354816165027
8,74,1,83,0.0975609756097561,0.9879518072289156,0.19129793078027663,0.9319845688318747
3,50,1,54,0.05660377358490566,0.9814814814814815,0.18473216949753418,0.9584935851368094
2,26,8,36,0.07142857142857142,0.7777777777777778,0.18428851377437536,0.9466100438415034
5,150,4,159,0.03225806451612903,0.9748427672955975,0.1638150202646839,0.9462144476982306
15,90,26,131,0.14285714285714285,0.8015267175572519,0.15919711470830075,0.9248055660794252
32,68,24,124,0.32,0.8064516129032258,0.14640799906204224,0.8998260234634642
14,86,2,102,0.14,0.9803921568627451,0.12295836114235825,0.9014891887295706
8,55,1,64,0.12698412698412698,0.984375,0.1271616684815541,0.900978216268297
12,97,12,121,0.11009174311926606,0.9008264462809917,0.13480280698646271,0.8894560683825127
12,34,1,47,0.2608695652173913,0.9787234042553191,0.16186580609915127,0.9181625864507329
21,75,1,97,0.21875,0.9896907216494846,0.1885075111682757,0.9202837227870024
6,19,4,29,0.24,0.8620689655172413,0.20238506218868385,0.9289326153527152
7,61,13,81,0.10294117647058823,0.8395061728395061,0.17137665882733932,0.9336546953436125
19,32,1,52,0.37254901960784315,0.9807692307692307,0.20459794734274547,0.933708563044539
0,2,58,60,0.0,0.03333333333333333,0.18645735777358446,0.7978454678064437
8,164,9,181,0.046511627906976744,0.9502762430939227,0.1773744841718289,0.8049097244940053
29,154,15,198,0.15846994535519127,0.9242424242424242,0.16274596704865746,0.797126727349306
50,86,2,138,0.36764705882352944,0.9855072463768116,0.1840169754520188,0.7965290880246385
9,47,7,63,0.16071428571428573,0.8888888888888888,0.17269044483977392,0.8003605056491595
32,175,6,213,0.15458937198067632,0.971830985915493,0.1800687584840722,0.8192640503743005
0,12,53,65,0.0,0.18461538461538463,0.12684746996866603,0.7055277866380367
6,6,2,14,0.5,0.8571428571428571,0.19827604139723748,0.8232148614679687
31,40,5,76,0.43661971830985913,0.9342105263157895,0.25400576859764923,0.8209197590710925
1,60,3,64,0.01639344262295082,0.953125,0.23370912535018631,0.8250458413221747
47,62,33,142,0.43119266055045874,0.7676056338028169,0.24278706845403336,0.7939170395258898
16,83,410,509,0.16161616161616163,0.1944990176817289,0.24291590786858702,0.6947184864962956
2,42,9,53,0.045454545454545456,0.8301886792452831,0.22732521836485406,0.6744838712576942
22,59,20,101,0.2716049382716049,0.801980198019802,0.2661259238322262,0.7626788446011823
2,0,0,2,1.0,1.0,0.3375544952607976,0.7830870078664885
1,15,1,17,0.0625,0.9411764705882353,0.284108821216532,0.7840821427625523
19,73,2,94,0.20652173913043478,0.9787234042553191,0.3112700064318869,0.7877390576561693
41,77,22,140,0.3474576271186441,0.8428571428571429,0.29930785879877053,0.7984892732353587
21,38,4,63,0.3559322033898305,0.9365079365079365,0.32706729333786605,0.9044905473533883
11,16,2,29,0.4074074074074074,0.9310344827586207,0.37877484504541775,0.9188970907124364
6,17,1,24,0.2608695652173913,0.9583333333333334,0.37484558764611836,0.9446362846213753
39,60,18,117,0.3939393939393939,0.8461538461538461,0.28826550106603177,0.9226582626433533
19,89,2,110,0.17592592592592593,0.9818181818181818,0.29554063334116404,0.9284642213904887
0,1,0,1,0.0,1.0,0.26780138230094214,0.9311853098258628
34,87,3,124,0.2809917355371901,0.9758064516129032,0.2614314308992783,0.947729088627706
123,256,36,415,0.3245382585751979,0.9132530120481928,0.25936788914609826,0.9444069565620283
11,75,20,106,0.12790697674418605,0.8113207547169812,0.22345312227704112,0.9266693685262053
0,35,5,40,0.0,0.875,0.18618604153169954,0.9147646066214435
0,12,2,14,0.0,0.8571428571428571,0.12990898525464323,0.9163344653341594
3,11,2,16,0.21428571428571427,0.875,0.13538895502032727,0.901074725074419
44,165,59,268,0.21052631578947367,0.7798507462686567,0.1654641429902521,0.8696248316842271
43,105,23,171,0.2905405405405405,0.8654970760233918,0.16682825799073073,0.853866349457154
5,17,4,26,0.22727272727272727,0.8461538461538461,0.1529331820903778,0.8442807543293903
5,24,97,126,0.1724137931034483,0.23015873015873015,0.1592912987131295,0.7612576079639259
5,38,10,53,0.11627906976744186,0.8113207547169812,0.17590259439419262,0.7521605729234945
14,164,27,205,0.07865168539325842,0.8682926829268293,0.18713854945037242,0.7537534051783477
21,144,3,168,0.12727272727272726,0.9821428571428571,0.17470812273423145,0.7690595276273273
23,120,7,150,0.16083916083916083,0.9533333333333334,0.1676099577413296,0.7938427543508526
48,67,2,117,0.41739130434782606,0.9829059829059829,0.18573149542808468,0.8106154553340799
67,150,7,224,0.3087557603686636,0.96875,0.19737192872750414,0.8281291915978162
13,88,1,102,0.12871287128712872,0.9901960784313726,0.19112893989660135,0.9367059556367651
4,51,5,60,0.07272727272727272,0.9166666666666666,0.18490725460514862,0.9517553716295772
3,27,9,39,0.1,0.7692307692307693,0.1879570138346831,0.9376036696729974
5,146,12,163,0.033112582781456956,0.9263803680981595,0.1745055646216445,0.929637599809469
15,99,26,140,0.13157894736842105,0.8142857142857143,0.17032553412582452,0.9097736542312377
34,82,25,141,0.29310344827586204,0.8226950354609929,0.15257012611554396,0.8868863760248106
13,94,2,109,0.12149532710280374,0.981651376146789,0.12581863564899257,0.8887294297600662
8,56,2,66,0.125,0.9696969696969697,0.12528822546511703,0.8858009856551515
13,108,12,133,0.10743801652892562,0.9097744360902256,0.13024690315106743,0.8848163812870885
13,36,1,50,0.2653061224489796,0.98,0.15386206350092166,0.9149262713969785
18,81,1,100,0.18181818181818182,0.99,0.1751057205061681,0.9240147902400987
4,22,4,30,0.15384615384615385,0.8666666666666667,0.17828675000298705,0.9314977834373775
7,77,12,96,0.08333333333333333,0.875,0.14831959072548292,0.9389699212286643
18,36,2,56,0.3333333333333333,0.9642857142857143,0.17858216304413002,0.9364891123913679
0,4,58,62,0.0,0.06451612903225806,0.16072502018698717,0.8071775637249805
8,192,9,209,0.04,0.9569377990430622,0.15109101782571208,0.8139151870039572
26,196,14,236,0.11711711711711711,0.940677966101695,0.1299211599211603,0.8082977535899136
41,94,13,148,0.3037037037037037,0.9121621621621622,0.14733337733337773,0.7971780624702225
8,50,7,65,0.13793103448275862,0.8923076923076924,0.14505978885289267,0.8008410661332263
33,189,6,228,0.14864864864864866,0.9736842105263158,0.154390548183652,0.8149388104941284
0,10,55,65,0.0,0.15384615384615385,0.1067715005646044,0.6991617304313341
6,7,2,15,0.46153846153846156,0.8666666666666667,0.17270556649867033,0.8137546643791068
33,50,5,88,0.39759036144578314,0.9431818181818182,0.22378990384806793,0.8117895242560719
1,61,3,65,0.016129032258064516,0.9538461538461539,0.209363034582489,0.8136706939338517
49,63,33,145,0.4375,0.7724137931034483,0.2284767911962456,0.7937066412111784
22,122,452,596,0.1527777777777778,0.24161073825503357,0.2305977545241055,0.70074993348937
2,48,9,59,0.04,0.847457627118644,0.21507651900286998,0.6827175644311312
22,65,20,107,0.25287356321839083,0.8130841121495327,0.25120131374835436,0.776894415617328
2,0,0,2,1.0,1.0,0.32812439067143123,0.7959420346649472
2,14,1,17,0.125,0.9411764705882353,0.2891829104648908,0.7956555564372925
20,83,2,105,0.1941747572815534,0.9809523809523809,0.31461801403967493,0.7995278745953248
41,84,25,150,0.328,0.8333333333333334,0.29897515689681775,0.808230666056737
21,38,4,63,0.3559322033898305,0.9365079365079365,0.3279972176985396,0.9075016943785803
11,18,2,31,0.3793103448275862,0.9354838709677419,0.3764701241024805,0.9200768720713085
6,17,1,24,0.2608695652173913,0.9583333333333334,0.37213163657686693,0.9436839036689945
40,60,17,117,0.4,0.8547008547008547,0.2864173508625813,0.9229268829119736
21,87,2,110,0.19444444444444445,0.9818181818181818,0.2963379857832162,0.9287328416591087
0,1,0,1,0.0,1.0,0.2672117721909832,0.9314539300944829
35,86,3,124,0.2892561983471074,0.9758064516129032,0.2661233719548557,0.9489500898487072
124,257,34,415,0.32545931758530183,0.9180722891566265,0.264191410060262,0.9463164259413773
9,77,20,106,0.10465116279069768,0.8113207547169812,0.22495438405499218,0.9285788379055543
0,35,5,40,0.0,0.875,0.18768730330965058,0.9166740760007924
0,12,2,14,0.0,0.8571428571428571,0.13054444616679345,0.917022933492507
3,11,2,16,0.21428571428571427,0.875,0.13337891328697485,0.9017631932327668
43,166,59,268,0.20574162679425836,0.7798507462686567,0.16277057425758315,0.8703132998425749
43,105,23,171,0.2905405405405405,0.8654970760233918,0.1629540517137879,0.8545548176155017
5,17,4,26,0.22727272727272727,0.8461538461538461,0.1489273959548487,0.8442807543293903
5,24,97,126,0.1724137931034483,0.23015873015873015,0.15860777171381304,0.7612576079639259
5,38,10,53,0.11627906976744186,0.8113207547169812,0.17521906739487617,0.7521605729234946
15,163,27,205,0.08426966292134831,0.8682926829268293,0.1872575906693545,0.7537534051783477
21,144,3,168,0.12727272727272726,0.9821428571428571,0.17482716395321352,0.7690595276273273
23,120,7,150,0.16083916083916083,0.9533333333333334,0.16841252595962813,0.7938427543508526
50,65,2,117,0.43478260869565216,0.9829059829059829,0.1890185356960727,0.81061545533408
67,150,7,224,0.3087557603686636,0.96875,0.20065896899549213,0.8281291915978162
13,88,1,102,0.12871287128712872,0.9901960784313726,0.19441598016458933,0.9367059556367651
4,51,5,60,0.07272727272727272,0.9166666666666666,0.1881942948731366,0.9517553716295772
3,27,9,39,0.1,0.7692307692307693,0.19044148588437257,0.9376036696729972
5,147,11,163,0.03289473684210526,0.9325153374233128,0.17695891582285514,0.9305140239987766
15,99,26,140,0.13157894736842105,0.8142857142857143,0.17277888532703517,0.9106500784205454
35,81,25,141,0.3017241379310345,0.8226950354609929,0.1537705323606612,0.8877628002141182
12,95,2,109,0.11214953271028037,0.981651376146789,0.1256839284094636,0.8896058539493737
8,56,2,66,0.125,0.9696969696969697,0.1251535182255881,0.8866774098444591
12,109,12,133,0.09917355371900827,0.9097744360902256,0.12893155836726458,0.8856928054763962
13,36,1,50,0.2653061224489796,0.98,0.1525467187171188,0.9158026955862864
18,81,1,100,0.18181818181818182,0.99,0.17382149657084403,0.9240147902400987
5,21,4,30,0.19230769230769232,0.8666666666666667,0.1824970315621685,0.9314977834373775
9,76,11,96,0.10588235294117647,0.8854166666666666,0.1545196337064745,0.9404580164667594
19,35,2,56,0.35185185185185186,0.9642857142857143,0.18876282215527043,0.9379772076294631
0,4,58,62,0.0,0.06451612903225806,0.17090567929812758,0.8086656589630757
7,193,9,209,0.035,0.9569377990430622,0.16173802876684068,0.8154032822420525
26,197,13,236,0.11659192825112108,0.9449152542372882,0.14049314388143233,0.8103911757045222
43,97,8,148,0.30714285714285716,0.9459459459459459,0.15839666892781448,0.8040977394110859
10,48,7,65,0.1724137931034483,0.8923076923076924,0.1555546833272082,0.8077607430740895
34,188,6,228,0.15315315315315314,0.9736842105263158,0.16230765478606202,0.8203703921968967
0,10,55,65,0.0,0.15384615384615385,0.11204310452151175,0.7045933121341023
6,7,2,15,0.46153846153846156,0.8666666666666667,0.17797717045557768,0.819186246081875
32,51,5,88,0.3855421686746988,0.9431818181818182,0.2280546231233918,0.81722110595884
1,61,3,65,0.016129032258064516,0.9538461538461539,0.21370278083866942,0.8184969487601066
48,64,33,145,0.42857142857142855,0.7724137931034483,0.23104971961417964,0.7937066412111784
21,123,452,596,0.14583333333333334,0.24161073825503357,0.2272525110755918,0.70074993348937
2,48,9,59,0.04,0.847457627118644,0.21108777491085565,0.6827175644311311
23,64,20,107,0.26436781609195403,0.8130841121495327,0.24885460578113477,0.7768944156173282
2,0,0,2,1.0,1.0,0.3257776827042117,0.7959420346649472
2,14,1,17,0.125,0.9411764705882353,0.28855737289354044,0.7956555564372925
20,83,2,105,0.1941747572815534,0.9809523809523809,0.31399247646832457,0.7995278745953247
42,87,21,150,0.32558139534883723,0.86,0.29927961457938296,0.8120401898662608
20,39,4,63,0.3389830508474576,0.9365079365079365,0.326872431367115,0.9113112181881041
11,18,2,31,0.3793103448275862,0.9354838709677419,0.3753453377710559,0.9238863958808324
6,17,1,24,0.2608695652173913,0.9583333333333334,0.3727041588708106,0.9436839036689942
40,60,17,117,0.4,0.8547008547008547,0.2869898731565249,0.9229268829119736
25,83,2,110,0.23148148148148148,0.9818181818181818,0.30220151336816514,0.9287328416591087
0,1,0,1,0.0,1.0,0.27446226232794324,0.9314539300944829
35,86,3,124,0.2892561983471074,0.9758064516129032,0.26890957637753,0.9489500898487072
137,244,34,415,0.35958005249343833,0.9180722891566265,0.2694306976780454,0.9463164259413773
11,75,20,106,0.12790697674418605,0.8113207547169812,0.23844203918337245,0.9285788379055543
0,35,5,40,0.0,0.875,0.20117495843803088,0.9166740760007924
0,12,2,14,0.0,0.8571428571428571,0.14403210129517371,0.917022933492507
3,11,2,16,0.21428571428571427,0.875,0.1415755631243498,0.9017631932327667
44,165,59,268,0.21052631578947367,0.7798507462686567,0.17165075109427463,0.8703132998425749
46,101,24,171,0.3129251700680272,0.8596491228070176,0.17503203276869175,0.8537193957274483
4,18,4,26,0.18181818181818182,0.8461538461538461,0.14963747981508368,0.8434453324413368
5,27,94,126,0.15625,0.25396825396825395,0.15368648313734282,0.7638235466200901
5,38,10,53,0.11627906976744186,0.8113207547169812,0.17029777881840594,0.7547265115796588
11,167,27,205,0.06179775280898876,0.8682926829268293,0.17912602921969006,0.756319343834512
26,139,3,168,0.15757575757575756,0.9821428571428571,0.17102460683255336,0.7716254662834915
25,118,7,150,0.17482517482517482,0.9533333333333334,0.16592444383765353,0.7964086930070168
45,70,2,117,0.391304347826087,0.9829059829059829,0.17712146923166205,0.8140168158782977
68,149,7,224,0.31336405529953915,0.96875,0.19591373687185598,0.8315305521420339
13,88,1,102,0.12871287128712872,0.9901960784313726,0.1919798613414458,0.9367059556367651
4,55,1,60,0.06779661016949153,0.9833333333333333,0.18505379568459573,0.9612791811533868
2,28,9,39,0.06666666666666667,0.7692307692307693,0.18574935480712115,0.9471274791968068
5,154,4,163,0.031446540880503145,0.9754601226993865,0.16773089527922766,0.9461728028477395
15,99,26,140,0.13157894736842105,0.8142857142857143,0.1615528627854057,0.9263088572695083
37,79,25,141,0.31896551724137934,0.8226950354609929,0.15121874413044747,0.9034215790630811
13,94,2,109,0.12149532710280374,0.981651376146789,0.12380892581662813,0.9052646327983366
9,56,1,66,0.13846153846153847,0.9848484848484849,0.1252015925558295,0.9045006908579242
13,108,12,133,0.10743801652892562,0.9097744360902256,0.13086465060717725,0.8939922769660517
13,36,1,50,0.2653061224489796,0.98,0.15924171571893625,0.9241021670759417
20,79,1,100,0.20202020202020202,0.99,0.18360938159603607,0.9261792924046007
4,22,4,30,0.15384615384615385,0.8666666666666667,0.18679041109285505,0.9336622856018797
9,76,11,96,0.10588235294117647,0.8854166666666666,0.1563499590499689,0.9426225186312617
24,31,1,56,0.43636363636363634,0.9821428571428571,0.2013311460872307,0.9426927302021285
0,4,58,62,0.0,0.06451612903225806,0.18155092630701095,0.8112166793712391
9,191,9,209,0.045,0.9569377990430622,0.17263120966002155,0.8179543026502156
27,194,15,236,0.12217194570135746,0.9364406779661016,0.15218347012464697,0.8117315423596588
48,94,6,148,0.3380281690140845,0.9594594594594594,0.17161317969520162,0.8073686079967244
7,51,7,65,0.1206896551724138,0.8923076923076924,0.16687653702752445,0.8110316116597281
39,183,6,228,0.17567567567567569,0.9736842105263158,0.17684701170388148,0.8236412607825352
0,13,52,65,0.0,0.2,0.11450934936621916,0.7119065669049841
6,7,2,15,0.46153846153846156,0.8666666666666667,0.1804434153002851,0.8264995008527567
31,52,5,88,0.37349397590361444,0.9431818181818182,0.2273711261436586,0.8245343607297219
1,61,3,65,0.016129032258064516,0.9538461538461539,0.21222213850890245,0.8270208572840152
51,61,33,145,0.45535714285714285,0.7724137931034483,0.2289834204864822,0.800300047804585
25,120,451,596,0.1724137931034483,0.24328859060402686,0.23637258304805855,0.7075830332754898
2,48,9,59,0.04,0.847457627118644,0.21699034366581918,0.689550664217251
23,64,20,107,0.26436781609195403,0.8130841121495327,0.2547571745360983,0.7771341088100413
2,0,0,2,1.0,1.0,0.3316802514591753,0.7961817278576604
2,14,1,17,0.125,0.9411764705882353,0.2961811120443732,0.7958952496300057
21,82,2,105,0.20388349514563106,0.9809523809523809,0.3230031781711684,0.7997675677880381
38,90,22,150,0.296875,0.8533333333333334,0.3003628720487194,0.8113275021065931
20,39,4,63,0.3389830508474576,0.9365079365079365,0.3241584802978636,0.9103588372357231
11,18,2,31,0.3793103448275862,0.9354838709677419,0.3726313867018045,0.9229340149284513
6,17,1,24,0.2608695652173913,0.9583333333333334,0.37003483154681854,0.9427315227166134
41,60,16,117,0.40594059405940597,0.8632478632478633,0.28516920212673375,0.9231955031805938
23,85,2,110,0.21296296296296297,0.9818181818181818,0.2977353396928713,0.9290014619277291
0,1,0,1,0.0,1.0,0.2713830512046605,0.9317225503631033
35,86,3,124,0.2892561983471074,0.9758064516129032,0.27446014590666573,0.9501710910697084
135,245,35,415,0.35526315789473684,0.9156626506024096,0.2719432604727419,0.9471931930832046
11,75,20,106,0.12790697674418605,0.8113207547169812,0.23602849360368475,0.9294556050473817
0,35,5,40,0.0,0.875,0.19876141285834312,0.9175508431426198
0,12,2,14,0.0,0.8571428571428571,0.14076989942128512,0.916678699413333
3,11,2,16,0.21428571428571427,0.875,0.14095886389596388,0.9014189591535928
49,161,59,269,0.23333333333333334,0.7806691449814126,0.17429219722929723,0.8700859798652233
44,103,24,171,0.29931972789115646,0.8596491228070176,0.17572984430701855,0.8534920757500968
5,17,4,26,0.22727272727272727,0.8461538461538461,0.15744549707530284,0.843562246543159
4,26,96,126,0.13333333333333333,0.23809523809523808,0.15822069087375246,0.7616728870257672
5,38,10,53,0.11627906976744186,0.8113207547169812,0.1748319865548156,0.7525758519853359
13,165,27,205,0.07303370786516854,0.8682926829268293,0.1852653733926968,0.7541686842401891
25,140,3,168,0.15151515151515152,0.9821428571428571,0.1762981501397593,0.7694748066891687
25,118,7,150,0.17482517482517482,0.9533333333333334,0.1679398417814509,0.7941411193108717
41,74,2,117,0.3565217391304348,0.9829059829059829,0.1761115576727764,0.8117492421821525
68,149,7,224,0.31336405529953915,0.96875,0.18841031881946382,0.8292629784458888
13,88,1,102,0.12871287128712872,0.9901960784313726,0.18775025281286314,0.9367059556367652
4,54,2,60,0.06896551724137931,0.9666666666666667,0.1809911738805685,0.9588982287724345
1,29,9,39,0.03333333333333333,0.7692307692307693,0.17531969180459203,0.9447465268158545
5,154,4,163,0.031446540880503145,0.9754601226993865,0.1581670331424994,0.9437918504667872
15,99,26,140,0.13157894736842105,0.8142857142857143,0.15198900064867746,0.9239279048885559
36,81,24,141,0.3076923076923077,0.8297872340425532,0.14501336758608788,0.902053797908066
14,93,2,109,0.1308411214953271,0.981651376146789,0.11893866275691471,0.9038968516433215
9,56,1,66,0.13846153846153847,0.9848484848484849,0.12033132949611612,0.9031329097029089
13,107,13,133,0.10833333333333334,0.9022556390977443,0.12595530322353812,0.89393133433592
11,38,1,50,0.22448979591836735,0.98,0.1532633693071144,0.9240412244458102
20,79,1,100,0.20202020202020202,0.99,0.17763103518421425,0.9261183497744694
5,21,4,30,0.19230769230769232,0.8666666666666667,0.1863065701755387,0.9336013429717481
8,76,12,96,0.09523809523809523,0.875,0.15595596839636552,0.9400603095370977
22,33,1,56,0.4,0.9821428571428571,0.1944072367541759,0.9401305211079646
0,4,58,62,0.0,0.06451612903225806,0.17462701697395613,0.808654470277075
8,192,9,209,0.04,0.9569377990430622,0.16486511221205138,0.8164662074121205
26,195,15,236,0.11764705882352941,0.9364406779661016,0.14960186405564596,0.8102434471215635
51,94,3,148,0.35172413793103446,0.9797297297297297,0.17098814061433631,0.808776265654382
8,50,7,65,0.13793103448275862,0.8923076923076924,0.16322004663934578,0.8124392693173857
36,185,6,227,0.16289592760180996,0.973568281938326,0.17288545126273358,0.8265204524514324
0,12,53,65,0.0,0.18461538461538463,0.11574259411987645,0.712587956376079
6,7,2,15,0.46153846153846156,0.8666666666666667,0.18167666005394237,0.8271808903238517
31,52,5,88,0.37349397590361444,0.9431818181818182,0.2293186566116016,0.8252157502008169
1,61,3,65,0.016129032258064516,0.9538461538461539,0.21481608138796376,0.8277022467551102
49,64,32,145,0.4336283185840708,0.7793103448275862,0.2265166786241118,0.7990709060548039
21,122,453,596,0.14685314685314685,0.23993288590604026,0.22779126610559583,0.7058745051402822
2,48,9,59,0.04,0.847457627118644,0.21023470501962296,0.6878586973088989
23,64,20,107,0.26436781609195403,0.8130841121495327,0.24800153588990212,0.7776399440994917
2,0,0,2,1.0,1.0,0.3249246128129791,0.7966875631471106
2,14,1,17,0.125,0.9411764705882353,0.289425473398177,0.7964010849194559
20,83,2,105,0.1941747572815534,0.9809523809523809,0.31486057697296105,0.8002734030774883
42,86,22,150,0.328125,0.8533333333333334,0.2997886743180938,0.8108481157211666
21,38,4,63,0.3559322033898305,0.9365079365079365,0.3296571109661915,0.9103588372357231
10,19,2,31,0.3448275862068966,0.9354838709677419,0.3732039089957482,0.9229340149284514
4,19,1,24,0.17391304347826086,0.9583333333333334,0.36655852466262884,0.9413924655213025
39,63,15,117,0.38235294117647056,0.8717948717948718,0.2783232305449818,0.9230774472062843
23,85,2,110,0.21296296296296297,0.9818181818181818,0.2908893681111194,0.9288834059534193
0,1,0,1,0.0,1.0,0.2551750823968337,0.931922919631231
35,85,3,123,0.2916666666666667,0.975609756097561,0.25002302157250395,0.9507283660443576
134,246,35,415,0.3526315789473684,0.9156626506024096,0.24955150379500937,0.9477504680578539
11,75,20,106,0.12790697674418605,0.8113207547169812,0.22020488142513117,0.9306485069090483
0,35,5,40,0.0,0.875,0.19536016092823677,0.9187437450042865
0,13,1,14,0.0,0.9285714285714286,0.14073831218874097,0.9268546816866516
3,12,1,16,0.2,0.9375,0.13888646033688912,0.9205235128554828
51,163,55,269,0.2383177570093458,0.7955390334572491,0.17293185419536708,0.8913148033493756
48,99,24,171,0.32653061224489793,0.8596491228070176,0.1779124178494001,0.8747489985935836
5,21,0,26,0.19230769230769232,1.0,0.15500900547230353,0.886797191364668
6,55,65,126,0.09836065573770492,0.48412698412698413,0.15078810247137767,0.8400552241375255
5,45,3,53,0.1,0.9433962264150944,0.16507381675709196,0.8498261136253962
14,164,27,205,0.07865168539325842,0.8682926829268293,0.17630977181327173,0.8412148642475962
25,140,3,168,0.15151515151515152,0.9821428571428571,0.1693833648868648,0.8475924152680043
27,116,7,150,0.1888111888111888,0.9533333333333334,0.16231099800141383,0.8701344581074449
45,69,2,116,0.39473684210526316,0.9827586206896551,0.17205474512432312,0.8877215292335361
69,148,7,224,0.31797235023041476,0.96875,0.19000683911328345,0.8832572435192504
13,88,1,102,0.12871287128712872,0.9901960784313726,0.19434286990605829,0.9555528284198773
5,53,1,59,0.08620689655172414,0.9830508474576272,0.19237242655630463,0.9612177742830962
2,28,9,39,0.06666666666666667,0.7692307692307693,0.19066028102393437,0.9470660723265162
5,154,4,163,0.031446540880503145,0.9754601226993865,0.17350762236184172,0.9461113959774491
16,99,25,140,0.1391304347826087,0.8214285714285714,0.1664103717863303,0.9272678585624831
34,83,24,141,0.2905982905982906,0.8297872340425532,0.15153343585676277,0.9054148033271827
17,90,2,109,0.1588785046728972,0.981651376146789,0.12880574363426026,0.9072578570624383
7,58,1,66,0.1076923076923077,0.9848484848484849,0.12580280597785726,0.9064939151220257
13,68,51,132,0.16049382716049382,0.6136363636363636,0.13641522463625294,0.8537204174332739
11,38,1,50,0.22448979591836735,0.98,0.15896138595792444,0.8838303075431639
19,80,1,100,0.1919191919191919,0.99,0.18188605039202282,0.885907432871823
5,21,4,30,0.19230769230769232,0.8666666666666667,0.18948280146703483,0.8923700179058366
7,82,7,96,0.07865168539325842,0.9270833333333334,0.15920471500917308,0.9062694606616625
21,34,1,56,0.38181818181818183,0.9821428571428571,0.19105324031564228,0.9063396722325292
0,4,58,62,0.0,0.06451612903225806,0.1756686249310269,0.7748636214016397
8,192,9,209,0.04,0.9569377990430622,0.15845522105095636,0.8239066836025967
28,194,14,236,0.12612612612612611,0.940677966101695,0.1444032682234933,0.8182892501885531
53,92,3,148,0.36551724137931035,0.9797297297297297,0.1692029895749388,0.8168220687213716
10,48,7,65,0.1724137931034483,0.8923076923076924,0.16636100397433254,0.8204850723843753
35,186,6,227,0.1583710407239819,0.973568281938326,0.17774948330729304,0.8271257793279456
6,58,1,65,0.09375,0.9846153846153847,0.13659688590469563,0.8274789975383067
6,7,2,15,0.46153846153846156,0.8666666666666667,0.20253095183876155,0.9420719314860795
31,52,5,88,0.37349397590361444,0.9431818181818182,0.25017294839642074,0.9401067913630445
1,61,3,65,0.016129032258064516,0.9538461538461539,0.2344590778438405,0.9419879610408243
52,64,29,145,0.4482758620689655,0.8,0.2462817379423627,0.9163122853651487
23,125,448,596,0.1554054054054054,0.2483221476510067,0.24385196827121372,0.8243143504141937
2,48,9,59,0.04,0.847457627118644,0.22694181959635912,0.8062985425828105
24,63,20,107,0.27586206896551724,0.8130841121495327,0.2529578294485759,0.7817940750876887
2,0,0,2,1.0,1.0,0.32988090637165285,0.8008416941353078
2,14,1,17,0.125,0.9411764705882353,0.29438176695685075,0.800555215907653
19,84,2,105,0.18446601941747573,0.9809523809523809,0.31842990797962384,0.8044275340656856
34,93,23,150,0.2677165354330709,0.8466666666666667,0.29263571846021025,0.8110942007323522
22,37,4,63,0.3728813559322034,0.9365079365079365,0.32370371139260995,0.9094064562833423
11,18,2,31,0.3793103448275862,0.9354838709677419,0.37217661779655087,0.9219816339760705
2,19,1,22,0.09523809523809523,0.9545454545454546,0.33184757716264696,0.9386513110324277
37,60,19,116,0.38144329896907214,0.8362068965517241,0.24348233415822876,0.9152522962541026
20,74,2,96,0.2127659574468085,0.9791666666666666,0.2649488995077728,0.9206794671224499
0,1,0,1,0.0,1.0,0.2401041790108784,0.9237189808002615
34,71,3,108,0.3238095238095238,0.9722222222222222,0.24079617994918476,0.9442405227503748
128,214,35,377,0.3742690058479532,0.9071618037135278,0.2458370306635413,0.9400482180654592
11,66,20,97,0.14285714285714285,0.7938144329896907,0.2186261463097998,0.920445353812755
0,28,5,33,0.0,0.8484848484848485,0.20502070413292903,0.9052938386612398
0,12,2,14,0.0,0.8571428571428571,0.15052880428020443,0.908284690174259
1,8,2,11,0.1111111111111111,0.8181818181818182,0.1360066833751048,0.8852868546764234
53,129,59,241,0.29120879120879123,0.7551867219917012,0.177607939262075,0.8503135292466663
45,89,24,158,0.3358208955223881,0.8481012658227848,0.17932384950676988,0.8325819640467468
4,16,4,24,0.2,0.8333333333333334,0.15442827724277655,0.8220350397067191
4,23,95,122,0.14814814814814814,0.22131147540983606,0.1551841351414916,0.740248902909597
4,35,10,49,0.10256410256410256,0.7959183673469388,0.16983614979350628,0.7327394056041813
9,151,26,186,0.05625,0.8602150537634409,0.17787186407922054,0.7331782908356931
22,108,3,133,0.16923076923076924,0.9774436090225563,0.18617467238202884,0.7559299752415131
26,110,8,144,0.19117647058823528,0.9444444444444444,0.17188434086480656,0.782966792734762
40,64,2,106,0.38461538461538464,0.9811320754716981,0.17885498216380608,0.8019711941131782
69,148,7,224,0.31797235023041476,0.96875,0.19570817505386534,0.8213164322084162
7,75,1,83,0.08536585365853659,0.9879518072289156,0.1867392758410637,0.9308364796111419
4,48,1,53,0.07692307692307693,0.9811320754716981,0.18307627217806002,0.9572955807718219
1,27,8,36,0.03571428571428571,0.7777777777777778,0.18014259870867225,0.9455188270595842
5,150,4,159,0.03225806451612903,0.9748427672955975,0.16057506946372366,0.9451472782414472
16,89,26,131,0.1523809523809524,0.8015267175572519,0.15503285257696894,0.9247304601147055
30,70,24,124,0.3,0.8064516129032258,0.14294494048905687,0.8997761083192094
17,83,2,102,0.17,0.9803921568627451,0.12180603331328334,0.9014392735853158
8,55,1,64,0.12698412698412698,0.984375,0.12775150093122484,0.9009283011240422
13,95,12,120,0.12037037037037036,0.9,0.133958257137981,0.8893380046280853
11,35,1,47,0.2391304347826087,0.9787234042553191,0.16301770700488433,0.9180445226963055
21,75,1,97,0.21875,0.9896907216494846,0.18965941207400874,0.9201656590325751
5,20,4,29,0.2,0.8620689655172413,0.1964621331624441,0.928814551598288
7,61,13,81,0.10294117647058823,0.8395061728395061,0.16831087265824246,0.933536631589185
17,34,1,52,0.3333333333333333,0.9807692307692307,0.19164420599157575,0.9335904992901115
0,2,58,60,0.0,0.03333333333333333,0.17350361642241477,0.7977274040520163
7,164,9,180,0.04093567251461988,0.95,0.16215580244302186,0.8048702611948734
29,155,15,199,0.15760869565217392,0.9246231155778895,0.15050983971010257,0.7971416485266692
46,87,3,136,0.3458646616541353,0.9779411764705882,0.16866907708926476,0.7954631420725412
8,48,7,63,0.14285714285714285,0.8888888888888888,0.16050581178314233,0.7992945596970621
32,172,6,210,0.1568627450980392,0.9714285714285714,0.1682088930156353,0.8181406166383572
0,13,52,65,0.0,0.2,0.12058984539658768,0.7066021550998958
6,6,2,14,0.5,0.8571428571428571,0.1920184168251591,0.8242892299298278
26,45,5,76,0.36619718309859156,0.9342105263157895,0.2384843469085836,0.8220335908320834
2,59,3,64,0.03278688524590164,0.953125,0.2206526597076876,0.8261052886066705
47,62,33,142,0.43119266055045874,0.7676056338028169,0.23284237383573378,0.7960573539398462
21,89,395,505,0.19090909090909092,0.21782178217821782,0.23970693784315494,0.7001906244097503
1,43,9,53,0.022727272727272728,0.8301886792452831,0.22054472750447404,0.6800134969549949
22,59,20,101,0.2716049382716049,0.801980198019802,0.25934543297184615,0.7660106681006809
2,0,0,2,1.0,1.0,0.3307740044004176,0.786418831365987
2,14,1,17,0.125,0.9411764705882353,0.29631726395776165,0.7874139662620505
23,69,2,94,0.25,0.9787234042553191,0.3273477089226328,0.7910708811556676
39,80,22,141,0.3277310924369748,0.8439716312056738,0.31256748490642083,0.8019803093560759
21,38,4,63,0.3559322033898305,0.9365079365079365,0.33614221526081217,0.904649759974607
9,18,2,29,0.3333333333333333,0.9310344827586207,0.3805145096331066,0.9190563033336553
2,19,1,22,0.09523809523809523,0.9545454545454546,0.3254121116944352,0.9421903971754879
36,60,20,116,0.375,0.8275862068965517,0.23612639740872088,0.9175598553035667
16,78,2,96,0.1702127659574468,0.9791666666666666,0.25151393540264183,0.9229870261719141
0,1,0,1,0.0,1.0,0.23209645967448653,0.9257081146072882
36,68,3,107,0.34615384615384615,0.9719626168224299,0.24105207099230258,0.9436075360581114
125,218,34,377,0.36443148688046645,0.9098143236074271,0.2422662543481077,0.9397941627866102
10,67,20,97,0.12987012987012986,0.7938144329896907,0.21155804629999816,0.9195556716468886
0,28,5,33,0.0,0.8484848484848485,0.19795260412312743,0.9044041564953734
0,12,2,14,0.0,0.8571428571428571,0.14438117555169885,0.9086265351019884
1,8,2,11,0.1111111111111111,0.8181818181818182,0.13593808200222232,0.8856286996041529
42,141,59,242,0.22950819672131148,0.756198347107438,0.16872496724812394,0.8507998920480725
43,91,23,157,0.3208955223880597,0.8535031847133758,0.16511663528158302,0.8338771160324935
4,16,4,24,0.2,0.8333333333333334,0.14162642287008784,0.8229512602790516
3,24,95,122,0.1111111111111111,0.22131147540983606,0.13894656304737085,0.7411651234819294
4,35,10,49,0.10256410256410256,0.7959183673469388,0.15359857769938554,0.7336556261765139
11,149,26,186,0.06875,0.8602150537634409,0.16342000627081407,0.7340945114080257
22,108,3,133,0.16923076923076924,0.9774436090225563,0.1717228145736224,0.7568461958138455
23,114,7,144,0.1678832116788321,0.9513888888888888,0.1629192452818396,0.7847305589254813
41,63,2,106,0.3942307692307692,0.9811320754716981,0.17339570911651242,0.8029632576052416
65,152,7,224,0.2995391705069124,0.96875,0.1876155906174999,0.8223084957004796
7,75,1,83,0.08536585365853659,0.9879518072289156,0.18393769669570353,0.9318285431032054
5,43,5,53,0.10416666666666667,0.9056603773584906,0.18416663442464126,0.9475059731048557
2,26,8,36,0.07142857142857142,0.7777777777777778,0.18454928748586577,0.9357292193926181
5,150,4,159,0.03225806451612903,0.9748427672955975,0.16498175824091715,0.935357670574481
16,89,26,131,0.1523809523809524,0.8015267175572519,0.16276714976979148,0.9139487889556758
29,71,25,125,0.29,0.8,0.1478770398796816,0.8880727781740047
17,83,2,102,0.17,0.9803921568627451,0.12937144409297982,0.889735943440111
8,54,2,64,0.12903225806451613,0.96875,0.1356095018652626,0.8869928281216944
13,94,13,120,0.12149532710280374,0.8916666666666667,0.13808502478471077,0.8849937265942911
11,35,1,47,0.2391304347826087,0.9787234042553191,0.16204243383528752,0.9137002446625113
17,79,1,97,0.17708333333333334,0.9896907216494846,0.18273175795203098,0.915821380998781
4,21,4,29,0.16,0.8620689655172413,0.18382019332618066,0.9244702735644937
6,62,13,81,0.08823529411764706,0.8395061728395061,0.15499666391441597,0.930114012541566
20,30,2,52,0.4,0.9615384615384616,0.1878538067715588,0.9274206274952398
0,2,58,60,0.0,0.03333333333333333,0.16942062704805652,0.7937896751142874
6,168,9,183,0.034482758620689655,0.9508196721311475,0.15699026012204018,0.8022401044663561
30,155,14,199,0.16216216216216217,0.9296482412060302,0.14599479260483356,0.7952293668878863
38,84,13,135,0.3114754098360656,0.9037037037037037,0.16519366067665245,0.7829455071813461
8,48,7,63,0.14285714285714285,0.8888888888888888,0.1627446810848157,0.7867769248058673
34,169,6,209,0.16748768472906403,0.9712918660287081,0.174066451172161,0.8056034524043246
0,11,54,65,0.0,0.16923076923076924,0.11692359402930386,0.6924166392175114
6,6,2,14,0.5,0.8571428571428571,0.18835216545787528,0.8101037140474434
23,48,5,76,0.323943661971831,0.9342105263157895,0.2297037230794669,0.8077309789309638
2,59,3,64,0.03278688524590164,0.953125,0.21122154066285828,0.8110848016158165
46,63,33,142,0.42201834862385323,0.7676056338028169,0.22701338906111362,0.7916422202014041
20,87,398,505,0.18691588785046728,0.21188118811881188,0.2333074954887314,0.6949268343771073
1,43,9,53,0.022727272727272728,0.8301886792452831,0.21262743663133263,0.6747692362651895
22,59,20,101,0.2716049382716049,0.801980198019802,0.2514281420987048,0.7651620118064798
2,0,0,2,1.0,1.0,0.3228567135272762,0.7855701750717861
1,15,1,17,0.0625,0.9411764705882353,0.2855076189598718,0.7865653099678498
16,76,2,94,0.17391304347826086,0.9787234042553191,0.3056684987073517,0.7902222248614669
37,79,24,140,0.31896551724137934,0.8285714285714286,0.29094666565271254,0.7989316241141255
20,39,4,63,0.3389830508474576,0.9365079365079365,0.31267054608085404,0.9024497310268577
9,18,2,29,0.3333333333333333,0.9310344827586207,0.3570428404531484,0.9168562743859059
1,22,1,24,0.043478260869565216,0.9583333333333334,0.3343913724655868,0.9427315227166134
36,61,20,117,0.3711340206185567,0.8290598290598291,0.2445533754110949,0.918311498296589
18,90,2,110,0.16666666666666666,0.9818181818181818,0.25050575636347583,0.9241174570437243
0,1,0,1,0.0,1.0,0.2283143555312983,0.9268385454790984
35,85,3,123,0.2916666666666667,0.975609756097561,0.2272363652800797,0.945258986826369
127,254,34,415,0.3333333333333333,0.9180722891566265,0.2215866477659554,0.9426253229190389
12,74,20,106,0.13953488372093023,0.8113207547169812,0.1922591188393888,0.9248877348832159
0,34,5,39,0.0,0.8717948717948718,0.1860479387151652,0.9125250975205786
0,12,2,14,0.0,0.8571428571428571,0.1330287929125142,0.9165369586752969
2,12,2,16,0.14285714285714285,0.875,0.12962743236829655,0.9012772184155565
42,169,58,269,0.1990521327014218,0.7843866171003717,0.1580634513256425,0.8704753065727526
43,105,23,171,0.2905405405405405,0.8654970760233918,0.15790257616476736,0.8547449237050141
4,18,4,26,0.18181818181818182,0.8461538461538461,0.13625755451974572,0.8444708604189027
3,24,99,126,0.1111111111111111,0.21428571428571427,0.13219701557548583,0.7591801403572932
5,38,10,53,0.11627906976744186,0.8113207547169812,0.14880831125654898,0.7505409807747373
11,168,27,206,0.061452513966480445,0.8689320388349514,0.157587241823189,0.7522251495878937
23,142,3,168,0.1393939393939394,0.9821428571428571,0.15709249847130283,0.7675312720368732
20,123,7,150,0.13986013986013987,0.9533333333333334,0.1486364994939768,0.7916665172130106
44,71,2,117,0.3826086956521739,0.9829059829059829,0.16178909308135303,0.8084392181962379
60,157,7,224,0.2764976958525346,0.96875,0.1753147379434034,0.8259529544599741
11,89,1,101,0.11,0.9900990099009901,0.17515600778467325,0.9367834252621565
5,50,5,60,0.09090909090909091,0.9166666666666666,0.17153172509062312,0.9518328412549686
2,28,9,39,0.06666666666666667,0.7692307692307693,0.17227660404779258,0.9375898027400854
5,155,4,164,0.03125,0.975609756097561,0.1568274698486584,0.9366565025907575
16,98,26,140,0.14035087719298245,0.8142857142857143,0.15689757518192163,0.9167925570125262
32,84,25,141,0.27586206896551724,0.8226950354609929,0.1416480570838278,0.893905278806099
16,91,2,109,0.14953271028037382,0.981651376146789,0.12351020200209054,0.8957483325413547
9,55,2,66,0.140625,0.9696969696969697,0.12788520200209055,0.8928337553693517
13,107,13,133,0.10833333333333334,0.9022556390977443,0.130374379491268,0.8907750371452199
11,38,1,50,0.22448979591836735,0.98,0.15292054081293954,0.9208849272551101
17,82,1,100,0.1717171717171717,0.99,0.17298727962967836,0.92294067638403
4,22,4,30,0.15384615384615385,0.8666666666666667,0.17491517629441716,0.9304236695813087
9,75,12,96,0.10714285714285714,0.875,0.15081243174832284,0.9378958073725955
19,35,2,56,0.35185185185185186,0.9642857142857143,0.17971516625853398,0.9354149985352992
0,4,58,62,0.0,0.06451612903225806,0.15962588054424828,0.8061034498689118
6,194,9,209,0.03,0.9569377990430622,0.1484354043537721,0.8139151870039572
29,193,14,236,0.13063063063063063,0.940677966101695,0.1350269521698097,0.8082977535899136
41,94,13,148,0.3037037037037037,0.9121621621621622,0.15388217102502852,0.7971780624702225
6,52,7,65,0.10344827586206896,0.8923076923076924,0.14668247417015928,0.8008410661332261
32,188,6,226,0.14545454545454545,0.9734513274336283,0.15215557250040046,0.8149055414808873
0,12,53,65,0.0,0.18461538461538463,0.1018910222358502,0.7035240658136974
6,7,2,15,0.46153846153846156,0.8666666666666667,0.16782508816991615,0.81811699976147
26,57,5,88,0.3132530120481928,0.9431818181818182,0.20828980417680082,0.8161518596384353
1,61,3,65,0.016129032258064516,0.9538461538461539,0.19193243298071994,0.818033029316215
42,70,32,144,0.375,0.7777777777777778,0.20211761816590515,0.7988352601184457
22,117,457,596,0.15827338129496402,0.2332214765100671,0.20994977608489013,0.7046800864330709
1,49,9,59,0.02,0.847457627118644,0.19202769816281223,0.6866809863880731
21,66,20,107,0.2413793103448276,0.8130841121495327,0.22651045678350187,0.7764622331786656
2,0,0,2,1.0,1.0,0.30343353370657883,0.7955098522262848
1,15,1,17,0.0625,0.9411764705882353,0.2676116748425513,0.7952233739986301
14,89,2,105,0.13592233009708737,0.9809523809523809,0.28472500310526877,0.7990956921566624
36,91,23,150,0.28346456692913385,0.8466666666666667,0.27164851266657364,0.8089369619979323
21,38,4,63,0.3559322033898305,0.9365079365079365,0.2998854872515545,0.9094064562833422
10,19,2,31,0.3448275862068966,0.9354838709677419,0.3462894281382541,0.9219816339760705
2,21,1,24,0.08695652173913043,0.9583333333333334,0.3399377333117866,0.9436839036689942
36,61,20,117,0.3711340206185567,0.8290598290598291,0.2500997362572947,0.9192638792489699
19,89,2,110,0.17592592592592593,0.9818181818181818,0.25737486853242697,0.9250698379961052
0,1,0,1,0.0,1.0,0.2268616923881829,0.9277909264314793
35,86,3,124,0.2892561983471074,0.9758064516129032,0.22465722072348399,0.9452870861857036
125,256,34,415,0.32808398950131235,0.9180722891566265,0.22310021195974894,0.9426534222783737
12,74,20,106,0.13953488372093023,0.8113207547169812,0.19869879140756655,0.9249158342425506
0,34,5,39,0.0,0.8717948717948718,0.18627643115911935,0.9125531968799133
0,12,2,14,0.0,0.8571428571428571,0.13325728535646836,0.9165650580346315
2,12,2,16,0.14285714285714285,0.875,0.12853317348949936,0.9013053177748913
44,166,58,268,0.20952380952380953,0.7835820895522388,0.15846514627861502,0.8703884734252111
45,103,23,171,0.30405405405405406,0.8654970760233918,0.16057912566532168,0.8546299911981381
4,18,4,26,0.18181818181818182,0.8461538461538461,0.13968401028201732,0.8443559279120265
3,26,97,126,0.10344827586206896,0.23015873015873015,0.13452878058789428,0.7613327815465621
5,38,10,53,0.11627906976744186,0.8113207547169812,0.1511400762689574,0.7526936219640062
11,168,27,206,0.061452513966480445,0.8689320388349514,0.15991900683559748,0.7543777907771627
23,142,3,168,0.1393939393939394,0.9821428571428571,0.15942426348371125,0.7696839132261423
22,121,7,150,0.15384615384615385,0.9533333333333334,0.1514703126726176,0.7939340909091558
46,69,2,117,0.4,0.9829059829059829,0.16517687637918127,0.810706791892383
61,156,7,224,0.28110599078341014,0.96875,0.1793608490884996,0.8282205281561194
11,89,1,101,0.11,0.9900990099009901,0.18029680967963263,0.9367834252621564
5,50,5,60,0.09090909090909091,0.9166666666666666,0.17667252698558247,0.9518328412549687
1,29,9,39,0.03333333333333333,0.7692307692307693,0.1726555011808472,0.9375898027400854
5,155,4,164,0.03125,0.975609756097561,0.15720636698171297,0.9366565025907575
16,98,26,140,0.14035087719298245,0.8142857142857143,0.15527847031697423,0.9167925570125262
30,86,25,141,0.25862068965517243,0.8226950354609929,0.13508142598199885,0.893905278806099
17,90,2,109,0.1588785046728972,0.981651376146789,0.11762035653763984,0.8957483325413546
9,55,2,66,0.140625,0.9696969696969697,0.12199535653763985,0.8928337553693516
13,107,13,133,0.10833333333333334,0.9022556390977443,0.12448453402681735,0.8907750371452199
11,38,1,50,0.22448979591836735,0.98,0.1517926001103936,0.92088492725511
17,82,1,100,0.1717171717171717,0.99,0.17185933892713243,0.9229406763840299
5,21,4,30,0.19230769230769232,0.8666666666666667,0.1792817410863767,0.9304236695813088
8,75,13,96,0.0963855421686747,0.8645833333333334,0.15610529144544846,0.9364077121345004
19,35,2,56,0.35185185185185186,0.9642857142857143,0.18367291247101342,0.9339269032972038
0,4,58,62,0.0,0.06451612903225806,0.1635836267567277,0.8046153546308165
6,194,9,209,0.03,0.9569377990430622,0.1523931505662515,0.812427091765862
28,194,14,236,0.12612612612612611,0.940677966101695,0.13834119773878847,0.8068096583518184
40,97,13,150,0.291970802919708,0.9133333333333333,0.15552028791057934,0.7958572773994375
7,51,7,65,0.1206896551724138,0.8923076923076924,0.14528913974839672,0.7995202810624411
34,186,6,226,0.15454545454545454,0.9734513274336283,0.15359769865936526,0.8150728516481974
0,10,55,65,0.0,0.15384615384615385,0.10333314839481501,0.6992957715854031
6,6,3,15,0.5,0.8,0.17476171982338645,0.8043648960093662
26,57,5,88,0.3132530120481928,0.9431818181818182,0.21522643583027112,0.8023997558863315
1,61,3,65,0.016129032258064516,0.9538461538461539,0.19951256527769087,0.8042809255641112
46,67,32,145,0.40707964601769914,0.7793103448275862,0.21595668572026105,0.7851347843490046
21,120,455,596,0.14893617021276595,0.23657718120805368,0.2199919021545971,0.6914589970490562
1,50,9,60,0.0196078431372549,0.85,0.20071510052485428,0.6738230931299665
22,65,20,107,0.25287356321839083,0.8130841121495327,0.2368398952703387,0.7679999443161634
2,0,0,2,1.0,1.0,0.3082684666989101,0.7965713728875919
2,14,1,17,0.125,0.9411764705882353,0.28137517926345396,0.7962848946599372
16,87,2,105,0.1553398058252427,0.9809523809523809,0.30126243263019375,0.8001572128179697
38,89,23,150,0.2992125984251969,0.8466666666666667,0.28585285440269337,0.8097795445092669
22,37,4,63,0.3728813559322034,0.9365079365079365,0.31784502379118446,0.9097696524092502
10,19,2,31,0.3448275862068966,0.9354838709677419,0.36430498708684755,0.9219816339760705
2,21,1,24,0.08695652173913043,0.9583333333333334,0.3425482054667503,0.9436839036689945
37,61,19,117,0.37755102040816324,0.8376068376068376,0.2536269226679165,0.9204848804699711
21,87,2,110,0.19444444444444445,0.9818181818181818,0.2635475575885514,0.9262908392171063
0,1,0,1,0.0,1.0,0.2330343814443073,0.9290119276524804
34,87,3,124,0.2809917355371901,0.9758064516129032,0.23188141509247728,0.9465080874067048
134,245,36,415,0.35356200527704484,0.9132530120481928,0.22912150785602609,0.9431859553410271
12,74,20,106,0.13953488372093023,0.8113207547169812,0.20472008730384372,0.9254483673052042
0,34,5,39,0.0,0.8717948717948718,0.19229772705539652,0.9130857299425669
0,12,2,14,0.0,0.8571428571428571,0.13836186699708747,0.9158765898762838
2,12,2,16,0.14285714285714285,0.875,0.13099225248461582,0.9006168496165436
53,157,59,269,0.2523809523809524,0.7806691449814126,0.16704667425332329,0.869283870328174
43,105,23,171,0.2905405405405405,0.8654970760233918,0.1684107892538019,0.8535253881011009
6,16,4,26,0.2727272727272727,0.8461538461538461,0.1568629703181202,0.8439397929733372
3,28,95,126,0.0967741935483871,0.24603174603174602,0.15075430029347117,0.7631842203040178
5,38,10,53,0.11627906976744186,0.8113207547169812,0.1673655959745343,0.7545450607214619
11,168,27,206,0.061452513966480445,0.8689320388349514,0.17614452654117435,0.7562292295346182
25,140,3,168,0.15151515151515152,0.9821428571428571,0.17738138492088987,0.7715353519835979
26,117,7,150,0.18181818181818182,0.9533333333333334,0.16730098912620836,0.7962016646053008
42,73,2,117,0.3652173913043478,0.9829059829059829,0.17796911066389512,0.8129743655885281
61,156,7,224,0.28110599078341014,0.96875,0.1791660703862005,0.8304881018522644
11,89,1,101,0.11,0.9900990099009901,0.18105547130785946,0.9367834252621564
3,52,5,60,0.05454545454545454,0.9166666666666666,0.17223638341900413,0.9518328412549687
1,29,9,39,0.03333333333333333,0.7692307692307693,0.16821935761426882,0.9375898027400854
5,155,4,164,0.03125,0.975609756097561,0.1510386216835329,0.9366565025907575
16,107,17,140,0.13008130081300814,0.8785714285714286,0.14364763868279382,0.9259762304819139
34,81,26,141,0.2956521739130435,0.8156028368794326,0.13370975048403605,0.9020757810495496
14,93,2,109,0.1308411214953271,0.981651376146789,0.11224334058573847,0.9039188347848052
9,56,1,66,0.13846153846153847,0.9848484848484849,0.11630927465167253,0.9031687597773044
13,107,13,133,0.10833333333333334,0.9022556390977443,0.12399325733565522,0.9011100415531726
12,37,1,50,0.24489795918367346,0.98,0.15421677531427522,0.9312199316630627
19,80,1,100,0.1919191919191919,0.99,0.17716951701701694,0.9332756807919826
4,22,4,30,0.15384615384615385,0.8666666666666667,0.18056449602175204,0.9315750005198737
10,74,12,96,0.11904761904761904,0.875,0.15533527389811996,0.9400603095370977
19,36,1,56,0.34545454545454546,0.9821428571428571,0.18599433446372263,0.9401305211079646
0,4,58,62,0.0,0.06451612903225806,0.16621411468350283,0.808654470277075
6,194,9,209,0.03,0.9569377990430622,0.1550236384930266,0.8164662074121204
27,193,16,236,0.12272727272727273,0.9322033898305084,0.13757068328496938,0.8096381202450502
50,97,3,150,0.3401360544217687,0.98,0.1587445207853375,0.8082095488164788
7,51,7,65,0.1206896551724138,0.8923076923076924,0.15400787811766034,0.8118725524794825
33,187,6,226,0.15,0.9734513274336283,0.15842964682514335,0.8259370278271437
0,12,53,65,0.0,0.18461538461538463,0.10907899747449398,0.7120045317517905
6,7,2,15,0.46153846153846156,0.8666666666666667,0.1750130634085599,0.826597465699563
25,58,5,88,0.30120481927710846,0.9431818181818182,0.2137566090195754,0.8246323255765283
1,61,3,65,0.016129032258064516,0.9538461538461539,0.19852828895254565,0.8277241490073347
45,68,32,145,0.39823008849557523,0.7793103448275862,0.2068274366773752,0.7990541982684185
27,115,454,596,0.19014084507042253,0.23825503355704697,0.21674903523423358,0.7056181041611834
1,50,9,60,0.0196078431372549,0.85,0.19812158425384144,0.6879822002420937
22,65,20,107,0.25287356321839083,0.8130841121495327,0.23424637899932582,0.7777634470326863
2,0,0,2,1.0,1.0,0.3111694559224027,0.7968110660803054
2,14,1,17,0.125,0.9411764705882353,0.2859973388828158,0.7965245878526507
22,81,2,105,0.21359223300970873,0.9809523809523809,0.3142063675616221,0.8003969060106829
39,89,22,150,0.3046875,0.8533333333333334,0.30084314063368284,0.8109716186543612
20,39,4,63,0.3389830508474576,0.9365079365079365,0.32210631288754493,0.9107220333616312
9,20,2,31,0.3103448275862069,0.9354838709677419,0.3636401678088238,0.9229340149284514
2,21,1,24,0.08695652173913043,0.9583333333333334,0.34355508749099,0.9427315227166134
37,64,16,117,0.36633663366336633,0.8632478632478633,0.25303174944289947,0.9231955031805938
21,87,2,110,0.19444444444444445,0.9818181818181818,0.26295238436353446,0.9290014619277291
0,1,0,1,0.0,1.0,0.23660009587532363,0.9317225503631033
35,86,3,124,0.2892561983471074,0.9758064516129032,0.23630261239960107,0.9501710910697084
131,248,36,415,0.34564643799472294,0.9132530120481928,0.22756929482499735,0.9468489590040308
13,73,20,106,0.1511627906976744,0.8113207547169812,0.20482900384092123,0.9291113709682077
0,34,5,39,0.0,0.8717948717948718,0.19240664359247403,0.9167487336055704
0,12,2,14,0.0,0.8571428571428571,0.14007283878342172,0.9158765898762838
2,12,2,16,0.14285714285714285,0.875,0.13270322427095005,0.9006168496165435
51,161,57,269,0.24056603773584906,0.7881040892193308,0.16706980109035705,0.8703460052193052
45,103,23,171,0.30405405405405406,0.8654970760233918,0.16918378047706373,0.8545875229922321
4,18,4,26,0.18181818181818182,0.8461538461538461,0.14577974388041498,0.8450019278644684
4,31,91,126,0.11428571428571428,0.2777777777777778,0.14051159010727782,0.7687815025874393
5,38,10,53,0.11627906976744186,0.8113207547169812,0.15712288578834094,0.7601423430048834
10,169,27,206,0.055865921787709494,0.8689320388349514,0.16510373175801374,0.7618265118180397
24,141,3,168,0.14545454545454545,0.9821428571428571,0.16547478927192838,0.7771326342670194
25,118,7,150,0.17482517482517482,0.9533333333333334,0.15608323742754635,0.8007368119975912
38,77,2,117,0.33043478260869563,0.9829059829059829,0.1598519129353523,0.8175095129808184
62,155,7,224,0.2857142857142857,0.96875,0.17469421349193853,0.8350232492445546
10,90,1,101,0.1,0.9900990099009901,0.17265339716540792,0.9367834252621564
3,56,1,60,0.05084745762711865,0.9833333333333333,0.16330602400250463,0.9613566507787782
1,29,9,39,0.03333333333333333,0.7692307692307693,0.16008708279473663,0.9471136122638951
5,155,4,164,0.03125,0.975609756097561,0.14377214772980154,0.946180312114567
17,107,16,140,0.13709677419354838,0.8857142857142857,0.13838237621099778,0.9365204481689887
35,82,24,141,0.29914529914529914,0.8297872340425532,0.13391245000194113,0.9146463411884989
15,92,2,109,0.14018691588785046,0.981651376146789,0.1131228257410218,0.9164893949237544
9,56,1,66,0.13846153846153847,0.9848484848484849,0.1186173312355273,0.9157393199162536
13,107,13,133,0.10833333333333334,0.9022556390977443,0.12682959919355796,0.9041567921683124
11,38,1,50,0.22448979591836735,0.98,0.15413766527713424,0.9342666822782023
19,80,1,100,0.1919191919191919,0.99,0.17709040697987596,0.9363224314071222
5,21,4,30,0.19230769230769232,0.8666666666666667,0.18497768099618223,0.9336013429717482
6,78,12,96,0.07142857142857142,0.875,0.15244671989379258,0.9400603095370977
21,33,1,55,0.3888888888888889,0.9818181818181818,0.18797557317965521,0.9400841389187252
0,4,58,62,0.0,0.06451612903225806,0.16819535339943542,0.8086080880878358
5,195,9,209,0.025,0.9569377990430622,0.1562905914946735,0.816419825222881
27,193,15,235,0.12272727272727273,0.9361702127659575,0.14175308818166,0.8101584270465894
53,94,3,150,0.36054421768707484,0.98,0.16584237757707185,0.8087298556180179
6,53,6,65,0.1016949152542373,0.9076923076923077,0.152897695140864,0.8145906614788238
34,187,6,227,0.15384615384615385,0.973568281938326,0.16467163548623293,0.8286718446128702
0,12,53,65,0.0,0.18461538461538463,0.10911607993067733,0.7147857307267564
6,7,2,15,0.46153846153846156,0.8666666666666667,0.1750501458647433,0.8293786646745291
31,52,5,88,0.37349397590361444,0.9431818181818182,0.22483499956525965,0.8274135245514943
1,61,3,65,0.016129032258064516,0.9538461538461539,0.2096066794982299,0.8299386589915223
44,69,32,145,0.3893805309734513,0.7793103448275862,0.21372615282485508,0.8012687082526061
22,117,457,596,0.15827338129496402,0.2332214765100671,0.22180879083067317,0.7049157323694288
1,50,9,60,0.0196078431372549,0.85,0.2026318893008305,0.6872631206639538
21,65,20,106,0.2441860465116279,0.8113207547169812,0.23751561023106307,0.776792459249896
2,0,0,2,1.0,1.0,0.3144386871541399,0.7958400782975151
2,14,1,17,0.125,0.9411764705882353,0.2789395477393379,0.7955536000698604
22,81,2,105,0.21359223300970873,0.9809523809523809,0.3071485764181442,0.7994259182278929
37,91,22,150,0.2890625,0.8533333333333334,0.2928174291362226,0.8100006308715711
22,37,4,63,0.3728813559322034,0.9365079365079365,0.3234757112272568,0.9104701251569809
9,20,2,31,0.3103448275862069,0.9354838709677419,0.3650095661485357,0.9226821067238011
2,21,1,24,0.08695652173913043,0.9583333333333334,0.34504160581905646,0.9402128447368187
38,65,14,117,0.36893203883495146,0.8803418803418803,0.2548890399383352,0.9231188276428014
22,86,2,110,0.2037037037037037,0.9818181818181818,0.26613242618172145,0.9289247863899367
0,1,0,1,0.0,1.0,0.23662932059165936,0.9319643000677482
34,87,3,124,0.2809917355371901,0.9758064516129032,0.2352569555829307,0.9519774666246936
123,257,35,415,0.3236842105263158,0.9156626506024096,0.22822879195351822,0.9489995686381897
14,72,20,106,0.16279069767441862,0.8113207547169812,0.20386555828795896,0.9318976074893841
0,34,5,39,0.0,0.8717948717948718,0.19144319803951174,0.9195349701267467
0,13,1,14,0.0,0.9285714285714286,0.13873862106309012,0.9264249055881109
2,13,1,16,0.13333333333333333,0.9375,0.1286857110101801,0.920093736756942
48,164,55,267,0.22641509433962265,0.7940074906367042,0.16103072448726904,0.8906662354193282
45,102,23,170,0.30612244897959184,0.8647058823529412,0.16462082640761214,0.8747947255250479
3,23,0,26,0.11538461538461539,1.0,0.1348637413873692,0.8868429182961323
5,57,64,126,0.08064516129032258,0.49206349206349204,0.12312866476106978,0.8412347379170624
5,45,3,53,0.1,0.9433962264150944,0.13741437904678408,0.8514635028628085
10,169,27,206,0.055865921787709494,0.8689320388349514,0.14539522501645688,0.8429435900433118
23,142,3,168,0.1393939393939394,0.9821428571428571,0.1462610258822577,0.8493211410637198
25,118,7,150,0.17482517482517482,0.9533333333333334,0.13889103738019373,0.8720819757346668
43,72,2,117,0.3739130434782609,0.9829059829059829,0.14857540802286076,0.8889677043851014
62,155,7,224,0.2857142857142857,0.96875,0.17290821806995652,0.8845034186708157
10,90,1,101,0.1,0.9900990099009901,0.17567319502848186,0.9556513497904583
5,54,1,60,0.0847457627118644,0.9833333333333333,0.17349401827303393,0.9613566507787781
3,27,9,39,0.1,0.7692307692307693,0.1797988865890754,0.9471136122638949
5,155,4,164,0.03125,0.975609756097561,0.16434975238994123,0.946180312114567
17,108,15,140,0.136,0.8928571428571429,0.15880329884348768,0.937540856332254
37,78,26,141,0.3217391304347826,0.8156028368794326,0.15134988269441932,0.9136404068998898
12,95,2,109,0.11214953271028037,0.981651376146789,0.12655491797956145,0.9154834606351453
8,57,1,66,0.12307692307692308,0.9848484848484849,0.12985162127626473,0.9147333856276446
13,70,50,133,0.1566265060240964,0.6240601503759399,0.14012029889229788,0.8634086452051599
11,38,1,50,0.22448979591836735,0.98,0.15790455545206464,0.89351853531505
18,81,1,100,0.18181818181818182,0.99,0.17941429571180487,0.8955742844439698
4,22,4,30,0.15384615384615385,0.8666666666666667,0.18196374626125547,0.8918327878453303
8,83,5,96,0.08791208791208792,0.9479166666666666,0.14855988304372764,0.9107347635292209
20,34,1,55,0.37037037037037035,0.9818181818181818,0.1854485741380262,0.9107585929108485
0,4,58,62,0.0,0.06451612903225806,0.1678661565556086,0.7792825420799588
6,192,9,207,0.030303030303030304,0.9565217391304348,0.14981994573831345,0.8267770547591725
26,195,14,235,0.11764705882352941,0.9404255319148936,0.13455669758190805,0.8211235593184429
56,92,2,150,0.3783783783783784,0.9866666666666667,0.16263672566193613,0.8206473688422525
8,55,2,65,0.12698412698412698,0.9692307692307692,0.15879929325307512,0.8352993834942672
31,190,6,227,0.14027149321266968,0.973568281938326,0.1662792082960154,0.838963899961647
7,57,1,65,0.109375,0.9846153846153847,0.12899415538596248,0.8393635003612474
6,7,2,15,0.46153846153846156,0.8666666666666667,0.19492822132002846,0.9539564343090202
24,59,5,88,0.2891566265060241,0.9431818181818182,0.23190730649188468,0.9520507313163608
0,62,3,65,0.0,0.9538461538461539,0.21510058380280905,0.9539679630208264
47,70,28,145,0.4017094017094017,0.8068965517241379,0.21843358713581237,0.9282865180290365
24,122,450,596,0.1643835616438356,0.24496644295302014,0.22377636351577077,0.8248201857036437
1,50,9,60,0.0196078431372549,0.85,0.20653869921928295,0.8071675739981687
22,64,20,106,0.2558139534883721,0.8113207547169812,0.2274585497176218,0.7824111982983968
2,0,0,2,1.0,1.0,0.30438162664069873,0.8014588173460158
2,14,1,17,0.125,0.9411764705882353,0.280930679996981,0.801172339118361
19,84,2,105,0.18446601941747573,0.9809523809523809,0.3072829684851918,0.8050446572763935
37,90,23,150,0.29133858267716534,0.8466666666666667,0.2915157086234438,0.8107261022681833
24,35,4,63,0.4067796610169492,0.9365079365079365,0.32614372281960285,0.9095177442046001
9,20,2,31,0.3103448275862069,0.9354838709677419,0.3676775777408817,0.9217297257714202
2,19,1,22,0.09523809523809523,0.9545454545454546,0.35438428611600614,0.9378438211831845
35,60,21,116,0.3684210526315789,0.8189655172413793,0.26415872220623177,0.9119817522176673
16,78,2,96,0.1702127659574468,0.9791666666666666,0.27061768877158127,0.9174089230860146
0,1,0,1,0.0,1.0,0.24143182087603596,0.9204164418830071
37,68,3,108,0.3523809523809524,0.9722222222222222,0.25236308993538387,0.9417774685631828
130,213,35,378,0.37900874635568516,0.9074074074074074,0.2532384314244527,0.93762025012025
10,67,20,97,0.12987012987012986,0.7938144329896907,0.21359024891912728,0.9180173858675458
0,28,5,33,0.0,0.8484848484848485,0.19998480674225655,0.9028658707160305
0,12,2,14,0.0,0.8571428571428571,0.14735322779488813,0.9083197764162417
1,8,2,11,0.1111111111111111,0.8181818181818182,0.1389101342454116,0.8853219409184062
50,131,59,240,0.27624309392265195,0.7541666666666667,0.17837343337721903,0.8502028932993585
41,93,23,157,0.30597014925373134,0.8535031847133758,0.17174331864475886,0.8332430307980948
4,16,4,24,0.2,0.8333333333333334,0.14617064059394672,0.8226610202160841
3,25,94,122,0.10714285714285714,0.22950819672131148,0.14292388734719347,0.7420458436063156
4,34,10,48,0.10526315789473684,0.7916666666666666,0.15796148133215587,0.7339289604894326
10,150,26,186,0.0625,0.8602150537634409,0.1668900527607273,0.7343678457209446
24,107,3,134,0.183206106870229,0.9776119402985075,0.17718933786917274,0.7571435774519001
26,111,7,144,0.1897810218978102,0.9513888888888888,0.16483761329419533,0.7853181806265034
44,60,2,106,0.4230769230769231,0.9811320754716981,0.18156715241179416,0.8035508793062637
62,155,7,224,0.2857142857142857,0.96875,0.1938120503709778,0.8228961174015018
6,76,1,83,0.07317073170731707,0.9879518072289156,0.1889588895944721,0.9312452046168739
4,48,1,53,0.07692307692307693,0.9811320754716981,0.18491030659852067,0.9583116915890212
1,27,8,36,0.03571428571428571,0.7777777777777778,0.18108377598627579,0.9465349378767837
6,149,4,159,0.03870967741935484,0.9748427672955975,0.1604414289218652,0.9461393417335107
17,98,16,131,0.14782608695652175,0.8778625954198473,0.15444786678739542,0.9356355855236477
32,67,25,124,0.32323232323232326,0.7983870967741935,0.14018435252388114,0.9095291599954327
14,86,2,102,0.14,0.9803921568627451,0.11936802599326891,0.9111923252615391
8,56,1,65,0.125,0.9846153846153847,0.12677220717793788,0.9107156934596061
12,92,16,120,0.11538461538461539,0.8666666666666667,0.1322667126724434,0.8943634922017445
11,35,1,47,0.2391304347826087,0.9787234042553191,0.16132616253934667,0.9230700102699646
18,78,1,97,0.1875,0.9896907216494846,0.18258192290801026,0.9251911466062344
5,20,4,29,0.2,0.8620689655172413,0.19003533905707862,0.9229349137630048
7,63,11,81,0.1,0.8641975308641975,0.1581450071667467,0.9323364043472911
21,30,1,52,0.4117647058823529,0.9807692307692307,0.1969685365785114,0.9323902720482177
0,2,58,60,0.0,0.03333333333333333,0.17911139372136856,0.7964928361507818
6,161,13,180,0.03592814371257485,0.9277777777777778,0.1677604691967913,0.8052229948809405
27,157,15,199,0.14673913043478262,0.9246231155778895,0.15456171143281616,0.7974943822127364
53,83,2,138,0.3897058823529412,0.9855072463768116,0.18344826605466494,0.7968967428880687
8,48,7,63,0.14285714285714285,0.8888888888888888,0.17528500074854247,0.8007281605125897
32,173,6,211,0.15609756097560976,0.9715639810426541,0.1832989380307724,0.8160662248237979
1,13,51,65,0.07142857142857142,0.2153846153846154,0.1346794902516608,0.7067255654831385
6,6,2,14,0.5,0.8571428571428571,0.2061080616802322,0.8244126403130706
24,47,5,76,0.3380281690140845,0.9342105263157895,0.24926520815187644,0.8253316043899294
0,61,3,64,0.0,0.953125,0.22830247523262176,0.8294033021645165
43,68,32,143,0.38738738738738737,0.7762237762237763,0.2279712616661141,0.7995056635712257
22,88,396,506,0.2,0.21739130434782608,0.23613452697223655,0.7035774372082167
1,44,9,54,0.022222222222222223,0.8333333333333334,0.21700947857889544,0.6838302018211709
20,60,20,100,0.25,0.8,0.2425196826605281,0.7673466853376544
2,0,0,2,1.0,1.0,0.3139482540890995,0.7877548486029606
2,14,1,17,0.125,0.9411764705882353,0.2835156585156589,0.7887499834990244
19,73,2,94,0.20652173913043478,0.9787234042553191,0.313018764105721,0.7924068983926414
34,83,23,140,0.2905982905982906,0.8357142857142857,0.29919175027870715,0.8009055426055712
22,37,4,63,0.3728813559322034,0.9365079365079365,0.32388908684045054,0.9036364900570156
9,18,2,29,0.3333333333333333,0.9310344827586207,0.368333531284895,0.9175937971177709
2,19,1,22,0.09523809523809523,0.9545454545454546,0.34491550417696526,0.9412380162231069
36,60,20,116,0.375,0.8275862068965517,0.25562978989125096,0.9166074743511857
18,76,2,96,0.19148936170212766,0.9791666666666666,0.26512827013441204,0.9220346452195329
0,1,0,1,0.0,1.0,0.23600205654217904,0.9247557336549074
34,71,3,108,0.3238095238095238,0.9722222222222222,0.24824695450136272,0.9436446225437961
122,219,36,377,0.35777126099706746,0.9045092838196287,0.246088369510629,0.9390733864454665
10,67,20,97,0.12987012987012986,0.7938144329896907,0.21045405308813522,0.9188348953057448
0,28,5,33,0.0,0.8484848484848485,0.19684861091126452,0.9036833801542297
0,12,2,14,0.0,0.8571428571428571,0.14327718233983594,0.9079057587608447
1,9,2,12,0.1,0.8333333333333334,0.13020727352524625,0.8870724254275115
50,132,58,240,0.27472527472527475,0.7583333333333333,0.16945374134314267,0.8525486159037019
43,91,24,158,0.3208955223880597,0.8481012658227848,0.16903745542579066,0.8348170507037823
4,16,4,24,0.2,0.8333333333333334,0.14649870385478098,0.8246490577771686
3,27,92,122,0.1,0.2459016393442623,0.14223154244476244,0.7463758015421075
4,34,10,48,0.10526315789473684,0.7916666666666666,0.15726913642972487,0.7382589184252242
11,149,26,186,0.06875,0.8602150537634409,0.1670905650011534,0.7386978036567362
23,107,3,133,0.17692307692307693,0.9774436090225563,0.1780795759901644,0.7592849858980538
25,112,7,144,0.18248175182481752,0.9513888888888888,0.16490192986152769,0.7868643509774189
39,65,2,106,0.375,0.9811320754716981,0.17263114094894774,0.805868752355835
63,154,7,224,0.2903225806451613,0.96875,0.1855343667553993,0.8252139904510732
6,76,1,83,0.07317073170731707,0.9879518072289156,0.18170161414215888,0.9312211572917379
5,47,1,53,0.09615384615384616,0.9811320754716981,0.18040028389346022,0.9582876442638854
1,27,8,36,0.03571428571428571,0.7777777777777778,0.17568089613835822,0.9465108905516477
5,150,4,159,0.03225806451612903,0.9748427672955975,0.1550144657945085,0.9461393417335107
15,100,16,131,0.13043478260869565,0.8778625954198473,0.14757918447791965,0.9356355855236477
33,65,26,124,0.336734693877551,0.7903225806451613,0.14211271217471264,0.9083770862627139
15,85,2,102,0.15,0.9803921568627451,0.1220666292254039,0.9100402515288202
8,56,1,65,0.125,0.9846153846153847,0.12947081041007288,0.9095636197268872
13,95,12,120,0.12037037037037036,0.9,0.13293031386957635,0.8979733232309304
9,37,1,47,0.1956521739130435,0.9787234042553191,0.15577858361225602,0.9266798412991506
18,78,1,97,0.1875,0.9896907216494846,0.17795600296709474,0.9288009776354202
5,20,4,29,0.2,0.8620689655172413,0.18789389116585253,0.9265447447921907
7,63,11,81,0.1,0.8641975308641975,0.1540746491833452,0.937098309109196
22,29,1,52,0.43137254901960786,0.9807692307692307,0.19427072761471775,0.9371521768101224
0,2,58,60,0.0,0.03333333333333333,0.1764135847575749,0.8012547409126867
8,160,13,181,0.047619047619047616,0.9281767955801105,0.16602053865024308,0.8052799974241308
26,158,15,199,0.14130434782608695,0.9246231155778895,0.15825656349496356,0.7975513847559267
52,81,4,137,0.39097744360902253,0.9708029197080292,0.18732476972482395,0.7948531273357187
8,48,7,63,0.14285714285714285,0.8888888888888888,0.17916150441870152,0.7986845449602399
30,175,6,211,0.14634146341463414,0.9715639810426541,0.18578171347793493,0.814022609271448
1,11,53,65,0.08333333333333333,0.18461538461538463,0.13606182552275287,0.7002863455351841
6,6,2,14,0.5,0.8571428571428571,0.2074903969513243,0.8179734203651161
23,48,5,76,0.323943661971831,0.9342105263157895,0.2469653418588648,0.8188353818987846
2,59,3,64,0.03278688524590164,0.953125,0.2314628472045526,0.8229070796733717
41,68,32,141,0.3761467889908257,0.7730496453900709,0.2293441822590959,0.7946566119136634
22,88,396,506,0.2,0.21739130434782608,0.23750744756521835,0.6987283855506544
1,44,9,54,0.022222222222222223,0.8333333333333334,0.2197761273948738,0.6789811501636087
20,60,20,100,0.25,0.8,0.24358565120439762,0.7668932380756965
2,0,0,2,1.0,1.0,0.315014222632969,0.7873014013410027
2,14,1,17,0.125,0.9411764705882353,0.286593699494136,0.7882965362370664
19,74,2,95,0.20430107526881722,0.9789473684210527,0.31109572664026686,0.7919854460115026
32,84,25,141,0.27586206896551724,0.8226950354609929,0.29676933806522277,0.7990776445930629
22,37,4,63,0.3728813559322034,0.9365079365079365,0.32146667462696615,0.9018085920445073
11,16,2,29,0.4074074074074074,0.9310344827586207,0.3764931296534212,0.9157658991052624
2,21,1,24,0.08695652173913043,0.9583333333333334,0.34511938480055276,0.9417791417642325
35,61,21,117,0.3645833333333333,0.8205128205128205,0.2543455752767433,0.9161381161232068
18,90,2,110,0.16666666666666666,0.9818181818181818,0.2602979562291242,0.9219440748703419
0,1,0,1,0.0,1.0,0.2297847800848801,0.924665163305716
36,86,3,125,0.29508196721311475,0.976,0.2379257413874339,0.9440937347342876
123,257,36,416,0.3236842105263158,0.9134615384615384,0.23089757775802142,0.9408013921562307
11,74,20,105,0.12941176470588237,0.8095238095238095,0.195197780597778,0.9228070976642405
0,35,5,40,0.0,0.875,0.1827754203493308,0.9109023357594784
0,12,2,14,0.0,0.8571428571428571,0.13069208701599747,0.916135198135198
2,12,2,16,0.14285714285714285,0.875,0.12729072647177977,0.9008754578754578
51,159,58,268,0.24285714285714285,0.7835820895522388,0.16198460402280018,0.8699586135257775
44,106,21,171,0.29333333333333333,0.8771929824561403,0.16173479918283143,0.8558433253052262
4,18,4,26,0.18181818181818182,0.8461538461538461,0.141468223653098,0.8462279406898415
0,25,101,126,0.0,0.1984126984126984,0.1229808286951148,0.7589263533882543
6,37,10,53,0.13953488372093023,0.8113207547169812,0.14291438351239052,0.749829318347823
12,167,27,206,0.0670391061452514,0.8689320388349514,0.1524913986759979,0.7515134871609793
21,144,3,168,0.12727272727272726,0.9821428571428571,0.15026505359250994,0.766819609609959
19,124,7,150,0.13286713286713286,0.9533333333333334,0.1345521950225085,0.7910697872929724
37,78,2,117,0.3217391304347826,0.9829059829059829,0.13861016603700127,0.8061716445000927
63,154,7,224,0.2903225806451613,0.96875,0.1541107944408555,0.823685380763829
10,91,1,102,0.09900990099009901,0.9901960784313726,0.16825506601086962,0.9367972921950682
4,55,1,60,0.06779661016949153,0.9833333333333333,0.15800674121780695,0.96137051771169
1,29,9,39,0.03333333333333333,0.7692307692307693,0.15319163081610437,0.9471274791968068
5,154,4,163,0.031446540880503145,0.9754601226993865,0.1395021756172152,0.9461728028477395
16,108,16,140,0.12903225806451613,0.8857142857142857,0.13895433635969853,0.9365129389021613
34,82,25,141,0.29310344827586204,0.8226950354609929,0.13486352462270987,0.9136256606957341
11,96,2,109,0.102803738317757,0.981651376146789,0.10807511857593784,0.9154687144309898
7,57,2,66,0.109375,0.9696969696969697,0.10955584700592369,0.9125402703260751
13,108,12,133,0.10743801652892562,0.9097744360902256,0.11521890505727142,0.9020318564342025
11,38,1,50,0.22448979591836735,0.98,0.14252697114084772,0.9321417465440927
16,83,1,100,0.16161616161616163,0.99,0.16112263124594176,0.9342188718727517
3,23,4,30,0.11538461538461539,0.8666666666666667,0.15917296800595596,0.9314977834373775
6,77,13,96,0.07228915662650602,0.8645833333333334,0.1276280691989051,0.9374818259905692
21,33,2,56,0.3888888888888889,0.9642857142857143,0.16849737642335252,0.9350010171532726
0,4,58,62,0.0,0.06451612903225806,0.15287237642335252,0.8056894684868852
6,190,13,209,0.030612244897959183,0.937799043062201,0.1418972661903573,0.8096929837685961
25,197,14,236,0.11261261261261261,0.940677966101695,0.12591481143239233,0.8040755503545525
41,95,13,149,0.3014705882352941,0.912751677852349,0.14589401523512555,0.7930400757620308
8,50,7,65,0.13793103448275862,0.8923076923076924,0.14911493224914601,0.7967030794250346
32,189,6,227,0.14479638009049775,0.973568281938326,0.15947310702971626,0.8122723577971765
0,12,53,65,0.0,0.18461538461538463,0.10391755147416071,0.7008908821299864
6,6,3,15,0.5,0.8,0.17534612290273216,0.8059600065539497
24,59,5,88,0.2891566265060241,0.9431818181818182,0.21228103456102712,0.8067289744281807
2,60,3,65,0.03225806451612903,0.9538461538461539,0.2008018134043866,0.8086101441059605
41,70,32,143,0.36936936936936937,0.7762237762237763,0.21050163928068308,0.7891061581590215
20,124,452,596,0.1388888888888889,0.24161073825503357,0.21063847562441598,0.6961494504372131
1,50,9,60,0.0196078431372549,0.85,0.19275439891680987,0.6784968387317379
21,65,20,106,0.2441860465116279,0.8113207547169812,0.22763811984704244,0.7680261773176804
2,0,0,2,1.0,1.0,0.29906669127561386,0.7965976058891089
2,14,1,17,0.125,0.9411764705882353,0.27561574463189614,0.7963111276614541
21,82,2,105,0.20388349514563106,0.9809523809523809,0.3001336632932535,0.8001834458194865
30,96,24,150,0.23809523809523808,0.84,0.28138021596837764,0.8092943349303757
22,37,4,63,0.3728813559322034,0.9365079365079365,0.3148077112602797,0.9085653632522189
11,18,2,31,0.3793103448275862,0.9354838709677419,0.36619378293032706,0.9207773448190393
2,21,1,24,0.08695652173913043,0.9583333333333334,0.3296245667416476,0.9417791417642325
36,61,20,117,0.3711340206185567,0.8290598290598291,0.2397865696871556,0.917359117344208
20,88,2,110,0.18518518518518517,0.9818181818181818,0.2573130247136106,0.9231650760913431
0,1,0,1,0.0,1.0,0.22957377367338871,0.9258861645267172
37,85,3,125,0.30327868852459017,0.976,0.23775190831522358,0.9453147359552888
121,259,36,416,0.31842105263157894,0.9134615384615384,0.22997186498656294,0.9420223933772319
11,74,20,105,0.12941176470588237,0.8095238095238095,0.19919817620070376,0.9240280988852417
0,35,5,40,0.0,0.875,0.18677581595225656,0.9121233369804796
0,12,2,14,0.0,0.8571428571428571,0.13375667014960563,0.916135198135198
2,12,2,16,0.14285714285714285,0.875,0.12770980695988526,0.9008754578754576
51,159,58,268,0.24285714285714285,0.7835820895522388,0.16240368451090567,0.8699586135257775
44,105,22,171,0.2953020134228188,0.8713450292397661,0.1612641594963669,0.8550079034171727
5,17,4,26,0.22727272727272727,0.8461538461538461,0.14824297015938812,0.845392518801788
4,27,95,126,0.12903225806451613,0.24603174603174602,0.1481887549249072,0.7648936525886362
6,37,10,53,0.13953488372093023,0.8113207547169812,0.16812230974218295,0.7557966175482049
12,167,27,206,0.0670391061452514,0.8689320388349514,0.17769932490579032,0.7574807863613613
20,145,3,168,0.12121212121212122,0.9821428571428571,0.17460717895650152,0.7727869088103408
21,122,7,150,0.14685314685314685,0.9533333333333334,0.16089232238450207,0.7970370864933543
39,76,2,117,0.3391304347826087,0.9829059829059829,0.16715352543590065,0.8129743655885281
63,154,7,224,0.2903225806451613,0.96875,0.17616064734624834,0.8304881018522644
10,91,1,102,0.09900990099009901,0.9901960784313726,0.17187173919276022,0.9367972921950682
5,54,1,60,0.0847457627118644,0.9833333333333333,0.1640447219057508,0.9613705177116899
1,29,9,39,0.03333333333333333,0.7692307692307693,0.15922961150404819,0.9471274791968067
5,154,4,163,0.031446540880503145,0.9754601226993865,0.14640595717095992,0.9461728028477395
16,108,16,140,0.12903225806451613,0.8857142857142857,0.14386011591544126,0.9365129389021615
34,81,26,141,0.2956521739130435,0.8156028368794326,0.13764893579121765,0.9126124894697971
12,95,2,109,0.11214953271028037,0.981651376146789,0.1121956432290918,0.9144555432050526
7,57,2,66,0.109375,0.9696969696969697,0.11367637165907765,0.911527099100138
14,107,12,133,0.11570247933884298,0.9097744360902256,0.11809875974864602,0.9010186852082654
12,37,1,50,0.24489795918367346,0.98,0.14832227772726606,0.9311285753181554
15,84,1,100,0.15151515151515152,0.99,0.16547493638935867,0.9332057006468145
3,23,4,30,0.11538461538461539,0.8666666666666667,0.16352527314937282,0.9304846122114403
6,76,14,96,0.07317073170731707,0.8541666666666666,0.1317422099771262,0.9359937307524737
19,35,2,56,0.35185185185185186,0.9642857142857143,0.16598539842592214,0.9335129219151774
0,4,58,62,0.0,0.06451612903225806,0.15036039842592214,0.80420137324879
7,189,13,209,0.03571428571428571,0.937799043062201,0.13893351362241396,0.8082048885305008
27,195,14,236,0.12162162162162163,0.940677966101695,0.12132260825640655,0.8025874551164572
43,93,13,149,0.3161764705882353,0.912751677852349,0.14484565383827566,0.7915519805239357
6,52,7,65,0.10344827586206896,0.8923076923076924,0.14314046247791187,0.7952149841869394
29,193,6,228,0.13063063063063063,0.9736842105263158,0.15134901946695667,0.812288919024032
0,13,52,65,0.0,0.2,0.10108446920240642,0.7031052455546443
6,6,3,15,0.5,0.8,0.17251304063097783,0.8081743699786076
24,59,5,88,0.2891566265060241,0.9431818181818182,0.20871908931551192,0.8089433378528385
2,60,3,65,0.03225806451612903,0.9538461538461539,0.1959528668718701,0.8108245075306184
35,78,32,145,0.30973451327433627,0.7793103448275862,0.19503258725559883,0.7917614599556523
20,124,452,596,0.1388888888888889,0.24161073825503357,0.20009553197371593,0.6988047522338439
1,50,9,60,0.0196078431372549,0.85,0.18423513376037653,0.681135579301513
20,66,20,106,0.23255813953488372,0.8113207547169812,0.21745772512250278,0.7684671156896531
2,0,0,2,1.0,1.0,0.28888629655107423,0.7970385442610818
2,14,1,17,0.125,0.9411764705882353,0.26543534990735645,0.7967520660334271
22,81,2,105,0.21359223300970873,0.9809523809523809,0.29134023112072505,0.8006243841914594
30,96,24,150,0.23809523809523808,0.84,0.2811060489522824,0.8092943349303757
22,37,4,63,0.3728813559322034,0.9365079365079365,0.31453354424418445,0.908565363252219
11,18,2,31,0.3793103448275862,0.9354838709677419,0.36591961591423183,0.9207773448190393
2,21,1,24,0.08695652173913043,0.9583333333333334,0.24062779655414848,0.9417791417642324
35,61,21,117,0.3645833333333333,0.8205128205128205,0.22128255845891037,0.916138116123207
24,84,2,110,0.2222222222222222,0.9818181818181818,0.24410001877637066,0.921944074870342
0,1,0,1,0.0,1.0,0.22052165539218205,0.9246651633057162
34,88,3,125,0.2786885245901639,0.976,0.2263206963200286,0.9440937347342876
121,258,37,416,0.31926121372031663,0.9110576923076923,0.22108198351009806,0.9404579855628242
12,73,20,105,0.1411764705882353,0.8095238095238095,0.2018411837419149,0.9224636910708338
0,35,5,40,0.0,0.875,0.1894188234934677,0.910558929166072
0,12,2,14,0.0,0.8571428571428571,0.13733549016013438,0.9157917915417915
2,12,2,16,0.14285714285714285,0.875,0.12599762167940876,0.900532051282051
53,156,59,268,0.2535885167464115,0.7798507462686567,0.16222455264318184,0.8690821578918593
43,105,23,171,0.2905405405405405,0.8654970760233918,0.1639176977789499,0.8532960258952009
3,19,4,26,0.13636363636363635,0.8461538461538461,0.13778947244228132,0.8440240478732228
3,30,93,126,0.09090909090909091,0.2619047619047619,0.13060841820240354,0.765792755356216
6,37,10,53,0.13953488372093023,0.8113207547169812,0.15054197301967928,0.7566957203157848
11,168,27,206,0.061452513966480445,0.8689320388349514,0.15932090358631937,0.7583798891289412
22,143,3,168,0.13333333333333333,0.9821428571428571,0.15796035936863229,0.7736860115779207
24,119,7,150,0.16783216783216784,0.9533333333333334,0.1457094523808832,0.7984692383014459
41,74,2,117,0.3565217391304348,0.9829059829059829,0.15513533789372522,0.8152419392846733
63,154,7,224,0.2903225806451613,0.96875,0.17712947279108593,0.8327556755484096
10,91,1,102,0.09900990099009901,0.9901960784313726,0.1782867313740871,0.9367972921950682
4,55,1,60,0.06779661016949153,0.9833333333333333,0.1680384065810244,0.9613705177116899
1,29,9,39,0.03333333333333333,0.7692307692307693,0.1640213807762891,0.9471274791968067
5,150,8,163,0.03225806451612903,0.950920245398773,0.14958205665954563,0.9426671060905091
14,99,27,140,0.12389380530973451,0.8071428571428572,0.14330514772776945,0.9217827523490124
37,79,25,141,0.31896551724137934,0.8226950354609929,0.13793997317219012,0.8988954741425853
15,92,2,109,0.14018691588785046,0.981651376146789,0.11649202106400283,0.9007385278778409
8,56,1,65,0.125,0.9846153846153847,0.12020489235113155,0.8999412859041284
14,107,12,133,0.11570247933884298,0.9097744360902256,0.1270485879467532,0.8894328720122557
12,37,1,50,0.24489795918367346,0.98,0.15727210592537322,0.9195427621221459
16,83,1,100,0.16161616161616163,0.99,0.17575183408252074,0.9251255842080355
5,21,4,30,0.19230769230769232,0.8666666666666667,0.1855252465108004,0.9336289855685797
6,77,13,96,0.07228915662650602,0.8645833333333334,0.15028576642296135,0.9396130281217713
21,34,1,56,0.38181818181818183,0.9821428571428571,0.184804518698723,0.939683239692638
0,4,58,62,0.0,0.06451612903225806,0.16694737584158012,0.8082404888950485
7,189,13,209,0.03571428571428571,0.937799043062201,0.15552049103807195,0.8122440041767592
26,194,16,236,0.11818181818181818,0.9322033898305084,0.13741818518066404,0.8054159170096892
51,95,3,149,0.3493150684931507,0.9798657718120806,0.16423231473451963,0.8039681701257005
7,51,7,65,0.1206896551724138,0.8923076923076924,0.154001166572337,0.8076311737887043
31,191,6,228,0.13963963963963963,0.9736842105263158,0.16362266414564178,0.8232170133877018
0,12,53,65,0.0,0.18461538461538463,0.10907720960018723,0.7092845173123485
7,6,2,15,0.5384615384615384,0.8666666666666667,0.18600028652326417,0.8238774512601212
24,59,5,88,0.2891566265060241,0.9431818181818182,0.22220633520779823,0.8246464191343523
2,60,3,65,0.03225806451612903,0.9538461538461539,0.2099315132555569,0.8277382425651588
37,76,32,145,0.3274336283185841,0.7793103448275862,0.20680559323061878,0.7990874672816596
20,109,467,596,0.15503875968992248,0.21644295302013422,0.2117126081616915,0.7025353616691513
1,50,9,60,0.0196078431372549,0.85,0.19456520866135082,0.6848661887368205
20,66,20,106,0.23255813953488372,0.8113207547169812,0.22778780002347707,0.7743955273227627
2,0,0,2,1.0,1.0,0.293721865957543,0.7934431463703818
1,15,1,17,0.0625,0.9411764705882353,0.26134234788525385,0.7931566681427272
20,83,2,105,0.1941747572815534,0.9809523809523809,0.2844733039946002,0.7970289863007596
31,95,24,150,0.24603174603174602,0.84,0.27284446366790904,0.8056989370396758
22,37,4,63,0.3728813559322034,0.9365079365079365,0.30396483455966344,0.908565363252219
10,19,2,31,0.3448275862068966,0.9354838709677419,0.35042479785532654,0.9207773448190393
2,21,1,24,0.08695652173913043,0.9583333333333334,0.28913620344663665,0.9427315227166134
36,62,19,117,0.3673469387755102,0.8376068376068376,0.198757194700281,0.9195324995175902
24,84,2,110,0.2222222222222222,0.9818181818181818,0.22157465501774132,0.9253384582647255
0,1,0,1,0.0,1.0,0.1979962916335527,0.9280595467000996
35,87,3,125,0.28688524590163933,0.976,0.2131081321616834,0.94653573717629
120,261,35,416,0.31496062992125984,0.9158653846153846,0.20725505023760185,0.9435868011916397
12,73,20,105,0.1411764705882353,0.8095238095238095,0.2027925755925714,0.9255925066996494
0,35,5,40,0.0,0.875,0.1903702153441242,0.9136877447948875
0,12,2,14,0.0,0.8571428571428571,0.13789208123333704,0.9164786047286047
2,12,2,16,0.14285714285714285,0.875,0.12655421275261142,0.9012188644688643
54,153,59,266,0.2608695652173913,0.7781954887218046,0.16382129349795305,0.8695325057148364
41,107,23,171,0.27702702702702703,0.8654970760233918,0.16241297651586556,0.8537463737181781
6,16,4,26,0.2727272727272727,0.8461538461538461,0.15637963977386743,0.8437875825093869
3,29,94,126,0.09375,0.25396825396825395,0.1496044296898338,0.7644225031443075
6,37,10,53,0.13953488372093023,0.8113207547169812,0.16953798450710952,0.7553254681038764
13,166,27,206,0.07262569832402235,0.8689320388349514,0.17991308426768418,0.7570096369170326
20,145,3,168,0.12121212121212122,0.9821428571428571,0.17682093831839538,0.772315759366012
27,116,7,150,0.1888111888111888,0.9533333333333334,0.16652688454608072,0.7973354514533735
40,75,2,117,0.34782608695652173,0.9829059829059829,0.17664103596457997,0.8141081524366006
63,154,7,224,0.2903225806451613,0.96875,0.1791546513814212,0.8316218887003372
10,91,1,102,0.09900990099009901,0.9901960784313726,0.1799060658085782,0.9367972921950682
3,56,1,60,0.05084745762711865,0.9833333333333333,0.16723643350946224,0.9613705177116899
1,29,9,39,0.03333333333333333,0.7692307692307693,0.16162323851079238,0.9471274791968067
5,154,4,163,0.031446540880503145,0.9754601226993865,0.14879958417770411,0.9461728028477395
16,107,17,140,0.13008130081300814,0.8785714285714286,0.140409600177964,0.935492530738896
38,78,25,141,0.3275862068965517,0.8226950354609929,0.13751818874082541,0.9126052525324689
15,92,2,109,0.14018691588785046,0.981651376146789,0.11607023663263816,0.9144483062677243
8,56,1,65,0.125,0.9846153846153847,0.11978310791976687,0.9136510642940119
13,108,12,133,0.10743801652892562,0.9097744360902256,0.12786747347716787,0.9031426504021394
12,37,1,50,0.24489795918367346,0.98,0.1580909914557879,0.9332525405120295
18,81,1,100,0.18181818181818182,0.99,0.17957265444688483,0.9353296658406886
4,22,4,30,0.15384615384615385,0.8666666666666667,0.18296763345161993,0.9336289855685797
8,76,12,96,0.09523809523809523,0.875,0.14977504607184047,0.9411011233598664
24,31,1,56,0.43636363636363634,0.9821428571428571,0.1920860061398099,0.9411713349307333
0,4,58,62,0.0,0.06451612903225806,0.174228863282667,0.8097285841331437
8,188,13,209,0.04081632653061224,0.937799043062201,0.16471147899719366,0.8137320994148546
24,196,16,236,0.10909090909090909,0.9322033898305084,0.14531047184108448,0.8069040122477843
56,90,3,149,0.3835616438356164,0.9798657718120806,0.17413096641500367,0.8054562653637959
7,51,7,65,0.1206896551724138,0.8923076923076924,0.16939432374732655,0.8091192690267995
31,191,6,228,0.13963963963963963,0.9736842105263158,0.1757374015189757,0.8232170133877018
0,12,53,65,0.0,0.18461538461538463,0.1133997391813134,0.7092845173123487
6,6,3,15,0.5,0.8,0.18482831060988483,0.8143536417363118
23,60,5,88,0.27710843373493976,0.9431818181818182,0.21858432592478877,0.8151226096105428
3,59,3,65,0.04838709677419355,0.9538461538461539,0.20991235273668654,0.8182144330413493
42,71,32,145,0.37168141592920356,0.7793103448275862,0.20821517732148467,0.7895636577578501
16,113,467,596,0.12403100775193798,0.21644295302013422,0.20869251340427386,0.6930115521453418
1,50,9,60,0.0196078431372549,0.85,0.19154511390393322,0.6753423792130109
20,66,20,106,0.23255813953488372,0.8113207547169812,0.22476770526605946,0.7648717177989531
1,1,0,2,0.5,1.0,0.22476770526605946,0.7934431463703818
1,15,1,17,0.0625,0.9411764705882353,0.19410935758963951,0.793156668142727
17,86,2,105,0.1650485436893204,0.9809523809523809,0.21077527857751474,0.7970289863007595
30,96,24,150,0.23809523809523808,0.84,0.19169153888694826,0.8056989370396758
21,38,4,63,0.3559322033898305,0.9365079365079365,0.2248202811209329,0.9085653632522189
8,21,2,31,0.27586206896551724,0.9354838709677419,0.2614280276678275,0.9207773448190393
2,21,1,24,0.08695652173913043,0.9583333333333334,0.3005177445579071,0.9403792942953654
37,63,17,117,0.37,0.8547008547008547,0.21051774455790703,0.9196222735383445
20,88,2,110,0.18518518518518517,0.9818181818181818,0.22804419958436206,0.9254282322854799
0,1,0,1,0.0,1.0,0.19854109399429998,0.9284677459632914
36,86,3,125,0.29508196721311475,0.976,0.2140612781724447,0.9483421127312752
116,265,35,416,0.30446194225721784,0.9158653846153846,0.20912969123098188,0.9453931767466248
8,77,20,105,0.09411764705882353,0.8095238095238095,0.1908290376362106,0.9280345091416518
0,35,5,40,0.0,0.875,0.17840667738776342,0.91612974723689
0,13,1,14,0.0,0.9285714285714286,0.12554953453062057,0.9266826863612577
2,13,1,16,0.13333333333333333,0.9375,0.11814212712321316,0.9203515175300888
55,156,55,266,0.26066350710900477,0.793233082706767,0.15537977099592812,0.8908133864881984
45,102,23,170,0.30612244897959184,0.8647058823529412,0.15695698267685346,0.8749142268243328
6,20,0,26,0.23076923076923078,1.0,0.14642945246428382,0.8869334575935637
3,56,67,126,0.05084745762711865,0.46825396825396826,0.14024799683118316,0.8381806231264434
6,44,3,53,0.12,0.9433962264150944,0.1573908539740403,0.847951512614314
12,167,27,206,0.0670391061452514,0.8689320388349514,0.16696786913764766,0.8394315997948174
23,142,3,168,0.1393939393939394,0.9821428571428571,0.16783367000344854,0.8458091508152255
24,119,7,150,0.16783216783216784,0.9533333333333334,0.1545720501067575,0.8686806151904491
31,84,2,117,0.26956521739130435,0.9829059829059829,0.14934958845128787,0.8855663438408837
61,156,7,224,0.28110599078341014,0.96875,0.1565405541675992,0.881102058126598
10,91,1,102,0.09900990099009901,0.9901960784313726,0.16342090321945357,0.95566521672337
3,56,1,60,0.05084745762711865,0.9833333333333333,0.1535419685947562,0.9613705177116899
0,30,9,39,0.0,0.7692307692307693,0.14396495343114887,0.9471274791968067
5,154,4,163,0.031446540880503145,0.9754601226993865,0.12854389650065798,0.9461728028477395
17,108,15,140,0.136,0.8928571428571429,0.12399644395320543,0.9375333470654267
37,79,25,141,0.31896551724137934,0.8226950354609929,0.13105362964607328,0.9146460688589996
17,90,2,109,0.1588785046728972,0.981651376146789,0.11359256020171428,0.9164891225942551
8,56,1,65,0.125,0.9846153846153847,0.117305431488843,0.9156918806205425
14,68,51,133,0.17073170731707318,0.6165413533834586,0.1344317528731222,0.863293026341989
12,37,1,50,0.24489795918367346,0.98,0.16941717561364703,0.8934029164518791
16,84,0,100,0.16,1.0,0.18778195548786084,0.8969086132091096
5,21,4,30,0.19230769230769232,0.8666666666666667,0.19582591153181686,0.8931671166104701
8,81,7,96,0.0898876404494382,0.9270833333333334,0.16310050056153957,0.908079730592233
23,32,1,56,0.41818181818181815,0.9821428571428571,0.200143831062814,0.9081499421631
0,4,58,62,0.0,0.06451612903225806,0.18228668820567112,0.7767071913655104
6,193,9,208,0.03015075376884422,0.9567307692307693,0.1622036948416384,0.8253056793436977
26,197,13,236,0.11659192825112108,0.9449152542372882,0.1438742618512738,0.8202935728061674
55,92,2,149,0.3741496598639456,0.9865771812080537,0.17446707040326603,0.8183760272644608
7,56,2,65,0.1111111111111111,0.9692307692307692,0.16286755880375445,0.8330280419164754
30,192,6,228,0.13513513513513514,0.9736842105263158,0.16933148661599687,0.8396853100869015
5,59,1,65,0.078125,0.9846153846153847,0.1207519411614514,0.8400385282972627
6,7,2,15,0.46153846153846156,0.8666666666666667,0.18668600709551736,0.9546314622450353
24,59,5,88,0.2891566265060241,0.9431818181818182,0.2236868460579716,0.9526958978094707
2,60,3,65,0.03225806451612903,0.9538461538461539,0.211639151238687,0.9539717406107373
44,73,28,145,0.37606837606837606,0.8068965517241379,0.21191325355360568,0.9283030792558922
16,120,460,596,0.11764705882352941,0.22818791946308725,0.2128469603696654,0.8224398150033662
1,50,9,60,0.0196078431372549,0.85,0.1963430615128254,0.8047706420710353
21,65,20,106,0.2441860465116279,0.8113207547169812,0.22006606815734367,0.7800142663712634
2,0,0,2,1.0,1.0,0.29698914508042057,0.7990618854188825
1,15,1,17,0.0625,0.9411764705882353,0.26460962700813145,0.7987754071912277
17,86,2,105,0.1650485436893204,0.9809523809523809,0.2835796954614445,0.8026477253492602
23,104,23,150,0.18110236220472442,0.8466666666666667,0.2557274077666371,0.8083291703410501
21,38,4,63,0.3559322033898305,0.9365079365079365,0.28976814270468015,0.9095177442046001
5,24,2,31,0.1724137931034483,0.9354838709677419,0.31159756412842204,0.9217297257714202
2,19,1,22,0.09523809523809523,0.9545454545454546,0.23114076753275656,0.9398381687542398
36,59,21,116,0.37894736842105264,0.8189655172413793,0.21384753445004975,0.9139760997887226
19,75,2,96,0.20212765957446807,0.9791666666666666,0.23379434296068807,0.91940327065707
0,1,0,1,0.0,1.0,0.20584403240168186,0.9224427843348815
35,70,3,108,0.3333333333333333,0.9722222222222222,0.22682869745414352,0.9417774685631828
113,229,35,377,0.3304093567251462,0.9071618037135278,0.2231825765020458,0.9375851638782672
6,71,20,97,0.07792207792207792,0.7938144329896907,0.20256827017345372,0.9179822996255629
0,28,5,33,0.0,0.8484848484848485,0.18896282799658298,0.9028307844740479
0,12,2,14,0.0,0.8571428571428571,0.1348274896507183,0.9082846901742588
1,8,2,11,0.1111111111111111,0.8181818181818182,0.12182512558452448,0.8852868546764234
50,132,58,240,0.27472527472527475,0.7583333333333333,0.16107159340242086,0.8507630451526139
43,91,23,157,0.3208955223880597,0.8535031847133758,0.15929476326738176,0.83380318265135
3,17,4,24,0.15,0.8333333333333334,0.1335219980209323,0.8232562583113223
2,27,93,122,0.06896551724137931,0.23770491803278687,0.13224248935226107,0.7438120418889075
4,35,10,49,0.10256410256410256,0.7959183673469388,0.14689450400427573,0.7363025445834918
15,148,24,187,0.09202453987730061,0.8716577540106952,0.1600408668438901,0.7383761012788972
21,110,3,134,0.16030534351145037,0.9776119402985075,0.16706861432965286,0.7611518330098529
21,116,7,144,0.15328467153284672,0.9513888888888888,0.14971995673073457,0.7887311980892179
27,77,2,106,0.25961538461538464,0.9811320754716981,0.14096565133463815,0.8069638967689784
61,156,7,224,0.28110599078341014,0.96875,0.15969507858941098,0.8263091348642163
5,77,1,83,0.06097560975609756,0.9879518072289156,0.15855366323437073,0.9334872618922347
5,43,5,53,0.10416666666666667,0.9056603773584906,0.15878260096330848,0.949164691893885
1,27,8,36,0.03571428571428571,0.7777777777777778,0.15073827894002065,0.9357532667177539
5,150,4,159,0.03225806451612903,0.9748427672955975,0.1324458105121176,0.935357670574481
17,98,16,131,0.14782608695652175,0.8778625954198473,0.13166601271549974,0.9248539143646181
32,67,26,125,0.32323232323232326,0.792,0.14075414680363382,0.8978350464400897
21,79,2,102,0.21,0.9803921568627451,0.13059614812028952,0.8994982117061961
8,55,1,64,0.12698412698412698,0.984375,0.1400259362957223,0.8989872392449225
11,58,51,120,0.15942028985507245,0.575,0.1479193110369231,0.8517500424794238
10,36,1,47,0.21739130434782608,0.9787234042553191,0.17387317084171458,0.8804565605476441
14,84,1,99,0.14285714285714285,0.98989898989899,0.18967303917614517,0.8826074494909858
4,21,4,29,0.16,0.8620689655172413,0.19141216961092775,0.8803512166477565
7,60,14,81,0.1044776119402985,0.8271604938271605,0.16016149656920994,0.8853741443373506
21,30,1,52,0.4117647058823529,0.9807692307692307,0.18898502598097464,0.8854280120382773
0,2,58,60,0.0,0.03333333333333333,0.17084443641181363,0.7495649168001819
6,165,9,180,0.03508771929824561,0.95,0.1530826406179812,0.8031363453716106
24,161,15,200,0.12972972972972974,0.925,0.14055955852968177,0.7954615733351363
52,82,3,137,0.3880597014925373,0.9781021897810219,0.17558849547759525,0.7937763161754268
6,50,7,63,0.10714285714285714,0.8888888888888888,0.168037475069432,0.7976077337999478
27,179,6,212,0.13106796116504854,0.9716981132075472,0.17183609638725342,0.8182559651400031
0,16,49,65,0.0,0.24615384615384617,0.11301256697548871,0.7133109101949481
6,6,2,14,0.5,0.8571428571428571,0.18444113840406015,0.8309979850248801
24,47,5,76,0.3380281690140845,0.9342105263157895,0.22771834550632283,0.8287423459271357
1,60,3,64,0.01639344262295082,0.953125,0.21152744734821155,0.8327602030699929
42,69,32,143,0.3783783783783784,0.7762237762237763,0.21014440118904604,0.8039204297046721
16,80,411,507,0.16666666666666666,0.1893491124260355,0.21864780254959024,0.7039861759242644
1,44,9,54,0.022222222222222223,0.8333333333333334,0.20309841127204362,0.6842197787993767
19,61,20,100,0.2375,0.8,0.23702698270061506,0.7633406579202557
2,0,0,2,1.0,1.0,0.30845555412918646,0.783748821185562
1,15,1,17,0.0625,0.9411764705882353,0.2690943871271744,0.7847439560816257
19,73,2,94,0.20652173913043478,0.9787234042553191,0.29625557234252925,0.7884008709752427
22,96,23,141,0.1864406779661017,0.8368794326241135,0.26883590085506115,0.7970659647467194
20,39,4,63,0.3389830508474576,0.9365079365079365,0.2934525271666027,0.9038029396155624
6,21,2,29,0.2222222222222222,0.9310344827586207,0.3220239557380313,0.9177602466763178
2,20,1,23,0.09090909090909091,0.9565217391304348,0.2697094083849426,0.9415203425923898
37,59,20,116,0.3854166666666667,0.8275862068965517,0.18191178933732358,0.9168898007204687
21,73,2,96,0.22340425531914893,0.9791666666666666,0.2048981115257734,0.9223169715888159
34,72,3,109,0.32075471698113206,0.9724770642201835,0.22714185056746078,0.9211062120556449
113,231,35,379,0.32848837209302323,0.9076517150395779,0.25366059760115794,0.9307707427755846
5,73,20,98,0.0641025641025641,0.7959183673469388,0.2264984941678681,0.9106865186097277
0,28,5,33,0.0,0.8484848484848485,0.20186795229594692,0.8982580868264574
0,12,2,14,0.0,0.8571428571428571,0.18888093930893393,0.8840611036853747
1,8,2,11,0.1111111111111111,0.8181818181818182,0.149694431372426,0.8827176195832699
49,132,59,240,0.27071823204419887,0.7541666666666667,0.156453570904576,0.8505747624404129
42,92,23,157,0.31343283582089554,0.8535031847133758,0.15540758788168504,0.8335784939394404
3,17,4,24,0.15,0.8333333333333334,0.12990924901125317,0.8229615822671196
3,28,91,122,0.0967741935483871,0.2540983606557377,0.1345766246463707,0.7455587241683767
5,34,10,49,0.1282051282051282,0.7959183673469388,0.15289164296138905,0.7380492268629609
12,150,26,188,0.07407407407407407,0.8617021276595744,0.16347365354339963,0.7387005512224921
20,110,3,133,0.15384615384615385,0.9774436090225563,0.16957865964840574,0.7614522356283118
19,118,7,144,0.1386861313868613,0.9513888888888888,0.1507169309830718,0.789626838802915
29,75,2,106,0.27884615384615385,0.9811320754716981,0.14577597641525156,0.8078595374826752
62,155,7,224,0.2857142857142857,0.96875,0.16516373151729238,0.8272047755779134
6,76,1,83,0.07317073170731707,0.9879518072289156,0.16179180839713952,0.9320409822312244
4,48,1,53,0.07692307692307693,0.9811320754716981,0.1544658010711322,0.9585000833919043
2,27,8,37,0.06896551724137931,0.7837837837837838,0.15373600723789008,0.9473688914096486
5,151,4,160,0.03205128205128205,0.975,0.13633673983862268,0.9470198044064262
16,99,16,131,0.1391304347826087,0.8778625954198473,0.13640021175230088,0.9365160481965632
34,67,24,125,0.33663366336633666,0.808,0.14465557025518413,0.9117828945577491
18,82,2,102,0.18,0.9803921568627451,0.12955352943885762,0.9134460598238555
8,55,1,64,0.12698412698412698,0.984375,0.13724115733554473,0.9129350873625819
10,60,50,120,0.14285714285714285,0.5833333333333334,0.14666030961183987,0.8561066956285298
10,36,1,47,0.21739130434782608,0.9787234042553191,0.1678639934841894,0.8839552128387492
14,82,2,98,0.14583333333333334,0.9795918367346939,0.18411857223876818,0.884611189515134
3,22,4,29,0.12,0.8620689655172413,0.18138565298410977,0.8823549566719046
7,61,13,81,0.10294117647058823,0.8395061728395061,0.14800101199900287,0.8868558385061197
21,30,1,52,0.4117647058823529,0.9807692307692307,0.18111025569648184,0.8869097062070462
0,2,58,60,0.0,0.03333333333333333,0.16296966612732083,0.751046610968951
5,162,13,180,0.029940119760479042,0.9277777777777778,0.14683866282779748,0.8002529601753002
22,161,16,199,0.12021857923497267,0.9195979899497487,0.1329568449545327,0.7918064724173616
49,86,3,138,0.362962962962963,0.9782608695652174,0.1639753634730512,0.7916163342502935
7,49,7,63,0.125,0.8888888888888888,0.16468964918733692,0.7954477518748145
27,179,6,212,0.13106796116504854,0.9716981132075472,0.16870776128654552,0.8143323147845347
0,14,51,65,0.0,0.2153846153846154,0.10988423187478083,0.7049916554438754
6,6,2,14,0.5,0.8571428571428571,0.18131280330335225,0.8226787302738073
23,48,5,76,0.323943661971831,0.9342105263157895,0.2233133093335454,0.8235976943506661
0,61,3,64,0.0,0.953125,0.20613922658569214,0.8283872672149878
41,68,32,141,0.3761467889908257,0.7730496453900709,0.20802263030395826,0.7990713780471097
16,81,410,507,0.16494845360824742,0.1913214990138067,0.21372955224799361,0.6994188937792408
1,44,9,54,0.022222222222222223,0.8333333333333334,0.198180160970447,0.6796524966543531
19,61,20,100,0.2375,0.8,0.23210873239901844,0.7631689801708367
1,1,0,2,0.5,1.0,0.23210873239901844,0.7835771434361429
1,15,1,17,0.0625,0.9411764705882353,0.194759637831614,0.7845722783322063
18,74,2,94,0.1956521739130435,0.9787234042553191,0.22270994839062022,0.7882291932258235
22,96,23,141,0.1864406779661017,0.8368794326241135,0.19560907538708822,0.7973477342592581
21,38,4,63,0.3559322033898305,0.9365079365079365,0.22289246821302866,0.9038029396155624
6,21,2,29,0.2222222222222222,0.9310344827586207,0.25146389678445724,0.9177602466763178
2,21,1,24,0.08695652173913043,0.9583333333333334,0.2656603629413112,0.9408267608118515
35,59,23,117,0.3723404255319149,0.8034188034188035,0.17599470944587045,0.9127437327288234
20,88,2,110,0.18518518518518517,0.9818181818181818,0.19352116447232545,0.9185496914759587
34,89,3,126,0.2764227642276423,0.9761904761904762,0.20943176740637146,0.9178694193671151
107,273,35,415,0.28157894736842104,0.9156626506024096,0.23022875988757446,0.9296307504055547
6,80,20,106,0.06976744186046512,0.8113207547169812,0.20145461719936003,0.9117468672925609
0,35,5,40,0.0,0.875,0.18175018370182308,0.9031063142971691
0,12,2,14,0.0,0.8571428571428571,0.16932782345337588,0.8886505319842442
2,12,2,16,0.14285714285714285,0.875,0.13654449735697988,0.8988764172101293
46,164,58,268,0.21904761904761905,0.7835820895522388,0.14138198790875614,0.8705569754578517
43,105,23,171,0.2905405405405405,0.8654970760233918,0.14339881309631305,0.8547436325768396
5,17,4,26,0.22727272727272727,0.8461538461538461,0.13564078165407106,0.8448138033699021
2,31,93,126,0.06060606060606061,0.2619047619047619,0.13433201290344185,0.7663258043967279
5,38,10,53,0.11627906976744186,0.8113207547169812,0.15094330858450497,0.7572287693562966
9,168,27,204,0.05084745762711865,0.8676470588235294,0.1582072311026648,0.7587293695963926
23,141,3,167,0.1402439024390244,0.9820359281437125,0.1578339110429336,0.7740202164740657
17,126,7,150,0.11888111888111888,0.9533333333333334,0.14352441101914784,0.7982703941570793
22,93,2,117,0.19130434782608696,0.9829059829059829,0.12934781205994017,0.8150430951403067
60,158,6,224,0.27522935779816515,0.9732142857142857,0.13619875927785988,0.8331945865060837
12,89,1,102,0.1188118811881188,0.9901960784313726,0.14451387650386818,0.9372362031527424
4,51,5,60,0.07272727272727272,0.9166666666666666,0.13829219121241546,0.9522856191455545
2,28,9,39,0.06666666666666667,0.7692307692307693,0.14055207821806517,0.9382261492037317
5,155,4,164,0.03125,0.975609756097561,0.12498152072677597,0.9373081246257099
15,109,16,140,0.12096774193548387,0.8857142857142857,0.1252796097345424,0.9276482606801318
32,84,25,141,0.27586206896551724,0.8226950354609929,0.13735928418303245,0.9047609824737046
16,91,2,109,0.14953271028037382,0.981651376146789,0.1194026202519194,0.9059662811069195
8,56,2,66,0.125,0.9696969696969697,0.12028663722504529,0.9030378370020047
11,109,13,133,0.09166666666666666,0.9022556390977443,0.12299226493067299,0.9009791187778731
11,38,1,50,0.22448979591836735,0.98,0.1455384262523445,0.9310890088877632
12,87,2,101,0.12121212121212122,0.9801980198019802,0.15839015785407612,0.9317444751312516
4,22,4,30,0.15384615384615385,0.8666666666666667,0.16308707384131468,0.9290233866958774
7,76,13,96,0.08433734939759036,0.8645833333333334,0.13572639961732513,0.9350074292490689
19,35,2,56,0.35185185185185186,0.9642857142857143,0.16462913412753627,0.9325266204117725
0,4,58,62,0.0,0.06451612903225806,0.1467719912703934,0.8032150717453851
7,189,13,209,0.03571428571428571,0.937799043062201,0.13877879399148185,0.8082927008831646
22,199,14,235,0.09954751131221719,0.9404255319148936,0.12092989619060326,0.802639205442435
44,93,12,149,0.32116788321167883,0.9194630872483222,0.14949500504768293,0.7939627865061983
8,50,7,65,0.13793103448275862,0.8923076923076924,0.1472214165671979,0.797625790169202
30,192,6,228,0.13513513513513514,0.9736842105263158,0.15447824310113287,0.8132116297681995
0,10,55,65,0.0,0.15384615384615385,0.10421369283658259,0.6974345497054052
7,6,2,15,0.5384615384615384,0.8666666666666667,0.18113676975965953,0.8120274836531778
25,58,5,88,0.30120481927710846,0.9431818181818182,0.21906398884006276,0.8127964515274089
0,62,3,65,0.0,0.9538461538461539,0.20484291579546032,0.8147136832318747
35,76,32,143,0.3153153153153153,0.7762237762237763,0.20400683466740838,0.7942509245140823
14,113,469,596,0.11023622047244094,0.21308724832214765,0.20005043266593442,0.6972194325161473
2,49,9,60,0.0392156862745098,0.85,0.18634765425727368,0.6795502595838165
19,66,20,105,0.2235294117647059,0.8095238095238095,0.21828042736651734,0.7732184961091958
2,0,0,2,1.0,1.0,0.2842144933005833,0.792266115156815
1,15,1,17,0.0625,0.9411764705882353,0.25011380483242496,0.7919796369291603
17,86,2,105,0.1650485436893204,0.9809523809523809,0.2736921682166136,0.7958519550871926
18,108,24,150,0.14285714285714285,0.84,0.24905528643687463,0.8049628441980818
15,44,4,63,0.2542372881355932,0.9365079365079365,0.26962686753161064,0.9083086567960516
5,24,2,31,0.1724137931034483,0.9354838709677419,0.2886551685071733,0.9205206383628718
2,21,1,24,0.08695652173913043,0.9583333333333334,0.26249501565376526,0.9417791417642324
37,60,20,117,0.38144329896907214,0.8290598290598291,0.17412977264934698,0.9173591173442082
19,89,2,110,0.17592592592592593,0.9818181818181818,0.1903334763530507,0.9231650760913432
34,89,3,126,0.2764227642276423,0.9761904761904762,0.2090180043911189,0.9224848039824998
108,276,31,415,0.28125,0.9253012048192771,0.22765462570631162,0.9346706903852536
7,79,20,106,0.08139534883720931,0.8113207547169812,0.19812030508015024,0.9167868072722599
0,35,5,40,0.0,0.875,0.18334197995699753,0.9081462542768682
0,12,2,14,0.0,0.8571428571428571,0.17091961970855032,0.8936904719639431
2,12,2,16,0.14285714285714285,0.875,0.13683588312113187,0.9002533535268247
47,162,59,268,0.22488038277511962,0.7798507462686567,0.14382937695673095,0.8714008627340354
43,105,23,171,0.2905405405405405,0.8654970760233918,0.14584620214428787,0.8555875198530233
5,17,4,26,0.22727272727272727,0.8461538461538461,0.1381351631832489,0.8442807543293903
2,29,95,126,0.06451612903225806,0.24603174603174602,0.13572384606825585,0.7635251816600711
4,39,10,53,0.09302325581395349,0.8113207547169812,0.14901288261310633,0.7544281466196398
11,166,27,204,0.062146892655367235,0.8676470588235294,0.15789101013530166,0.7559287468597358
21,143,3,167,0.12804878048780488,0.9820359281437125,0.15577552979682482,0.7712195937374089
18,125,7,150,0.1258741258741259,0.9533333333333334,0.14163177881096858,0.7960028204609343
26,89,2,117,0.22608695652173913,0.9829059829059829,0.1324241239511398,0.8127755214441615
60,158,6,224,0.27522935779816515,0.9732142857142857,0.1392750711690595,0.8309270128099386
12,89,1,102,0.1188118811881188,0.9901960784313726,0.14703160719132533,0.9372362031527424
5,50,5,60,0.09090909090909091,0.9166666666666666,0.14672958363348781,0.9522856191455545
1,29,9,39,0.03333333333333333,0.7692307692307693,0.14261336087319726,0.9382261492037316
5,155,4,164,0.03125,0.975609756097561,0.1287849636606537,0.9373081246257101
15,109,16,140,0.12096774193548387,0.8857142857142857,0.12808405166941914,0.9276482606801318
35,81,25,141,0.3017241379310345,0.8226950354609929,0.13888936329931847,0.9047609824737046
17,90,2,109,0.1588785046728972,0.981651376146789,0.12226781285285161,0.9059662811069193
8,56,2,66,0.125,0.9696969696969697,0.1231518298259775,0.9030378370020047
11,110,12,133,0.09090909090909091,0.9097744360902256,0.1231518298259775,0.9020532326339418
12,37,1,50,0.24489795918367346,0.98,0.15337534780459752,0.932163122743832
13,86,2,101,0.13131313131313133,0.9801980198019802,0.16767008084933055,0.9328185889873204
4,22,4,30,0.15384615384615385,0.8666666666666667,0.17236699683656914,0.9300975005519462
7,76,13,96,0.08433734939759036,0.8645833333333334,0.1413117413317914,0.9360815431051377
19,35,2,56,0.35185185185185186,0.9642857142857143,0.16887936235735634,0.9336007342678413
0,4,58,62,0.0,0.06451612903225806,0.1510222195002135,0.8042891856014539
7,189,13,209,0.03571428571428571,0.937799043062201,0.14313724732952707,0.8082927008831646
22,198,15,235,0.1,0.9361702127659575,0.12243753887471653,0.802031302706873
43,94,12,149,0.31386861313868614,0.9194630872483222,0.14851689342122437,0.793354883770636
6,52,7,65,0.10344827586206896,0.8923076923076924,0.14131719656635508,0.7970178874336398
30,192,6,228,0.13513513513513514,0.9736842105263158,0.14857402310029008,0.8126037270326371
0,11,54,65,0.0,0.16923076923076924,0.0983094728357398,0.6990244491676451
6,6,3,15,0.5,0.8,0.16973804426431124,0.8040935735916082
25,58,5,88,0.30120481927710846,0.9431818181818182,0.20766526334471447,0.8048625414658392
0,62,3,65,0.0,0.9538461538461539,0.1933795490590002,0.8073876759058672
34,79,32,145,0.3008849557522124,0.7793103448275862,0.19152474086093255,0.7873658555600479
23,120,453,596,0.16083916083916083,0.23993288590604026,0.19972343871480278,0.694169454645526
1,50,9,60,0.0196078431372549,0.85,0.18321953985796274,0.6765002817131952
19,66,20,105,0.2235294117647059,0.8095238095238095,0.21515231296720644,0.7679707160407724
2,0,0,2,1.0,1.0,0.2865808843957779,0.796542144612201
1,15,1,17,0.0625,0.9411764705882353,0.25248019592761956,0.7962556663845463
17,86,2,105,0.1650485436893204,0.9809523809523809,0.27605855931180817,0.8001279845425788
17,108,25,150,0.136,0.8333333333333334,0.2525035656329207,0.807845554329114
16,43,4,63,0.2711864406779661,0.9365079365079365,0.26826746275275,0.9073562758436706
4,25,2,31,0.13793103448275862,0.9354838709677419,0.2851707758021077,0.919568257410491
2,21,1,24,0.08695652173913043,0.9583333333333334,0.26215842268324374,0.9436839036689945
36,61,20,117,0.3711340206185567,0.8290598290598291,0.17232042562875183,0.9192638792489699
21,87,2,110,0.19444444444444445,0.9818181818181818,0.19116963197795817,0.9250698379961051
31,92,3,126,0.25203252032520324,0.9761904761904762,0.2063698394585351,0.9243895658872615
111,269,34,414,0.29210526315789476,0.9178743961352657,0.22689380562394862,0.9336097177161091
6,80,20,106,0.06976744186046512,0.8113207547169812,0.1956983554296809,0.9157258346031155
0,35,5,40,0.0,0.875,0.18092003030652817,0.9070852816077238
0,12,2,14,0.0,0.8571428571428571,0.16849767005808097,0.8926294992947986
2,12,2,16,0.14285714285714285,0.875,0.13588668752073615,0.89919238085768
50,160,58,268,0.23809523809523808,0.7835820895522388,0.14212251518513525,0.8708729391054026
40,108,23,171,0.2702702702702703,0.8654970760233918,0.14472790803443056,0.8550595962243905
3,19,4,26,0.13636363636363635,0.8461538461538461,0.12247910420667933,0.8448138033699021
4,29,93,126,0.12121212121212122,0.2619047619047619,0.12982834411405877,0.7663258043967278
4,39,10,53,0.09302325581395349,0.8113207547169812,0.14311738065890928,0.7572287693562966
11,166,27,204,0.062146892655367235,0.8676470588235294,0.1519955081811046,0.7587293695963927
22,143,3,168,0.13333333333333333,0.9821428571428571,0.15063496396341752,0.7740354920453723
20,123,7,150,0.13986013986013987,0.9533333333333334,0.13660137850126064,0.7982856697283857
26,89,2,117,0.22608695652173913,0.9829059829059829,0.13028947653718476,0.815058370711613
60,158,6,224,0.27522935779816515,0.9732142857142857,0.15012743674211745,0.8332098620773901
11,90,1,102,0.10891089108910891,0.9901960784313726,0.14837011815311568,0.9372514787240488
3,52,5,60,0.05454545454545454,0.9166666666666666,0.14287328940047297,0.952300894716861
2,28,9,39,0.06666666666666667,0.7692307692307693,0.1435189714020872,0.938241424775038
5,155,4,164,0.03125,0.975609756097561,0.12893563806875386,0.9373081246257101
14,109,17,140,0.11382113821138211,0.8785714285714286,0.12521578069035988,0.9266278525168665
36,81,24,141,0.3076923076923077,0.8297872340425532,0.1368736880004411,0.9047537455363767
17,90,2,109,0.1588785046728972,0.981651376146789,0.12025213755397425,0.9059590441695914
8,57,1,66,0.12307692307692308,0.9848484848484849,0.12227585640937629,0.9051951022291789
11,110,12,133,0.09090909090909091,0.9097744360902256,0.12747066160418147,0.9042104978611157
12,37,1,50,0.24489795918367346,0.98,0.15293227482089675,0.9343203879710059
13,86,2,101,0.13131313131313133,0.9801980198019802,0.16722700786562977,0.9349758542144944
4,22,4,30,0.15384615384615385,0.8666666666666667,0.17294486724202576,0.9332751739423856
8,75,13,96,0.0963855421686747,0.8645833333333334,0.1427581864529353,0.9382460452696398
23,32,1,56,0.41818181818181815,0.9821428571428571,0.17980151695420973,0.9383162568405067
0,4,58,62,0.0,0.06451612903225806,0.16221909937179216,0.806840206009617
7,189,13,209,0.03571428571428571,0.937799043062201,0.1543341272011057,0.810843721291328
23,196,16,235,0.1050228310502283,0.9319148936170213,0.13435196603918495,0.8039744203794738
51,95,3,149,0.3493150684931507,0.9798657718120806,0.16549509992204486,0.8039269563809166
8,50,7,65,0.13793103448275862,0.8923076923076924,0.16322151144155983,0.8075899600439204
33,189,6,228,0.14864864864864866,0.9736842105263158,0.17068766951012754,0.8231757996429179
0,13,52,65,0.0,0.2,0.1109474097698678,0.7114411057653669
6,7,2,15,0.46153846153846156,0.8666666666666667,0.17688147570393373,0.8260340397131395
25,58,5,88,0.30120481927710846,0.9431818181818182,0.21480869478433698,0.8268030075873706
0,62,3,65,0.0,0.9538461538461539,0.19980543320573294,0.829936044762961
38,75,32,145,0.336283185840708,0.7793103448275862,0.19794373568395543,0.8012852694794618
20,108,468,596,0.15625,0.21476510067114093,0.20056073075784703,0.7044934706742402
1,50,9,60,0.0196078431372549,0.85,0.18212632997050507,0.6868242977419092
19,66,20,105,0.2235294117647059,0.8095238095238095,0.21405910307974876,0.773899127673882
2,0,0,2,1.0,1.0,0.2909821800028257,0.7929467467215012
1,15,1,17,0.0625,0.9411764705882353,0.2568814915346674,0.7926602684938464
15,88,2,105,0.14563106796116504,0.9809523809523809,0.2776859298148338,0.7965325866518789
19,107,24,150,0.15079365079365079,0.84,0.25118742480811135,0.8052025373907951
17,42,4,63,0.288135593220339,0.9365079365079365,0.2700282238395883,0.9083086567960516
3,26,2,31,0.10344827586206896,0.9354838709677419,0.2820054285145618,0.9205206383628719
2,21,1,24,0.08695652173913043,0.9583333333333334,0.2684554689821917,0.9417791417642325
35,63,19,117,0.35714285714285715,0.8376068376068376,0.17661873428831412,0.9185801185652093
20,88,2,110,0.18518518518518517,0.9818181818181818,0.19414518931476918,0.9243860773123443
34,89,3,126,0.2764227642276423,0.9761904761904762,0.21421667990484844,0.9237058052035009
113,266,35,414,0.29815303430079154,0.9154589371980676,0.23526802040586853,0.9344856533746534
6,80,20,106,0.06976744186046512,0.8113207547169812,0.20165126270554756,0.9166017702616598
0,35,5,40,0.0,0.875,0.18194682920801064,0.9079612172662682
0,12,2,14,0.0,0.8571428571428571,0.16952446895956344,0.8935054349533429
2,12,2,16,0.14285714285714285,0.875,0.13891222406160425,0.8988473152952233
46,163,59,268,0.22009569377990432,0.7798507462686567,0.14389943957513554,0.8699948245024339
39,109,23,171,0.2635135135135135,0.8654970760233918,0.14205526090168857,0.854181481621422
3,19,4,26,0.13636363636363635,0.8461538461538461,0.11894248976780926,0.8442807543293903
4,26,96,126,0.13333333333333333,0.23809523809523808,0.12802333140679042,0.7623913948119984
4,39,10,53,0.09302325581395349,0.8113207547169812,0.14131236795164095,0.753294359771567
14,163,27,204,0.07909604519774012,0.8676470588235294,0.15261180297988952,0.7547949600116632
21,144,3,168,0.12727272727272726,0.9821428571428571,0.1503854578964016,0.7701010824606428
18,125,7,150,0.1258741258741259,0.9533333333333334,0.1369252339098618,0.7948843091841681
22,93,2,117,0.19130434782608696,0.9829059829059829,0.12660963881165802,0.8116570101673953
59,159,6,224,0.2706422018348624,0.9732142857142857,0.14579229102183316,0.8298085015331724
11,90,1,102,0.10891089108910891,0.9901960784313726,0.14230337070122967,0.9372514787240488
2,53,5,60,0.03636363636363636,0.9166666666666666,0.13420913935118436,0.9523008947168609
2,28,9,39,0.06666666666666667,0.7692307692307693,0.13243351384674532,0.938241424775038
4,156,4,164,0.025,0.975609756097561,0.11782312423635569,0.9373081246257101
16,108,16,140,0.12903225806451613,0.8857142857142857,0.11827428597784002,0.9276482606801318
37,80,24,141,0.3162393162393162,0.8297872340425532,0.13612213860830133,0.9057741536996418
15,92,2,109,0.14018691588785046,0.981651376146789,0.11748566918729964,0.9069794523328566
7,58,1,66,0.1076923076923077,0.9848484848484849,0.11731158584489945,0.9062155103924441
11,110,12,133,0.09090909090909091,0.9097744360902256,0.12510379363710725,0.9052309060243812
11,38,1,50,0.22448979591836735,0.98,0.14764995495877878,0.9353407961342712
14,85,2,101,0.1414141414141414,0.9801980198019802,0.1642805465893704,0.9359962623777597
5,21,4,30,0.19230769230769232,0.8666666666666667,0.17331989433839556,0.9332751739423856
7,75,14,96,0.08536585365853659,0.8541666666666666,0.1403379711125699,0.9367579500315445
21,34,1,56,0.38181818181818183,0.9821428571428571,0.17485672338833153,0.9368281616024114
0,4,58,62,0.0,0.06451612903225806,0.1594721080037161,0.8053521107715219
7,189,13,209,0.03571428571428571,0.937799043062201,0.15158713583302968,0.8093556260532326
20,199,16,235,0.091324200913242,0.9319148936170213,0.13256347940372606,0.8024863251413786
48,98,3,149,0.3287671232876712,0.9798657718120806,0.15932819109994462,0.8024388611428215
4,54,7,65,0.06896551724137931,0.8923076923076924,0.14170788037618562,0.8061018648058251
32,190,6,228,0.14414414414414414,0.9736842105263158,0.1501047790169867,0.823175799642918
0,12,53,65,0.0,0.18461538461538463,0.09555932447153215,0.7092433035675647
6,7,2,15,0.46153846153846156,0.8666666666666667,0.1614933904055981,0.8238362375153373
26,57,5,88,0.3132530120481928,0.9431818181818182,0.20114177988187049,0.8246052053895684
0,62,3,65,0.0,0.9538461538461539,0.18809546546569308,0.8277382425651588
36,77,32,145,0.3185840707964602,0.7793103448275862,0.18664074368123437,0.7990874672816596
19,108,469,596,0.14960629921259844,0.21308724832214765,0.19816085539140854,0.7020559752837245
1,50,9,60,0.0196078431372549,0.85,0.18036995524756722,0.6843868023513938
18,67,20,105,0.21176470588235294,0.8095238095238095,0.21062205608790335,0.7736594344811687
2,0,0,2,1.0,1.0,0.2875451330109803,0.7927070535287878
1,15,1,17,0.0625,0.9411764705882353,0.2517232741469527,0.7924205753011331
15,88,2,105,0.14563106796116504,0.9809523809523809,0.27252771242711915,0.7962928934591655
19,109,22,150,0.1484375,0.8533333333333334,0.24822105945619627,0.8068676061028438
17,42,4,63,0.288135593220339,0.9365079365079365,0.2680109586001592,0.9102134187008135
3,26,2,31,0.10344827586206896,0.9354838709677419,0.2799881632751327,0.9224254002676338
2,21,1,24,0.08695652173913043,0.9583333333333334,0.2561933907272894,0.9395373632766288
36,64,17,117,0.36,0.8547008547008547,0.16476481929871797,0.918780342519608
23,85,2,110,0.21296296296296297,0.9818181818181818,0.18625952829342696,0.9245863012667431
33,89,3,125,0.27049180327868855,0.976,0.20160928901025826,0.9241972435159834
109,275,29,413,0.2838541666666667,0.9297820823244553,0.22278942419992737,0.9383109816347687
6,79,20,105,0.07058823529411765,0.8095238095238095,0.19413253771652042,0.9201703920656078
0,35,5,40,0.0,0.875,0.18355052713450987,0.9121654659572335
0,13,1,14,0.0,0.9285714285714286,0.17112816688606267,0.9079137652769612
2,13,1,16,0.13333333333333333,0.9375,0.13874721450511027,0.9197422146054107
50,159,59,268,0.23923444976076555,0.7798507462686567,0.1425002840476535,0.8908897238126213
42,106,23,171,0.28378378378378377,0.8654970760233918,0.14439913840552424,0.875103591815963
3,23,0,26,0.11538461538461539,1.0,0.12033205965094548,0.8851347229124694
4,58,64,126,0.06451612903225806,0.49206349206349204,0.11946461589925125,0.8397832489895668
3,47,3,53,0.06,0.9433962264150944,0.12803604447067982,0.8495541384774375
12,165,27,204,0.06779661016949153,0.8676470588235294,0.13772127449489288,0.8408506570848804
22,143,3,168,0.13333333333333333,0.9821428571428571,0.13772127449489288,0.8472282081052886
19,124,7,150,0.13286713286713286,0.9533333333333334,0.12252594351008823,0.8720114348288138
21,94,2,117,0.1826086956521739,0.9829059829059829,0.10807235949128681,0.8887841358120412
58,160,6,224,0.26605504587155965,0.9732142857142857,0.12959670670370743,0.8849576051997963
11,90,1,102,0.10891089108910891,0.9901960784313726,0.13593881556897183,0.9561194032523507
2,57,1,60,0.03389830508474576,0.9833333333333333,0.1322100020096498,0.9618247042406705
2,28,9,39,0.06666666666666667,0.7692307692307693,0.13204858150924625,0.9477652342988476
4,156,4,164,0.025,0.975609756097561,0.11657239103305579,0.9468319341495196
16,109,15,140,0.128,0.8928571428571429,0.11587708633775108,0.9381924783672068
38,77,26,141,0.33043478260869563,0.8156028368794326,0.13699509876011132,0.9142920289348423
17,90,2,109,0.1588785046728972,0.981651376146789,0.12168416430315955,0.9154973275680571
7,58,1,66,0.1076923076923077,0.9848484848484849,0.12151008096075937,0.9147333856276445
11,73,49,133,0.13095238095238096,0.631578947368421,0.13537494894185012,0.8644827590612285
12,37,1,50,0.24489795918367346,0.98,0.16083656215856537,0.8945926491711187
14,85,2,101,0.1414141414141414,0.9801980198019802,0.177467153789157,0.8952481154146071
4,22,4,30,0.15384615384615385,0.8666666666666667,0.1811594614814647,0.8915066188159677
9,80,7,96,0.10112359550561797,0.9270833333333334,0.1484007204667393,0.9074324040236679
22,33,1,56,0.4,0.9821428571428571,0.18284664837061113,0.9075026155945346
0,4,58,62,0.0,0.06451612903225806,0.16746203298599574,0.7760265647636452
8,188,13,209,0.04081632653061224,0.937799043062201,0.15458545378288593,0.8197722927198994
21,200,14,235,0.09502262443438914,0.9404255319148936,0.13317469167584534,0.8141187972791698
48,97,3,148,0.3310344827586207,0.9797297297297297,0.1602633118679138,0.8140518986974198
6,57,2,65,0.09523809523809523,0.9692307692307692,0.15189073206676257,0.8287039133494345
30,192,6,228,0.13513513513513514,0.9736842105263158,0.15674952344240786,0.8353611815198604
6,58,1,65,0.09375,0.9846153846153847,0.11299952344240786,0.8357143997302217
6,7,2,15,0.46153846153846156,0.8666666666666667,0.17893358937647383,0.9503073336779942
24,59,5,88,0.2891566265060241,0.9431818181818182,0.21441077508724696,0.9510763015522253
0,62,3,65,0.0,0.9538461538461539,0.20083611445376276,0.9529935332566911
39,78,28,145,0.3333333333333333,0.8068965517241379,0.20116452167872173,0.9283030792558922
18,114,464,596,0.13636363636363635,0.2214765100671141,0.20703959898237043,0.8214810422325128
1,50,9,60,0.0196078431372549,0.85,0.19053570012553042,0.803811869300182
18,67,20,105,0.21176470588235294,0.8095238095238095,0.2073949438230094,0.7787987871442429
2,0,0,2,1.0,1.0,0.2843180207460863,0.7978464061918619
1,15,1,17,0.0625,0.9411764705882353,0.2519385026737972,0.7975599279642072
14,89,2,105,0.13592233009708737,0.9809523809523809,0.2713559784019525,0.8014322461222395
19,107,24,150,0.15079365079365079,0.84,0.24527888089628358,0.8061613101616485
18,41,4,63,0.3050847457627119,0.9365079365079365,0.26938189652472294,0.9083086567960516
4,25,2,31,0.13793103448275862,0.9354838709677419,0.2862852095740806,0.9205206383628718
1,20,1,22,0.047619047619047616,0.9545454545454546,0.24385550052330804,0.9410083101701109
33,62,21,116,0.3473684210526316,0.8189655172413793,0.15062241781654112,0.9151462412045938
22,72,2,96,0.23404255319148937,0.9791666666666666,0.17512849684389678,0.9205734120729411
31,75,3,109,0.29245283018867924,0.9724770642201835,0.19516834215035403,0.9196810777822073
107,237,34,378,0.311046511627907,0.91005291005291,0.22055593904957885,0.9289642902847358
5,72,20,97,0.06493506493506493,0.7938144329896907,0.19593407181269948,0.9085795040678436
0,27,6,33,0.0,0.8181818181818182,0.18535206123068892,0.8924576948425861
0,12,2,14,0.0,0.8571428571428571,0.17854934014225354,0.8785430380707864
1,8,2,11,0.1111111111111111,0.8181818181818182,0.14479829586489346,0.8784310810622776
46,134,59,239,0.25555555555555554,0.7531380753138075,0.14787158191690292,0.8461412822975836
39,95,23,157,0.291044776119403,0.8535031847133758,0.14767043133557772,0.8291450137966111
0,17,7,24,0.0,0.7083333333333334,0.1032352153887339,0.8003279314081
3,25,94,122,0.10714285714285714,0.22950819672131148,0.10926489998984708,0.7197127547983315
4,35,10,49,0.10256410256410256,0.7959183673469388,0.12391691464186172,0.7165322618219202
12,149,26,187,0.07453416149068323,0.8609625668449198,0.13456465199767362,0.7170779346365006
20,111,3,134,0.15267175572519084,0.9776119402985075,0.14050188694254212,0.7398536663674562
16,121,7,144,0.11678832116788321,0.9513888888888888,0.12067799631573181,0.7681752111638964
20,84,2,106,0.19230769230769232,0.9811320754716981,0.10657269862834455,0.7864079098436567
57,161,6,224,0.26146788990825687,0.9732142857142857,0.1439252543295241,0.8242480458980784
6,76,1,83,0.07317073170731707,0.9879518072289156,0.1390720935530184,0.9325971331134505
1,47,5,53,0.020833333333333332,0.9056603773584906,0.12739626937719423,0.9482745631151007
1,28,8,37,0.034482758620689655,0.7837837837837838,0.12167464039576656,0.9372490226777955
4,151,4,159,0.025806451612903226,0.9748427672955975,0.10355102552258263,0.9368534265345227
16,99,16,131,0.1391304347826087,0.8778625954198473,0.10674275603897197,0.9263496703246596
31,70,25,126,0.3069306930693069,0.8015873015873016,0.12311747043348834,0.9007004169126029
12,88,2,102,0.12,0.9803921568627451,0.10290777187516593,0.9017258270766686
7,56,1,64,0.1111111111111111,0.984375,0.10832782607570794,0.901214854615395
10,98,12,120,0.09259259259259259,0.9,0.11857914882703069,0.9004062292784678
11,35,1,47,0.2391304347826087,0.9787234042553191,0.14781453113587628,0.928254746488687
14,82,2,98,0.14583333333333334,0.9795918367346939,0.16496122852450915,0.9289331849799866
5,20,4,29,0.2,0.8620689655172413,0.1736568806984222,0.9266769521367573
7,60,14,81,0.1044776119402985,0.8271604938271605,0.1447350119657067,0.9303302653138799
20,31,1,52,0.39215686274509803,0.9807692307692307,0.183614563786435,0.9303841330148064
0,2,58,60,0.0,0.03333333333333333,0.16774154791341914,0.7945210377767111
5,162,13,180,0.029940119760479042,0.9277777777777778,0.15879119465168862,0.7984892917449651
21,163,15,199,0.11413043478260869,0.9246231155778895,0.14093405179454574,0.790760679076761
47,87,3,137,0.35074626865671643,0.9781021897810219,0.17020732826931478,0.7905478723690935
6,56,2,64,0.0967741935483871,0.96875,0.15546078449051293,0.8057880201523447
26,178,6,210,0.12745098039215685,0.9714285714285714,0.1587426942693498,0.8263977455239749
0,13,52,65,0.0,0.2,0.1027202853057644,0.7148592839855132
6,6,2,14,0.5,0.8571428571428571,0.17414885673433583,0.8325463588154454
25,46,5,76,0.352112676056338,0.9342105263157895,0.22017350763374427,0.8334653228923041
1,60,3,64,0.01639344262295082,0.953125,0.20621108018236453,0.8375370206668913
35,76,32,143,0.3153153153153153,0.7762237762237763,0.20114951541930726,0.8086972473015704
23,87,397,507,0.20909090909090908,0.21696252465483234,0.21719476049681039,0.7012990365379751
1,44,9,54,0.022222222222222223,0.8333333333333334,0.2021620807582483,0.6815711453815124
17,64,20,101,0.20987654320987653,0.801980198019802,0.23214444407394494,0.7675683165271986
2,0,0,2,1.0,1.0,0.30357301550251636,0.7879764797925047
1,15,1,17,0.0625,0.9411764705882353,0.2621997760658967,0.7889716146885684
15,77,2,94,0.16304347826086957,0.9787234042553191,0.28314978115702794,0.7926285295821854
16,102,24,142,0.13559322033898305,0.8309859154929577,0.257475196160409,0.8004516923349255
16,43,4,63,0.2711864406779661,0.9365079365079365,0.2663459863871314,0.9032438940282262
2,25,2,29,0.07407407407407407,0.9310344827586207,0.27375339379453884,0.9172012010889814
1,20,1,22,0.047619047619047616,0.9545454545454546,0.2390164113608466,0.9412380162231068
33,62,20,115,0.3473684210526316,0.8260869565217391,0.14578332865407967,0.9163932957262125
22,72,2,96,0.23404255319148937,0.9791666666666666,0.17028940768143527,0.9218204665945599
30,76,3,109,0.2830188679245283,0.9724770642201835,0.18991623624763004,0.9206097070613888
105,237,34,376,0.30701754385964913,0.9095744680851063,0.2179028694974212,0.9305489167878326
5,72,20,97,0.06493506493506493,0.7938144329896907,0.19328100226054185,0.9101641305709404
0,27,6,33,0.0,0.8181818181818182,0.18342878551177338,0.8934066944586654
0,12,2,14,0.0,0.8571428571428571,0.176626064423338,0.8794920376868659
1,8,2,11,0.1111111111111111,0.8181818181818182,0.14287502014597792,0.8783627322097344
46,134,59,239,0.25555555555555554,0.7531380753138075,0.1459483061979874,0.8460729334450401
39,95,23,157,0.291044776119403,0.8535031847133758,0.1470948645115409,0.8290766649440676
2,18,4,24,0.1,0.8333333333333334,0.11752092967444817,0.8181850742652429
3,24,95,122,0.1111111111111111,0.22131147540983606,0.12411750769959763,0.7363989374681207
4,35,10,49,0.10256410256410256,0.7959183673469388,0.1387695223516123,0.7332184444917095
11,153,24,188,0.06707317073170732,0.8723404255319149,0.14835140388471332,0.7353895256901463
19,112,3,134,0.1450381679389313,0.9776119402985075,0.15319812628868765,0.7581652574211019
16,120,8,144,0.11764705882352941,0.9444444444444444,0.13349691246982678,0.7854947387254786
20,84,2,106,0.19230769230769232,0.9811320754716981,0.11939161478243952,0.8037274374052388
57,161,6,224,0.26146788990825687,0.9732142857142857,0.1424584561979048,0.8237104306025177
6,76,1,83,0.07317073170731707,0.9879518072289156,0.13703840199736278,0.9332304780052435
3,49,1,53,0.057692307692307696,0.9811320754716981,0.13062814558710636,0.9596895791659233
1,28,8,37,0.034482758620689655,0.7837837837837838,0.12597237242838957,0.9470386303447617
4,151,4,159,0.025806451612903226,0.9748427672955975,0.10893927009609984,0.9466430342014889
16,99,16,131,0.1391304347826087,0.8778625954198473,0.11200832380453975,0.9371313414836894
34,66,25,125,0.34,0.8,0.13310722490344085,0.9112553307020183
16,84,2,102,0.16,0.9803921568627451,0.11861181205940416,0.9122807408660839
7,56,1,64,0.1111111111111111,0.984375,0.12403186625994615,0.9117697684048102
10,98,12,120,0.09259259259259259,0.9,0.12901762124570113,0.9001794719088532
11,35,1,47,0.2391304347826087,0.9787234042553191,0.1582530035545467,0.9280279891190727
13,83,1,97,0.13541666666666666,0.9896907216494846,0.17391160570508432,0.9301491254553422
5,20,4,29,0.2,0.8620689655172413,0.1826072578789974,0.9278928926121128
6,61,14,81,0.08955223880597014,0.8271604938271605,0.14682900627985027,0.9317729631588499
20,31,1,52,0.39215686274509803,0.9807692307692307,0.17999427238629284,0.9318268308597765
0,2,58,60,0.0,0.03333333333333333,0.16412125651327697,0.7959637356216812
5,166,9,180,0.029239766081871343,0.95,0.15507085272603108,0.8031065927645384
18,166,15,199,0.09782608695652174,0.9246231155778895,0.1348845173223044,0.7953779800963341
48,87,3,138,0.35555555555555557,0.9782608695652174,0.16633293002071708,0.793745144084296
5,57,2,64,0.08064516129032258,0.96875,0.14928223877647742,0.8089852918675472
23,181,6,210,0.11274509803921569,0.9714285714285714,0.15259550438122682,0.8295950172391774
0,13,52,65,0.0,0.2,0.09657309541764136,0.7180565557007158
4,8,2,14,0.3333333333333333,0.8571428571428571,0.14419214303668898,0.8357436305306478
24,47,5,76,0.3380281690140845,0.9342105263157895,0.18830477202700516,0.8334879914329034
0,61,3,64,0.0,0.953125,0.17432961674750208,0.8375596892074907
34,75,32,141,0.3119266055045872,0.7730496453900709,0.1680969095973637,0.8082438000396126
24,87,395,506,0.21621621621621623,0.21936758893280633,0.18746420315820567,0.7011891698871563
1,44,9,54,0.022222222222222223,0.8333333333333334,0.17453236375577802,0.6814612787306936
17,64,20,101,0.20987654320987653,0.801980198019802,0.20451472707147467,0.7674584498763798
2,0,0,2,1.0,1.0,0.2997528223095699,0.7878666131416859
1,15,1,17,0.0625,0.9411764705882353,0.2603916553075578,0.7888617480377496
14,78,2,94,0.15217391304347827,0.9787234042553191,0.2821307857423404,0.7925186629313666
16,104,22,142,0.13333333333333333,0.8450704225352113,0.256617461146447,0.8028073453806723
14,45,4,63,0.23728813559322035,0.9365079365079365,0.2596277353431619,0.9052559664628338
2,25,2,29,0.07407407407407407,0.9310344827586207,0.26703514275056933,0.9192132735235893
2,21,1,24,0.08695652173913043,0.9583333333333334,0.2460230130728695,0.9417791417642325
32,65,20,117,0.32989690721649484,0.8290598290598291,0.15029399981808306,0.917359117344208
21,88,2,111,0.1926605504587156,0.9819819819819819,0.16888836416932815,0.9231884761147434
33,90,3,126,0.2682926829268293,0.9761904761904762,0.1850244894695548,0.9225082040058997
102,280,34,416,0.2670157068062827,0.9182692307692307,0.20729657456886505,0.9336895226872184
4,82,20,106,0.046511627906976744,0.8113207547169812,0.1800427877565445,0.9158056395742248
0,34,6,40,0.0,0.85,0.17019057100777604,0.9035936580074045
0,12,2,14,0.0,0.8571428571428571,0.15776821075932881,0.8891378756944793
2,12,2,16,0.14285714285714285,0.875,0.13104824442227855,0.8957007572573609
41,169,57,267,0.19523809523809524,0.7865168539325843,0.13141646510504706,0.8677771675360183
40,107,23,170,0.272108843537415,0.8647058823529412,0.1319616309065593,0.8518507969877991
2,20,4,26,0.09090909090909091,0.8461538461538461,0.10680354292124619,0.8415485991856013
2,23,101,126,0.08,0.1984126984126984,0.1115875960773924,0.7539903054278466
5,38,10,53,0.11627906976744186,0.8113207547169812,0.1281988917584555,0.7484646989588439
12,167,27,206,0.0670391061452514,0.8689320388349514,0.13777590692206285,0.7501488677720002
17,147,3,167,0.10365853658536585,0.9820359281437125,0.1321761060260947,0.7654397146496734
16,127,7,150,0.11188811188811189,0.9533333333333334,0.12026896554752566,0.7892706402783519
18,97,2,117,0.1565217391304348,0.9829059829059829,0.10375652206081419,0.8061563689287864
57,161,6,224,0.26146788990825687,0.9732142857142857,0.12812206477498075,0.8243078602945635
11,89,1,101,0.11,0.9900990099009901,0.13240777906069504,0.9374059047928908
5,50,5,60,0.09090909090909091,0.9166666666666666,0.1287834963666449,0.9524553207857032
1,29,9,39,0.03333333333333333,0.7692307692307693,0.12396838596494233,0.93821228227082
4,156,4,164,0.025,0.975609756097561,0.11273145216703293,0.9372942576927983
16,108,16,140,0.12903225806451613,0.8857142857142857,0.11518061590651925,0.9276343937472201
35,81,24,140,0.3017241379310345,0.8285714285714286,0.13592381573517634,0.9055866002708551
13,94,2,109,0.12149532710280374,0.981651376146789,0.11592773533439733,0.9067918989040699
7,57,2,66,0.109375,0.9696969696969697,0.11583844962011161,0.903877321732067
11,110,12,133,0.09090909090909091,0.9097744360902256,0.11583844962011161,0.902892717364004
12,37,1,50,0.24489795918367346,0.98,0.1460619675987316,0.9330026074738941
12,87,1,100,0.12121212121212122,0.99,0.15980655634332036,0.9350583566028139
4,22,4,30,0.15384615384615385,0.8666666666666667,0.16335139859784004,0.9323372681674399
6,78,12,96,0.07142857142857142,0.875,0.13045203195463104,0.9389699212286643
19,35,2,56,0.35185185185185186,0.9642857142857143,0.16336010691878075,0.936489112391368
0,4,58,62,0.0,0.06451612903225806,0.14773510691878075,0.8071775637249806
6,194,9,209,0.03,0.9569377990430622,0.13903380821748207,0.8139151870039572
19,202,13,234,0.08597285067873303,0.9444444444444444,0.11633022128820485,0.808835821924592
42,95,13,150,0.30656934306569344,0.9133333333333333,0.14280982441014375,0.7978834409722112
7,56,2,65,0.1111111111111111,0.9692307692307692,0.13670481830513764,0.8125354556242258
26,196,6,228,0.11711711711711711,0.9736842105263158,0.1432317534035013,0.8266331999851281
1,11,54,66,0.08333333333333333,0.18181818181818182,0.10487196504371296,0.7148521239183376
4,9,2,15,0.3076923076923077,0.8666666666666667,0.1488280089997569,0.8294450578661104
24,59,5,88,0.2891566265060241,0.9431818181818182,0.1858503842149032,0.8274799177430755
0,62,3,65,0.0,0.9538461538461539,0.17356854840365563,0.8288230190861768
34,77,32,143,0.3063063063063063,0.7762237762237763,0.17353097172374318,0.8092359394990973
23,121,452,596,0.1597222222222222,0.24161073825503357,0.18047541616818763,0.705290220788278
1,50,9,60,0.0196078431372549,0.85,0.16654551988535019,0.687621047855947
18,68,20,106,0.20930232558139536,0.8113207547169812,0.18454109020650192,0.7775499868414898
2,0,0,2,1.0,1.0,0.2834421891076008,0.7965976058891088
1,15,1,17,0.0625,0.9411764705882353,0.2510626710353116,0.7963111276614542
15,88,2,105,0.14563106796116504,0.9809523809523809,0.27186710931547803,0.8001834458194866
14,112,24,150,0.1111111111111111,0.84,0.24398208143045017,0.8092943349303756
14,45,4,63,0.23728813559322035,0.9365079365079365,0.25506292619773563,0.9085653632522189
2,27,2,31,0.06896551724137931,0.9354838709677419,0.26211402249832483,0.9207773448190393
2,21,1,24,0.08695652173913043,0.9583333333333334,0.2524514744250479,0.9417791417642325
33,66,18,117,0.3333333333333333,0.8461538461538461,0.1572133791869527,0.9198011197862105
22,87,2,111,0.2018348623853211,0.9819819819819819,0.17711835952771285,0.9256304785567456
32,91,3,126,0.2601626016260163,0.9761904761904762,0.18793215698607577,0.9249502064479022
99,282,35,416,0.25984251968503935,0.9158653846153846,0.2069119273719204,0.9357881185358142
4,82,20,106,0.046511627906976744,0.8113207547169812,0.1796581405595999,0.9179042354228207
0,34,6,40,0.0,0.85,0.1698059238108314,0.9056922538560004
0,12,2,14,0.0,0.8571428571428571,0.1573835635623842,0.8912364715430751
2,12,2,16,0.14285714285714285,0.875,0.1301726792086427,0.8953573506639543
42,166,59,267,0.20192307692307693,0.7790262172284644,0.13018528128546497,0.8663636699848803
41,105,23,169,0.2808219178082192,0.863905325443787,0.13313661216863681,0.8503229341639248
2,20,4,26,0.09090909090909091,0.8461538461538461,0.10900326520064418,0.8403641429551335
3,25,98,126,0.10714285714285714,0.2222222222222222,0.11766486937719853,0.7562072097415965
5,38,10,53,0.11627906976744186,0.8113207547169812,0.13427616505826165,0.7506816032725939
12,167,27,206,0.0670391061452514,0.8689320388349514,0.143853180221869,0.7523657720857503
16,148,3,167,0.0975609756097561,0.9820359281437125,0.13738229918652803,0.7676566189634234
15,128,7,150,0.1048951048951049,0.9533333333333334,0.12352116032538916,0.7925576355498334
17,98,2,117,0.14782608695652175,0.9829059829059829,0.10452175591800382,0.809557729473004
56,162,6,224,0.25688073394495414,0.9732142857142857,0.12823199063741283,0.8277092208387813
11,89,1,101,0.11,0.9900990099009901,0.12864015390271896,0.937405904792891
3,52,5,60,0.05454545454545454,0.9166666666666666,0.11982106601386365,0.952455320785703
1,29,9,39,0.03333333333333333,0.7692307692307693,0.11500595561216106,0.9382122822708199
4,156,4,164,0.025,0.975609756097561,0.10464010195362448,0.9372942576927983
15,109,16,140,0.12096774193548387,0.8857142857142857,0.10693619295939291,0.92763439374722
37,79,24,140,0.31896551724137934,0.8285714285714286,0.13138468300008685,0.9055866002708551
14,93,2,109,0.1308411214953271,0.981651376146789,0.11337902407871156,0.9067918989040699
7,57,2,66,0.109375,0.9696969696969697,0.11328973836442584,0.903877321732067
11,110,12,133,0.09090909090909091,0.9097744360902256,0.11848454355923102,0.902892717364004
12,37,1,50,0.24489795918367346,0.98,0.14870806153785107,0.9330026074738942
13,86,1,100,0.13131313131313133,0.99,0.16389565172544127,0.935058356602814
2,24,4,30,0.07692307692307693,0.8666666666666667,0.15760355672366883,0.9323372681674398
6,76,14,96,0.07317073170731707,0.8541666666666666,0.12249001593308849,0.9359937307524738
19,35,2,56,0.35185185185185186,0.9642857142857143,0.15406297741259203,0.9335129219151774
0,4,58,62,0.0,0.06451612903225806,0.13843797741259203,0.80420137324879
6,194,9,209,0.03,0.9569377990430622,0.12973667871129332,0.8109389965277668
17,203,13,233,0.07727272727272727,0.944206008583691,0.10579021700972958,0.8058255691825796
41,94,15,150,0.3037037037037037,0.9,0.1304174416369542,0.7929684263254367
7,56,2,65,0.1111111111111111,0.9692307692307692,0.13530144652095907,0.8076204409774516
24,198,6,228,0.10810810810810811,0.9736842105263158,0.14029250029250068,0.8246943758145442
1,11,54,66,0.08333333333333333,0.18181818181818182,0.10193271193271232,0.7129132997477539
4,9,2,15,0.3076923076923077,0.8666666666666667,0.14588875588875627,0.8275062336955266
24,59,5,88,0.2891566265060241,0.9431818181818182,0.18291113110390259,0.8255410935724916
0,62,3,65,0.0,0.9538461538461539,0.17187217006494152,0.8269182571814149
33,78,32,143,0.2972972972972973,0.7762237762237763,0.1709569691497406,0.8092359394990973
21,124,451,596,0.14482758620689656,0.24328859060402686,0.17577360844913853,0.7055299139809913
1,50,9,60,0.0196078431372549,0.85,0.16313071345330238,0.6878607410486604
18,68,20,106,0.20930232558139536,0.8113207547169812,0.18112628377445408,0.7777896800342032
2,0,0,2,1.0,1.0,0.280027382675553,0.7968372990818222
1,15,1,17,0.0625,0.9411764705882353,0.24764786460326382,0.7965508208541675
16,87,2,105,0.1553398058252427,0.9809523809523809,0.26983926543544134,0.8004231390122
14,112,24,150,0.1111111111111111,0.84,0.24324123883741475,0.809534028123089
14,45,4,63,0.23728813559322035,0.9365079365079365,0.2564498887497467,0.9085653632522189
2,27,2,31,0.06896551724137931,0.9354838709677419,0.2635009850503359,0.9207773448190393
2,21,1,24,0.08695652173913043,0.9583333333333334,0.24715679992094208,0.9417791417642325
33,67,17,117,0.33,0.8547008547008547,0.15144251420665636,0.9210221210072117
22,87,2,111,0.2018348623853211,0.9819819819819819,0.17134749454741652,0.9268514797777468
33,90,3,126,0.2682926829268293,0.9761904761904762,0.1874836198476432,0.9261712076689034
107,274,35,416,0.28083989501312334,0.9158653846153846,0.2105968021284295,0.9370091197568156
6,80,20,106,0.06976744186046512,0.8113207547169812,0.18666527445232162,0.9191252366438218
0,34,6,40,0.0,0.85,0.17681305770355316,0.9069132550770015
0,12,2,14,0.0,0.8571428571428571,0.16439069745510593,0.8924574727640764
2,12,2,16,0.14285714285714285,0.875,0.13765600357755492,0.8953573506639544
45,164,58,267,0.215311004784689,0.7827715355805244,0.13958116677746463,0.8668987154637461
41,105,23,169,0.2808219178082192,0.863905325443787,0.14137105747480602,0.8508579796427904
2,20,4,26,0.09090909090909091,0.8461538461538461,0.11423808545994425,0.8408991884339994
3,23,100,126,0.11538461538461539,0.20634920634920634,0.12075482453482286,0.7544746815243172
5,38,10,53,0.11627906976744186,0.8113207547169812,0.13736612021588598,0.7489490750553145
12,169,25,206,0.06629834254143646,0.8786407766990292,0.14683731200751976,0.7520202064204818
17,147,3,167,0.10365853658536585,0.9820359281437125,0.14123751111155164,0.7673110532981552
19,123,8,150,0.13380281690140844,0.9466666666666667,0.12959348427108297,0.7907246434533183
18,97,2,117,0.1565217391304348,0.9829059829059829,0.11183631588854233,0.8077247373764892
55,163,6,224,0.25229357798165136,0.9732142857142857,0.13489124261319382,0.8258762287422662
11,89,1,101,0.11,0.9900990099009901,0.13412201184396305,0.937840486392521
3,52,5,60,0.05454545454545454,0.9166666666666666,0.12530292395510773,0.9528899023853332
1,29,9,39,0.03333333333333333,0.7692307692307693,0.12059363692537871,0.937259901318439
4,156,4,164,0.025,0.975609756097561,0.1093567031274693,0.9363418767404174
14,100,26,140,0.12280701754385964,0.8142857142857143,0.10778587464781948,0.9174303121145669
37,78,25,140,0.3217391304347826,0.8214285714285714,0.13138835911986915,0.8943621104749367
17,90,2,109,0.1588785046728972,0.981651376146789,0.11804334864719,0.8955674091081516
7,58,1,66,0.1076923076923077,0.9848484848484849,0.11771367831751967,0.8948173341006508
11,110,12,133,0.09090909090909091,0.9097744360902256,0.12290848351232486,0.8938327297325878
12,37,1,50,0.24489795918367346,0.98,0.15313200149094489,0.9239426198424778
14,85,1,100,0.1414141414141414,0.99,0.16976259312153652,0.9259983689713976
2,24,4,30,0.07692307692307693,0.8666666666666667,0.16320774446142466,0.9334813621686767
6,78,12,96,0.07142857142857142,0.875,0.12744909317482309,0.9411344233931666
20,35,1,56,0.36363636363636365,0.9821428571428571,0.15670021588388972,0.9412046349640333
0,4,58,62,0.0,0.06451612903225806,0.14131560049927436,0.8097285841331437
6,194,9,209,0.03,0.9569377990430622,0.13261430179797565,0.8164662074121204
17,202,14,233,0.0776255707762557,0.9399141630901288,0.10871824631120168,0.8107396592821389
46,100,4,150,0.3150684931506849,0.9733333333333334,0.13352601084499363,0.8083587069011865
8,55,2,65,0.12698412698412698,0.9692307692307692,0.1406775894251436,0.8230107215532012
28,194,6,228,0.12612612612612611,0.9736842105263158,0.1484915258105086,0.8371084659141035
1,14,51,66,0.06666666666666667,0.22727272727272727,0.10606728338626616,0.7292698759326562
5,8,2,15,0.38461538461538464,0.8666666666666667,0.16101233833132111,0.8438628098804289
20,63,5,88,0.24096385542168675,0.9431818181818182,0.19115003196299063,0.8418976697573941
0,62,3,65,0.0,0.9538461538461539,0.18006066470923981,0.8438879541511121
35,78,32,145,0.30973451327433627,0.7793103448275862,0.17929866758404714,0.8161703843645766
25,119,452,596,0.1736111111111111,0.24161073825503357,0.18595966531647345,0.7122246656537572
1,50,9,60,0.0196078431372549,0.85,0.1707427677466347,0.6945554927214264
19,67,20,106,0.22093023255813954,0.8113207547169812,0.19278042001684512,0.7779909252134628
2,0,0,2,1.0,1.0,0.280692507928933,0.7970385442610818
1,15,1,17,0.0625,0.9411764705882353,0.2551976714401207,0.7967520660334271
19,84,2,105,0.18446601941747573,0.9809523809523809,0.2815499599283315,0.8006243841914594
16,110,24,150,0.12698412698412698,0.84,0.255442761886873,0.8092943349303757
14,45,4,63,0.23728813559322035,0.9365079365079365,0.26453947967003144,0.9085653632522189
2,27,2,31,0.06896551724137931,0.9354838709677419,0.27159057597062064,0.9207773448190393
2,21,1,24,0.08695652173913043,0.9583333333333334,0.2432490879688473,0.9417791417642324
33,67,17,117,0.33,0.8547008547008547,0.1475348022545616,0.9210221210072117
27,82,2,111,0.24770642201834864,0.9819819819819819,0.17399286254289711,0.9268514797777468
31,92,3,126,0.25203252032520324,0.9761904761904762,0.19058003257548511,0.9261712076689034
104,275,37,416,0.27440633245382584,0.9110576923076923,0.21390792133873007,0.9363223065700023
8,78,20,106,0.09302325581395349,0.8113207547169812,0.1932986527988348,0.9184384234570088
0,34,6,40,0.0,0.85,0.18344643605006633,0.9062264418901884
0,13,1,14,0.0,0.9285714285714286,0.17102407580161913,0.9019747412099164
2,12,2,16,0.14285714285714285,0.875,0.1442893819240681,0.9048746191097942
49,160,58,267,0.23444976076555024,0.7827715355805244,0.14239557317366833,0.8764159839095859
38,108,23,169,0.2602739726027397,0.863905325443787,0.1435729234990307,0.8603752480886303
3,19,4,26,0.13636363636363635,0.8461538461538461,0.12385253834328933,0.8511032700666524
2,25,99,126,0.07407407407407407,0.21428571428571427,0.12114551238044942,0.7658125500050428
5,38,10,53,0.11627906976744186,0.8113207547169812,0.13775680806151253,0.7602869435360401
13,166,27,206,0.07262569832402235,0.8689320388349514,0.14813190782208716,0.7517670307165433
18,146,3,167,0.10975609756097561,0.9820359281437125,0.14340318706549185,0.7670578775942165
17,126,7,150,0.11888111888111888,0.9533333333333334,0.12689338108200166,0.7914238487017606
16,99,2,117,0.1391304347826087,0.9829059829059829,0.1095871613934115,0.8084239426249316
53,165,6,224,0.24311926605504589,0.9732142857142857,0.12483796563504143,0.8265754339907085
11,89,1,101,0.11,0.9900990099009901,0.12997024076731656,0.9374059047928908
2,53,5,60,0.03636363636363636,0.9166666666666666,0.11855375028105863,0.9524553207857032
1,29,9,39,0.03333333333333333,0.7692307692307693,0.11294055528238878,0.93821228227082
4,156,4,164,0.025,0.975609756097561,0.10083254134510654,0.9372942576927983
16,108,16,140,0.12903225806451613,0.8857142857142857,0.10228270408559186,0.9276343937472201
38,77,25,140,0.33043478260869563,0.8214285714285714,0.1296118966321757,0.9045661921075899
15,92,2,109,0.14018691588785046,0.981651376146789,0.11490727517971923,0.9057714907408047
7,58,1,66,0.1076923076923077,0.9848484848484849,0.11457760485004889,0.905021415733304
11,110,12,133,0.09090909090909091,0.9097744360902256,0.12236981264225669,0.9040368113652407
12,37,1,50,0.24489795918367346,0.98,0.1525933306208767,0.9341467014751309
13,86,1,100,0.13131313131313133,0.99,0.16778092080846688,0.9362024506040508
2,24,4,30,0.07692307692307693,0.8666666666666667,0.16033675207397557,0.9334813621686766
6,78,12,96,0.07142857142857142,0.875,0.12333586476252927,0.9411344233931664
19,36,1,56,0.34545454545454546,0.9821428571428571,0.1526598118434857,0.9412046349640334
0,4,58,62,0.0,0.06451612903225806,0.13727519645887032,0.8097285841331437
6,194,9,209,0.03,0.9569377990430622,0.1285738977575716,0.8164662074121205
18,201,14,233,0.0821917808219178,0.9399141630901288,0.10533015799160653,0.8107396592821389
44,102,4,150,0.3013698630136986,0.9733333333333334,0.1296239768059733,0.8083587069011865
5,53,7,65,0.08620689655172414,0.8923076923076924,0.1309502367529229,0.8120217105641901
28,194,6,228,0.12612612612612611,0.9736842105263158,0.13876417313828784,0.8261194549250924
1,13,52,66,0.07142857142857142,0.21212121212121213,0.09961760542029154,0.716116362779143
4,8,3,15,0.3333333333333333,0.8,0.14723665303933917,0.8211854872031062
20,63,5,88,0.24096385542168675,0.9431818181818182,0.1773743466710087,0.8192203470800715
1,61,3,65,0.016129032258064516,0.9538461538461539,0.16793681116188683,0.8212106314737893
34,79,32,145,0.3008849557522124,0.7793103448275862,0.1678675386959602,0.793493061687254
26,116,454,596,0.18309859154929578,0.23825503355704697,0.18170920940989901,0.7000569675800189
1,50,9,60,0.0196078431372549,0.85,0.16649231184006025,0.6823877946476882
17,69,20,106,0.19767441860465115,0.8113207547169812,0.18452743286521447,0.7679877293042265
2,0,0,2,1.0,1.0,0.27976552810330974,0.796559157875655
1,15,1,17,0.0625,0.9411764705882353,0.25427069161449734,0.7962726796480004
16,87,2,105,0.1553398058252427,0.9809523809523809,0.2741579449812371,0.8001449978060329
15,111,24,150,0.11904761904761904,0.84,0.2481811825948666,0.8088149485449491
14,45,4,63,0.23728813559322035,0.9365079365079365,0.2559225460297129,0.908565363252219
2,27,2,31,0.06896551724137931,0.9354838709677419,0.2629736423303021,0.9207773448190393
2,21,1,24,0.08695652173913043,0.9583333333333334,0.2451101489264187,0.9384162750451122
32,70,15,117,0.3137254901960784,0.8717948717948718,0.14707093324014417,0.9201012567300938
26,83,2,111,0.23853211009174313,0.9819819819819819,0.17221837753896466,0.925930615500629
30,93,3,126,0.24390243902439024,0.9761904761904762,0.19034425788591397,0.9255054454326018
103,278,35,416,0.27034120734908135,0.9158653846153846,0.20925999686681723,0.9388154953118005
7,79,20,106,0.08139534883720931,0.8113207547169812,0.18698959875881568,0.920931612198807
0,34,6,40,0.0,0.85,0.17640758817680507,0.909355257519004
0,13,1,14,0.0,0.9285714285714286,0.16398522792835787,0.905103556838732
2,13,1,16,0.13333333333333333,0.9375,0.13821491980510858,0.9144900037251789
45,168,54,267,0.2112676056338028,0.797752808988764,0.1343199905968314,0.8881715504404334
39,107,23,169,0.2671232876712329,0.863905325443787,0.1376372546892375,0.8721308146194777
2,24,0,26,0.07692307692307693,1.0,0.11000609319980827,0.8841500453887086
2,53,71,126,0.03636363636363636,0.4365079365079365,0.10357299141786928,0.8306053570731307
5,45,3,53,0.1,0.9433962264150944,0.11785870570358357,0.84394767513243
14,167,25,206,0.07734806629834254,0.8786407766990292,0.12890842946048967,0.8368147248649443
17,147,3,167,0.10365853658536585,0.9820359281437125,0.12466917278220857,0.8431770003140461
17,126,7,150,0.11888111888111888,0.9533333333333334,0.11147110324611087,0.8654027895061274
14,101,2,117,0.12173913043478261,0.9829059829059829,0.09070193792661799,0.8824028834292983
54,163,7,224,0.2488479262672811,0.96875,0.11526263069007572,0.8779385977150126
11,89,1,101,0.11,0.9900990099009901,0.12578211120955624,0.9570230367711631
3,56,1,60,0.05084745762711865,0.9833333333333333,0.11876031944200176,0.9627283377594829
1,29,9,39,0.03333333333333333,0.7692307692307693,0.11247250044700044,0.9470983366925886
4,156,4,164,0.025,0.975609756097561,0.10123556664909104,0.946180312114567
15,110,15,140,0.12,0.8928571428571429,0.10139540680893121,0.937540856332254
37,78,25,140,0.3217391304347826,0.8214285714285714,0.12996683538035975,0.9144726546926238
17,90,2,109,0.1588785046728972,0.981651376146789,0.11711406086687635,0.9163157084278796
7,58,1,66,0.1076923076923077,0.9848484848484849,0.116784390537206,0.9155656334203787
11,72,50,133,0.13253012048192772,0.6240601503759399,0.1284533423736073,0.864240892997894
13,36,1,50,0.2653061224489796,0.98,0.16159231224727108,0.894350783107784
14,85,1,100,0.1414141414141414,0.99,0.1782229038778627,0.896406532236704
2,24,4,30,0.07692307692307693,0.8666666666666667,0.17206905772401654,0.8926650356380643
7,84,5,96,0.07692307692307693,0.9479166666666666,0.1370953357937729,0.9107347635292209
19,36,1,56,0.34545454545454546,0.9821428571428571,0.16374905590543692,0.9108049751000876
0,4,58,62,0.0,0.06451612903225806,0.14836444052082154,0.7793289242691983
5,195,9,209,0.025,0.9569377990430622,0.133002994737689,0.8268828740787871
18,203,12,233,0.08144796380090498,0.9484978540772532,0.10673754350224976,0.8223825675183948
51,96,3,150,0.3469387755102041,0.98,0.13609820551597301,0.8209539960898233
7,51,7,65,0.1206896551724138,0.8923076923076924,0.14235057383730684,0.8246169997528269
30,192,6,228,0.13513513513513514,0.9736842105263158,0.15066658215331516,0.8282980774470625
8,56,2,66,0.125,0.9696969696969697,0.11917307565980868,0.8265200935262215
4,8,3,15,0.3333333333333333,0.8,0.16679212327885629,0.9315892179501846
19,64,5,88,0.2289156626506024,0.9431818181818182,0.19592293222894236,0.9296240778271497
2,60,3,65,0.03225806451612903,0.9538461538461539,0.18889580375968862,0.9303881206512784
37,80,28,145,0.3162393162393162,0.8068965517241379,0.18451016672099035,0.9056590566118695
26,124,446,596,0.17333333333333334,0.2516778523489933,0.1920306921725503,0.8141405080463412
1,50,9,60,0.0196078431372549,0.85,0.17552679331571028,0.7964713351140104
17,69,20,106,0.19767441860465115,0.8113207547169812,0.1859088531163747,0.7738461615454406
2,0,0,2,1.0,1.0,0.28114694835446996,0.8024175901168692
1,15,1,17,0.0625,0.9411764705882353,0.2573732822615268,0.8021311118892144
14,89,2,105,0.13592233009708737,0.9809523809523809,0.2721824630588065,0.8060034300472468
14,112,24,150,0.1111111111111111,0.84,0.24287843375477722,0.8107324940866556
14,45,4,63,0.23728813559322035,0.9365079365079365,0.2520148340776182,0.9085653632522189
2,27,2,31,0.06896551724137931,0.9354838709677419,0.2590659303782074,0.9207773448190393
1,20,1,22,0.047619047619047616,0.9545454545454546,0.24031262617433866,0.9398701636350589
33,64,18,115,0.3402061855670103,0.8434782608695652,0.14605636696962582,0.917509915187854
22,72,2,96,0.23404255319148937,0.9791666666666666,0.17056244599698145,0.9229370860562013
31,74,3,108,0.29523809523809524,0.9722222222222222,0.19123394040119474,0.9219763508849398
98,244,35,377,0.28654970760233917,0.9071618037135278,0.2140098066204151,0.9320166896119989
6,71,20,97,0.07792207792207792,0.7938144329896907,0.19366453445916232,0.9116319033951067
0,27,6,33,0.0,0.8181818181818182,0.18308252387715176,0.8955100941698492
0,13,1,14,0.0,0.9285714285714286,0.17627980278871638,0.8917995190307026
1,8,2,11,0.1111111111111111,0.8181818181818182,0.1435519350093022,0.8881857415038816
44,140,55,239,0.2391304347826087,0.7698744769874477,0.14427877523660496,0.8582868572639931
35,98,23,156,0.2631578947368421,0.8525641025641025,0.13969588945071162,0.8411928401699761
2,18,4,24,0.1,0.8333333333333334,0.11304593122180605,0.8306459158299484
2,24,96,122,0.07692307692307693,0.21311475409836064,0.11290321679337734,0.7476888188454727
4,36,9,49,0.1,0.8163265306122449,0.12718893107909163,0.7474237777641051
12,150,26,188,0.07407407407407407,0.8617021276595744,0.1377709416611022,0.7378710204909831
16,115,3,134,0.12213740458015267,0.9776119402985075,0.13934612644239386,0.7606467522219386
18,119,7,144,0.13138686131386862,0.9513888888888888,0.12395418737543097,0.7865773824935731
15,89,2,106,0.14423076923076922,0.9811320754716981,0.10696459801742057,0.8049442357660866
53,165,6,224,0.24311926605504589,0.9732142857142857,0.1274102074538557,0.8249272289633656
6,76,1,83,0.07317073170731707,0.9879518072289156,0.1268741581373186,0.9356182365534449
4,48,1,53,0.07692307692307693,0.9811320754716981,0.12357745484061529,0.959161885819081
1,28,8,37,0.034482758620689655,0.7837837837837838,0.11792155263298894,0.9480306938368253
4,151,4,159,0.025806451612903226,0.9748427672955975,0.10415998792338188,0.9476350976935525
15,99,17,131,0.13157894736842105,0.8702290076335878,0.10418742878831792,0.9360408289427952
37,64,24,125,0.36633663366336633,0.808,0.13591683799297466,0.9113076753039812
17,83,2,102,0.17,0.9803921568627451,0.12547122855653955,0.9123330854680468
6,57,1,64,0.09523809523809523,0.984375,0.12862370906093643,0.9118221130067731
10,98,12,120,0.09259259259259259,0.9,0.13086221129943867,0.9002318165108162
10,36,1,47,0.21739130434782608,0.9787234042553191,0.15699200354617246,0.9280803337210355
14,83,1,98,0.14432989690721648,0.9897959183673469,0.1739239243025029,0.9302164981598569
2,23,4,29,0.08,0.8620689655172413,0.16655550324987134,0.9290507778575217
5,64,12,81,0.07246376811594203,0.8518518518518519,0.12457366531452499,0.9353153281220719
19,32,1,52,0.37254901960784315,0.9807692307692307,0.15350923954421686,0.9353691958229984
0,2,58,60,0.0,0.03333333333333333,0.13990379736734612,0.7995061005849031
5,167,9,181,0.029069767441860465,0.9502762430939227,0.13082910806009868,0.8066884210268922
18,167,13,198,0.0972972972972973,0.9343434343434344,0.11367282133859456,0.8003484253251943
47,85,4,136,0.3560606060606061,0.9705882352941176,0.1439200655033645,0.7976044706004474
6,50,7,63,0.10714285714285714,0.8888888888888888,0.14779761652377266,0.8014358882249683
25,180,6,211,0.12195121951219512,0.9715639810426541,0.1548672524375231,0.8185376209665115
0,14,51,65,0.0,0.2153846153846154,0.10164596392211696,0.7091969616258522
4,8,2,14,0.3333333333333333,0.8571428571428571,0.1492650115411646,0.8268840364557841
19,53,5,77,0.2638888888888889,0.935064935064935,0.18281060031931148,0.824710992451643
0,61,3,64,0.0,0.953125,0.1689109864196976,0.8273940732597238
35,76,32,143,0.3153153153153153,0.7762237762237763,0.16309023059894173,0.7996277219639608
20,93,395,508,0.17699115044247787,0.22244094488188976,0.1730685582131733,0.7044208728201039
0,45,9,54,0.0,0.8333333333333334,0.15564695542571685,0.6846736374330581
17,64,20,101,0.20987654320987653,0.801980198019802,0.1856293187414135,0.7684730063809418
2,0,0,2,1.0,1.0,0.28086741397950876,0.788881169646248
1,15,1,17,0.0625,0.9411764705882353,0.25209757270966743,0.7897542461495766
11,83,2,96,0.11702127659574468,0.9791666666666666,0.26881489793763097,0.7934744842448147
16,100,25,141,0.13793103448275862,0.8226950354609929,0.2434742863901229,0.800113235564417
14,45,4,63,0.23728813559322035,0.9365079365079365,0.25208814141165753,0.9021228057967094
2,25,2,29,0.07407407407407407,0.9310344827586207,0.2626701519936681,0.9160801128574647
2,19,1,22,0.09523809523809523,0.9545454545454546,0.23949011299113393,0.9412380162231069
32,65,18,115,0.32989690721649484,0.8434782608695652,0.14376109973634746,0.9188777677759019
21,74,2,97,0.22105263157894736,0.979381443298969,0.1664114756761971,0.9243356210202924
32,73,3,108,0.3047619047619048,0.9722222222222222,0.19191837746603926,0.9230884554874127
91,254,33,378,0.263768115942029,0.9126984126984127,0.2148603078613858,0.9334739430157573
5,72,20,97,0.06493506493506493,0.7938144329896907,0.19265974813055972,0.913089156798865
0,27,6,33,0.0,0.8181818181818182,0.18280753138179123,0.8963317206865903
0,12,2,14,0.0,0.8571428571428571,0.1692020892049205,0.8824170639147905
1,8,2,11,0.1111111111111111,0.8181818181818182,0.13794697547557996,0.8788032863879696
43,137,59,239,0.2388888888888889,0.7531380753138075,0.14049501223414304,0.8464828052472323
36,97,23,156,0.2706766917293233,0.8525641025641025,0.13562569608663141,0.8293887881532153
3,17,4,24,0.15,0.8333333333333334,0.11937310809491299,0.8180509196724896
1,20,101,122,0.047619047619047616,0.1721311475409836,0.11689939133548193,0.7292390217512457
5,35,9,49,0.125,0.8163265306122449,0.1347565341926248,0.728973980669878
17,147,24,188,0.10365853658536585,0.8723404255319149,0.14956489656196276,0.7311450618683148
14,118,3,135,0.10606060606060606,0.9777777777777777,0.14884339584046205,0.7539444846677377
15,123,7,145,0.10869565217391304,0.9517241379310345,0.13024436202403694,0.7823139221844845
13,91,2,106,0.125,0.9811320754716981,0.10943340606270503,0.800680775456998
52,166,6,224,0.23853211009174313,0.9732142857142857,0.12208085036152548,0.8206637686542769
6,76,1,83,0.07317073170731707,0.9879518072289156,0.12573109094556398,0.9372095771811244
3,49,1,53,0.057692307692307696,0.9811320754716981,0.11611570633017936,0.9607532264467605
1,28,8,37,0.034482758620689655,0.7837837837837838,0.10623345233522563,0.9481022776255991
4,151,4,159,0.025806451612903226,0.9748427672955975,0.09476857312841093,0.947682990413859
16,99,16,131,0.1391304347826087,0.8778625954198473,0.09911639921536744,0.9371313414836893
36,65,24,125,0.3564356435643564,0.808,0.1321786340102755,0.9123981878448753
16,85,2,103,0.15841584158415842,0.9805825242718447,0.12073345279490626,0.913450793353098
5,58,1,64,0.07936507936507936,0.984375,0.12161835960315802,0.9129398208918243
9,99,12,120,0.08333333333333333,0.9,0.12528136326616168,0.9013495243958676
10,36,1,47,0.21739130434782608,0.9787234042553191,0.15141115551289544,0.9291980416060869
13,84,1,98,0.13402061855670103,0.9897959183673469,0.16687032221915227,0.9313342060449081
3,22,4,29,0.12,0.8620689655172413,0.16413740296449392,0.9290779732016787
5,63,13,81,0.07352941176470588,0.8395061728395061,0.12372222699311526,0.933578855035894
17,34,1,52,0.3333333333333333,0.9807692307692307,0.14871044010014023,0.9336055273926634
0,2,58,60,0.0,0.03333333333333333,0.1373725716194146,0.7977424321545682
5,166,9,180,0.029239766081871343,0.95,0.12964491915492005,0.8048852892974253
17,169,13,199,0.0913978494623656,0.9346733668341709,0.11164585417128282,0.7985924268086898
47,86,4,137,0.3533834586466165,0.9708029197080292,0.1429834027555565,0.7958791412859301
3,53,7,63,0.05357142857142857,0.8888888888888888,0.13349360683718914,0.7997105589104512
28,178,6,212,0.13592233009708737,0.9716981132075472,0.14240688088467218,0.8185951218201712
0,14,51,65,0.0,0.2153846153846154,0.09478783326562458,0.709254462479512
4,8,2,14,0.3333333333333333,0.8571428571428571,0.1424068808846722,0.826941537309444
19,54,5,78,0.2602739726027397,0.9358974358974359,0.17541176753051052,0.8249268852947919
0,61,3,64,0.0,0.953125,0.16235493189302974,0.8275628328899103
33,78,32,143,0.2972972972972973,0.7762237762237763,0.1543426231288413,0.7997658123921599
24,92,393,509,0.20689655172413793,0.22789783889980353,0.17624621215065692,0.7053385195365764
0,45,9,54,0.0,0.8333333333333334,0.15682873642250159,0.6855721224116886
17,64,20,101,0.20987654320987653,0.801980198019802,0.1868110997381982,0.7693714913595724
2,0,0,2,1.0,1.0,0.28204919497629344,0.7897796546248786
1,15,1,17,0.0625,0.9411764705882353,0.2537957703187592,0.79053380243785
14,79,2,95,0.15053763440860216,0.9789473684210527,0.2753011466628452,0.794222712212286
15,103,23,141,0.1271186440677966,0.8368794326241135,0.25098991048720226,0.8028878059837627
13,46,4,63,0.22033898305084745,0.9365079365079365,0.2529102578195893,0.9041178199277817
2,25,2,29,0.07407407407407407,0.9310344827586207,0.26349226840159995,0.9180751269885371
2,21,1,24,0.08695652173913043,0.9583333333333334,0.24840282956424758,0.9427315227166133
32,66,19,117,0.32653061224489793,0.8376068376068376,0.15219291702780444,0.9195324995175902
20,89,2,111,0.1834862385321101,0.9819819819819819,0.16947666538953446,0.9253618582881253
31,92,3,126,0.25203252032520324,0.9761904761904762,0.18328991031810027,0.9246815861792819
86,295,35,416,0.22572178477690288,0.9158653846153846,0.19978784807588054,0.9345671173148131
6,80,20,106,0.06976744186046512,0.8113207547169812,0.17827762790582588,0.9166832342018194
0,34,6,40,0.0,0.85,0.1634993027826732,0.9044712526349992
0,12,2,14,0.0,0.8571428571428571,0.151076942534226,0.890015470322074
2,12,2,16,0.14285714285714285,0.875,0.1248378754788324,0.8953573506639543
42,165,59,266,0.2028985507246377,0.7781954887218046,0.1276110629349078,0.8662449944839289
35,112,23,170,0.23809523809523808,0.8647058823529412,0.12562002261634134,0.8503186239357098
3,19,4,26,0.13636363636363635,0.8461538461538461,0.11285457284301754,0.8403598327269185
1,17,107,125,0.05555555555555555,0.144,0.1108243033708876,0.7450282963387783
6,38,9,53,0.13636363636363635,0.8301886792452831,0.13030482285140707,0.742198107659533
10,170,27,207,0.05555555555555555,0.8695652173913043,0.13824133078791503,0.7439727305521684
13,150,3,166,0.07975460122699386,0.9819277108433735,0.12922668198360804,0.7592481178155074
15,128,7,150,0.1048951048951049,0.9533333333333334,0.1152261897222462,0.7842678099028687
9,106,2,117,0.0782608695652174,0.9829059829059829,0.0923927085036718,0.8011535385533032
52,166,6,224,0.23853211009174313,0.9732142857142857,0.1069882047505442,0.8193050299190803
10,91,1,102,0.09900990099009901,0.9901960784313726,0.11319596838405041,0.9401901839807049
3,52,5,60,0.05454545454545454,0.9166666666666666,0.10150765669573872,0.9525441821837598
1,29,9,39,0.03333333333333333,0.7692307692307693,0.09833305352113554,0.9382106895893976
4,156,4,164,0.025,0.975609756097561,0.09051096763156499,0.9373081246257101
15,109,16,140,0.12096774193548387,0.8857142857142857,0.09280705863733342,0.9276482606801318
33,82,25,140,0.28695652173913044,0.8214285714285714,0.12262072323360672,0.9045800590405016
15,92,2,109,0.14018691588785046,0.981651376146789,0.10857140977590776,0.9057853576737164
6,58,2,66,0.09375,0.9696969696969697,0.10781999534875077,0.9028569135688017
10,111,12,133,0.08264462809917356,0.9097744360902256,0.11183416299928205,0.9018723092007387
10,38,2,50,0.20833333333333334,0.96,0.13683416299928206,0.929125056453486
12,87,1,100,0.12121212121212122,0.99,0.15057875174387078,0.9311808055824058
2,24,4,30,0.07692307692307693,0.8666666666666667,0.14428665674209837,0.9284597171470316
6,78,12,96,0.07142857142857142,0.875,0.11349694955487566,0.9361127783715214
17,37,2,56,0.3148148148148148,0.9642857142857143,0.1384437922587277,0.9336319695342251
0,4,59,63,0.0,0.06349206349206349,0.12505093511587057,0.804174125790667
5,194,9,208,0.02512562814070352,0.9567307692307693,0.11683393512180341,0.8108821733821732
17,206,12,235,0.07623318385650224,0.948936170212766,0.09796248519654183,0.8093016262697112
37,98,16,151,0.2740740740740741,0.8940397350993378,0.11979990703396368,0.7955930169981881
6,52,7,65,0.10344827586206896,0.8923076923076924,0.1235892211681054,0.7992560206611917
28,194,6,228,0.12612612612612611,0.9736842105263158,0.13140315755347035,0.813353765022094
0,10,55,65,0.0,0.15384615384615385,0.08642961257992536,0.6975766849592997
4,9,2,15,0.3076923076923077,0.8666666666666667,0.1303856565359693,0.812315913984243
20,64,5,89,0.23809523809523808,0.9438202247191011,0.16080988652947426,0.8104715504825762
0,62,3,65,0.0,0.9538461538461539,0.1499194316928311,0.8111729767159171
33,80,32,145,0.2920353982300885,0.7793103448275862,0.15248533514369028,0.7947830638199527
21,123,452,596,0.14583333333333334,0.24161073825503357,0.15854034335387093,0.7018263560981444
1,50,9,60,0.0196078431372549,0.85,0.14332344578403217,0.6841571831658134
18,68,20,106,0.20930232558139536,0.8113207547169812,0.1732237780099458,0.7780821261473603
2,0,0,2,1.0,1.0,0.2721248769110447,0.7971297451949794
1,15,1,17,0.0625,0.9411764705882353,0.24703984289743924,0.7967520660334271
13,90,2,105,0.1262135922330097,0.9809523809523809,0.2650703560735835,0.8006243841914593
13,113,24,150,0.10317460317460317,0.84,0.23809024249422844,0.8092943349303757
13,46,4,63,0.22033898305084745,0.9365079365079365,0.24873390673958765,0.9085653632522189
2,27,2,31,0.06896551724137931,0.9354838709677419,0.2557850030401768,0.9207773448190393
2,21,1,24,0.08695652173913043,0.9583333333333334,0.23568683976859633,0.9417791417642324
31,67,19,117,0.3163265306122449,0.8376068376068376,0.13801920128463133,0.9185801185652093
21,88,2,111,0.1926605504587156,0.9819819819819819,0.15661356563587642,0.9244094773357444
31,92,3,126,0.25203252032520324,0.9761904761904762,0.17736162332449767,0.9237292052269009
82,299,35,416,0.2152230971128609,0.9158653846153846,0.1956361247261082,0.9345671173148131
7,79,20,106,0.08139534883720931,0.8113207547169812,0.1733657266181066,0.9166832342018194
0,34,6,40,0.0,0.85,0.16351350986933813,0.9044712526349992
0,12,2,14,0.0,0.8571428571428571,0.15109114962089093,0.890015470322074
2,12,2,16,0.14285714285714285,0.875,0.12630980851301923,0.8953573506639543
41,170,55,266,0.1943127962085308,0.793233082706767,0.12654584362013568,0.8683932221960663
35,112,23,170,0.23809523809523808,0.8647058823529412,0.12455480330156922,0.8524668516478472
3,19,4,26,0.13636363636363635,0.8461538461538461,0.11328916605168,0.8425080604390559
2,23,100,125,0.08,0.2,0.11308983050350727,0.7551765240509158
5,39,9,53,0.11363636363636363,0.8301886792452831,0.1293235967372735,0.7523463353716705
12,168,27,207,0.06666666666666667,0.8695652173913043,0.138847406261083,0.7541209582643058
12,151,3,166,0.0736196319018405,0.9819277108433735,0.1289563332674684,0.7693963455276449
16,127,7,150,0.11188811188811189,0.9533333333333334,0.1171813783645514,0.7922678099028687
9,106,2,117,0.0782608695652174,0.9829059829059829,0.09434789714597702,0.8091535385533033
52,166,6,224,0.23853211009174313,0.9732142857142857,0.1089433933928494,0.8273050299190804
11,90,1,102,0.10891089108910891,0.9901960784313726,0.11307352069129353,0.940190183980705
3,56,1,60,0.05084745762711865,0.9833333333333333,0.1041036769756871,0.9620679917075693
1,29,9,39,0.03333333333333333,0.7692307692307693,0.09934177221378235,0.9477344991132072
4,156,4,164,0.025,0.975609756097561,0.09239611051351941,0.9468319341495197
15,109,16,140,0.12096774193548387,0.8857142857142857,0.09369320052028685,0.9371720702039413
32,83,25,140,0.2782608695652174,0.8214285714285714,0.12226462909171543,0.914103868564311
14,93,2,109,0.1308411214953271,0.981651376146789,0.10688020214937029,0.9153091671975259
6,58,2,66,0.09375,0.9696969696969697,0.10471436056521187,0.9123807230926112
10,108,15,133,0.0847457627118644,0.8872180451127819,0.1095569755773184,0.8986499676325325
10,38,2,50,0.20833333333333334,0.96,0.1345569755773184,0.9259027148852796
13,86,1,100,0.13131313131313133,0.99,0.1497445657649086,0.9279584640141996
2,24,4,30,0.07692307692307693,0.8666666666666667,0.14345247076313616,0.9252373755788253
6,78,12,96,0.07142857142857142,0.875,0.11390499960075817,0.9328904368033152
14,40,2,56,0.25925925925925924,0.9642857142857143,0.13225044785274848,0.9304096279660188
0,4,59,63,0.0,0.06349206349206349,0.11885759070989133,0.8009517842224607
4,195,9,208,0.020100502512562814,0.9567307692307693,0.10962255353856253,0.8108821733821732
17,204,14,235,0.07692307692307693,0.9404255319148936,0.09084965976566876,0.8080858207985866
35,101,15,151,0.25735294117647056,0.9006622516556292,0.10885534688900293,0.7953232853208193
5,53,7,65,0.08620689655172414,0.8923076923076924,0.11018160683595256,0.7989862889838231
30,192,6,228,0.13513513513513514,0.9736842105263158,0.11928254450831878,0.8130840333447253
0,11,54,65,0.0,0.16923076923076924,0.08224550747128176,0.6995047554797331
4,8,3,15,0.3333333333333333,0.8,0.12986455509032938,0.804720174980867
20,64,5,89,0.23809523809523808,0.9438202247191011,0.16100666017356868,0.8028758114792002
0,62,3,65,0.0,0.9538461538461539,0.15001764918455773,0.8047930431836658
31,82,32,145,0.2743362831858407,0.7793103448275862,0.152443840900182,0.7874570564939454
19,126,451,596,0.1310344827586207,0.24328859060402686,0.1588477817868815,0.6947400419648503
1,50,9,60,0.0196078431372549,0.85,0.14234388293004147,0.6770708690325195
18,68,20,106,0.20930232558139536,0.8113207547169812,0.1722442151559551,0.768798009816264
2,0,0,2,1.0,1.0,0.26748231039405035,0.7973694383876927
1,15,1,17,0.0625,0.9411764705882353,0.2423972763804449,0.7969917592261405
16,87,2,105,0.1553398058252427,0.9809523809523809,0.2645886772126224,0.8008640773841728
14,113,23,150,0.11023622047244094,0.8466666666666667,0.24114581111070815,0.8104864090754699
13,46,4,63,0.22033898305084745,0.9365079365079365,0.2539035968667406,0.9095177442046
3,26,2,31,0.10344827586206896,0.9354838709677419,0.265880801541714,0.9217297257714202
2,21,1,24,0.08695652173913043,0.9583333333333334,0.24436692628516718,0.9417791417642325
32,67,18,117,0.32323232323232326,0.8461538461538461,0.14768582960407053,0.9198011197862105
21,88,2,111,0.1926605504587156,0.9819819819819819,0.1662801939553156,0.9256304785567456
29,94,3,126,0.23577235772357724,0.9761904761904762,0.18193144616825382,0.9249502064479022
93,286,37,416,0.24538258575197888,0.9110576923076923,0.2011130854026635,0.9351013053490009
5,81,20,106,0.05813953488372093,0.8113207547169812,0.17794173566450255,0.9172174222360073
0,34,6,40,0.0,0.85,0.16316341054134983,0.9050054406691872
0,12,2,14,0.0,0.8571428571428571,0.15074105029290266,0.890549658356262
2,12,2,16,0.14285714285714285,0.875,0.12497316738216259,0.8946705374771412
40,167,59,266,0.1932367149758454,0.7781954887218046,0.12505547659889543,0.8655581812971158
35,112,23,170,0.23809523809523808,0.8647058823529412,0.12538731665198985,0.8496318107488964
3,19,4,26,0.13636363636363635,0.8461538461538461,0.10981318102508375,0.8403598327269185
2,24,99,125,0.07692307692307693,0.208,0.11249654417356318,0.7541711534816354
6,37,10,53,0.13953488372093023,0.8113207547169812,0.13243009899083893,0.7486455470126329
15,167,25,207,0.08241758241758242,0.8792270531400966,0.14420403933620785,0.7518004321550956
16,147,3,166,0.09815950920245399,0.9819277108433735,0.1378186630998237,0.7670758194184346
17,126,7,150,0.11888111888111888,0.9533333333333334,0.12719643508629136,0.7920955115057958
13,102,2,117,0.11304347826086956,0.9829059829059829,0.10933189796709586,0.8089812401562304
51,167,6,224,0.23394495412844038,0.9732142857142857,0.12327208621921074,0.8271327315220074
10,91,1,102,0.09900990099009901,0.9901960784313726,0.1264273468002139,0.9388750284407751
3,52,5,60,0.05454545454545454,0.9166666666666666,0.11428599977514593,0.9539244444335873
1,29,9,39,0.03333333333333333,0.7692307692307693,0.10727396419168178,0.9382106895893976
4,156,4,164,0.025,0.975609756097561,0.09682260573418833,0.9373081246257101
16,108,16,140,0.12903225806451613,0.8857142857142857,0.09827276847467366,0.9276482606801318
34,81,25,140,0.2956521739130435,0.8214285714285714,0.12435972499641279,0.9045800590405015
14,93,2,109,0.1308411214953271,0.981651376146789,0.10963060604882517,0.9057853576737164
5,60,1,66,0.07692307692307693,0.9848484848484849,0.10647534546782202,0.9050214157333037
10,111,12,133,0.08264462809917356,0.9097744360902256,0.11048951311835331,0.9040368113652407
11,37,2,50,0.22916666666666666,0.96,0.13846570359454377,0.931289558617988
14,85,1,100,0.1414141414141414,0.99,0.1550962952251354,0.9333453077469079
2,24,4,30,0.07692307692307693,0.8666666666666667,0.1476521264906441,0.9306242193115338
7,77,12,96,0.08333333333333333,0.875,0.11732086355068551,0.9382772805360234
17,38,1,56,0.3090909090909091,0.9821428571428571,0.14278511892148293,0.9383474921068905
0,4,59,63,0.0,0.06349206349206349,0.13179610793247196,0.8067251461988303
5,195,9,209,0.025,0.9569377990430622,0.12356116106116144,0.8134627694778069
18,204,13,235,0.08108108108108109,0.9446808510638298,0.10240607740607778,0.8112743196297826
42,102,7,151,0.2916666666666667,0.9536423841059603,0.12387072387072426,0.8060803745020627
6,57,2,65,0.09523809523809523,0.9692307692307692,0.12648715505858402,0.8207323891540774
32,190,6,228,0.14414414414414414,0.9736842105263158,0.1351744137458427,0.8348301335149796
0,14,51,65,0.0,0.2153846153846154,0.09101856958999854,0.7252932418352307
4,9,2,15,0.3076923076923077,0.8666666666666667,0.1349746135460425,0.8400324708601741
20,64,5,89,0.23809523809523808,0.9438202247191011,0.16541679041679078,0.8381585316710368
0,62,3,65,0.0,0.9538461538461539,0.1538337788337792,0.8394678606399403
31,82,32,145,0.2743362831858407,0.7793103448275862,0.15135800976508978,0.8145632836001724
14,116,466,596,0.1076923076923077,0.2181208053691275,0.15313718297283443,0.7072618601913664
1,50,9,60,0.0196078431372549,0.85,0.1353462828289931,0.6895926872590357
17,69,20,106,0.19767441860465115,0.8113207547169812,0.1635854854868004,0.7747264214493736
2,0,0,2,1.0,1.0,0.2624865843878993,0.7937740404969927
1,15,1,17,0.0625,0.9411764705882353,0.23740155037429386,0.7933963613354403
11,92,2,105,0.10679611650485436,0.9809523809523809,0.2526581384464159,0.7972686794934728
11,115,24,150,0.0873015873015873,0.84,0.22593889617723686,0.8059386302323891
14,45,4,63,0.23728813559322035,0.9365079365079365,0.2444525858773672,0.9085653632522189
2,27,2,31,0.06896551724137931,0.9354838709677419,0.25150368217795643,0.9207773448190393
1,22,1,24,0.043478260869565216,0.9583333333333334,0.23401596686758566,0.9436839036689942
32,68,17,117,0.32,0.8547008547008547,0.13687310972472852,0.9229268829119736
18,91,2,111,0.1651376146788991,0.9819819819819819,0.15153562610742838,0.9287562416825088
30,93,3,126,0.24390243902439024,0.9761904761904762,0.16973528105820815,0.9280759695736653
87,293,36,416,0.22894736842105262,0.9134615384615384,0.18681704797550136,0.9366657131634089
6,80,20,106,0.06976744186046512,0.8113207547169812,0.1628855202993935,0.9187818300504152
0,34,6,40,0.0,0.85,0.15303330355062503,0.9065698484835949
0,12,2,14,0.0,0.8571428571428571,0.14682212342640139,0.8921140661706699
2,12,2,16,0.14285714285714285,0.875,0.1215160009774218,0.8950139440705477
36,171,59,266,0.17391304347826086,0.7781954887218046,0.12276963366304491,0.8659015878905224
34,114,23,171,0.22972972972972974,0.8654970760233918,0.12074496090666484,0.8500882450095103
2,20,4,26,0.09090909090909091,0.8461538461538461,0.1010252069763846,0.8404728603941257
1,26,98,125,0.037037037037037035,0.216,0.09634943485875201,0.7554270382916998
5,38,10,53,0.11627906976744186,0.8113207547169812,0.11296073053981515,0.7499014318226972
15,164,27,206,0.08379888268156424,0.8689320388349514,0.12493199949432432,0.7515856006358534
15,148,3,166,0.09202453987730061,0.9819277108433735,0.11767019906863256,0.7668609878991924
15,128,7,150,0.1048951048951049,0.9533333333333334,0.10781049355675314,0.7918806799865538
9,106,2,117,0.0782608695652174,0.9829059829059829,0.08617208496182281,0.808653380969781
51,167,6,224,0.23394495412844038,0.9732142857142857,0.10660577970744416,0.8268048723355582
10,91,1,102,0.09900990099009901,0.9901960784313726,0.11545904598645303,0.9374043121114685
3,56,1,60,0.05084745762711865,0.9833333333333333,0.10611167282354969,0.9619775376280902
1,29,9,39,0.03333333333333333,0.7692307692307693,0.09890230863094528,0.9477344991132071
4,156,4,164,0.025,0.975609756097561,0.08932737436275948,0.9468319341495196
16,108,16,140,0.12903225806451613,0.8857142857142857,0.09277553910124679,0.9371720702039414
36,79,25,140,0.3130434782608696,0.8214285714285714,0.12631591177205426,0.9141038685643111
15,92,2,109,0.14018691588785046,0.981651376146789,0.11292190630911282,0.9153091671975259
5,59,2,66,0.078125,0.9696969696969697,0.10993834902481296,0.9123807230926112
10,111,12,133,0.08264462809917356,0.9097744360902256,0.11448080194939225,0.9018723092007387
11,37,2,50,0.22916666666666666,0.96,0.1424569924255827,0.929125056453486
13,86,1,100,0.13131313131313133,0.99,0.1576445826131729,0.9311808055824058
3,23,4,30,0.11538461538461539,0.8666666666666667,0.1556949193731871,0.9284597171470316
7,77,12,96,0.08333333333333333,0.875,0.12287918438353906,0.9361127783715214
17,38,1,56,0.3090909090909091,0.9821428571428571,0.14700832626969026,0.9361829899423884
0,4,59,63,0.0,0.06349206349206349,0.13584761198397602,0.8067251461988303
6,194,9,209,0.03,0.9569377990430622,0.1283269508269512,0.8134627694778069
17,205,13,235,0.07657657657657657,0.9446808510638298,0.10652836652836692,0.8112743196297826
46,102,3,151,0.3108108108108108,0.9801324503311258,0.13217089217089256,0.8098646696770863
4,59,2,65,0.06349206349206349,0.9692307692307692,0.12475767047195656,0.824516684329101
32,190,6,228,0.14414414414414414,0.9736842105263158,0.13344492915921524,0.8386144286900032
0,15,50,65,0.0,0.23076923076923078,0.08928908500337109,0.7312753392080565
4,9,2,15,0.3076923076923077,0.8666666666666667,0.13324512895941504,0.8460145682329999
20,64,5,89,0.23809523809523808,0.9438202247191011,0.16297302011587764,0.8441406290438627
0,62,3,65,0.0,0.9538461538461539,0.1520335091763667,0.8454499580127661
32,81,32,145,0.2831858407079646,0.7793103448275862,0.1480870848759601,0.8167610857979747
21,110,465,596,0.16030534351145037,0.2197986577181208,0.1619175534501582,0.709699355581882
1,50,9,60,0.0196078431372549,0.85,0.14412665330631688,0.6920301826495513
17,69,20,106,0.19767441860465115,0.8113207547169812,0.1723658559641242,0.774966114642087
2,0,0,2,1.0,1.0,0.2712669548652231,0.794013733689706
1,15,1,17,0.0625,0.9411764705882353,0.24618192085161766,0.7936360545281538
13,90,2,105,0.1262135922330097,0.9809523809523809,0.2642124340277619,0.7975083726861862
14,112,24,150,0.1111111111111111,0.84,0.23963032979964,0.8061783234251025
13,46,4,63,0.22033898305084745,0.9365079365079365,0.24820656401955388,0.908565363252219
3,26,2,31,0.10344827586206896,0.9354838709677419,0.2601837686945273,0.9207773448190392
2,21,1,24,0.08695652173913043,0.9583333333333334,0.2417073457566114,0.9413924655213025
33,69,15,117,0.3235294117647059,0.8717948717948718,0.1450686902944265,0.9230774472062843
18,90,2,110,0.16666666666666666,0.9818181818181818,0.1599496426753789,0.9288834059534193
29,94,3,126,0.23577235772357724,0.9761904761904762,0.17499786769179054,0.9285215590870133
90,290,35,415,0.23684210526315788,0.9156626506024096,0.1920257314688803,0.9387631332865469
7,79,20,106,0.08139534883720931,0.8113207547169812,0.17217664086693205,0.9208792501735534
0,35,5,40,0.0,0.875,0.16159463028492144,0.912874324065179
0,13,1,14,0.0,0.9285714285714286,0.14917227003647424,0.908622623384907
2,13,1,16,0.13333333333333333,0.9375,0.1220014016891353,0.9180090702713538
40,171,55,266,0.1895734597156398,0.793233082706767,0.12527380069613145,0.891068341826866
35,113,23,171,0.23648648648648649,0.8654970760233918,0.12537581909083279,0.8752549989458539
2,24,0,26,0.07692307692307693,1.0,0.10253024361367835,0.8873031917169383
2,57,66,125,0.03389830508474576,0.472,0.0957449516490407,0.8388287981859409
5,45,3,53,0.1,0.9433962264150944,0.110030665934755,0.8485996876738114
15,166,25,206,0.08287292817679558,0.8786407766990292,0.12186965567429721,0.8414667374063259
14,149,3,166,0.08588957055214724,0.9819277108433735,0.11509197527698492,0.8478135532410935
18,125,7,150,0.1258741258741259,0.9533333333333334,0.10599207044248295,0.8706850176163172
9,106,2,117,0.0782608695652174,0.9829059829059829,0.08338841088230164,0.8874577185995446
51,166,6,223,0.2350230414746544,0.9730941704035875,0.10597412010395556,0.8836140286572
10,91,1,102,0.09900990099009901,0.9901960784313726,0.11527577666186317,0.9576420398616818
2,57,1,60,0.03389830508474576,0.9833333333333333,0.10583267738825543,0.9633473408500016
1,29,9,39,0.03333333333333333,0.7692307692307693,0.09875559241061796,0.9477173397831073
4,156,4,164,0.025,0.975609756097561,0.09005708233173979,0.9468147748194199
16,109,15,140,0.128,0.8928571428571429,0.09036077863543608,0.938175319037107
35,79,25,139,0.30701754385964913,0.8201438848920863,0.1230403035346406,0.9149235907494074
15,92,2,109,0.14018691588785046,0.981651376146789,0.10949228559366862,0.916146048712722
5,60,1,66,0.07692307692307693,0.9848484848484849,0.10633702501266548,0.9153821067723094
9,112,12,133,0.0743801652892562,0.9097744360902256,0.11212014789902411,0.9048736928804368
11,37,2,50,0.22916666666666666,0.96,0.14009633837521457,0.9321264401331841
14,85,1,100,0.1414141414141414,0.99,0.1567269300058062,0.934182189262104
3,23,4,30,0.11538461538461539,0.8666666666666667,0.15492473220360842,0.9304406926634644
7,84,5,96,0.07692307692307693,0.9479166666666666,0.12205409406981237,0.9486939472026903
21,34,1,56,0.38181818181818183,0.9821428571428571,0.156572846345574,0.948764158773557
0,4,59,63,0.0,0.06349206349206349,0.14558383535656302,0.817141812865497
6,194,9,209,0.03,0.9569377990430622,0.13924381174381212,0.8238794361444736
17,205,12,234,0.07657657657657657,0.9487179487179487,0.11744522744522783,0.822267714532752
39,99,11,149,0.2826086956521739,0.9261744966442953,0.13761587805066103,0.8131497854819371
3,60,2,65,0.047619047619047616,0.9692307692307692,0.1279350826555799,0.8278018001339518
30,192,6,228,0.13513513513513514,0.9736842105263158,0.13625109097158825,0.8314828778281873
4,60,1,65,0.0625,0.9846153846153847,0.09063420785470512,0.8318360960385485
4,10,1,15,0.2857142857142857,0.9333333333333333,0.13145053438531737,0.9560991345873012
19,64,5,88,0.2289156626506024,0.9431818181818182,0.1598670576211177,0.9541339944642663
0,62,3,65,0.0,0.9538461538461539,0.14892754668160677,0.954866595196867
33,83,28,144,0.28448275862068967,0.8055555555555556,0.14919526996282334,0.9376353178984757
19,119,458,596,0.13768115942028986,0.23154362416107382,0.16206128593442934,0.8322514400313763
1,50,9,60,0.0196078431372549,0.85,0.1455573870775893,0.8145822670990455
16,70,20,106,0.18604651162790697,0.8113207547169812,0.16320688873871886,0.7898258913992736
2,0,0,2,1.0,1.0,0.2652477050652495,0.7993497009230832
1,15,1,17,0.0625,0.9411764705882353,0.2414740389723063,0.7990632226954284
12,91,2,105,0.11650485436893204,0.9809523809523809,0.25811758959643943,0.8029355408534607
14,114,22,150,0.109375,0.8533333333333334,0.23310219550776948,0.8097609376788577
14,45,4,63,0.23728813559322035,0.9365079365079365,0.24733176353247385,0.9104701251569809
2,27,2,31,0.06896551724137931,0.9354838709677419,0.254382859833063,0.9226821067238012
2,19,1,22,0.09523809523809523,0.9545454545454546,0.23616304992479303,0.940851339980177
33,65,17,115,0.336734693877551,0.8521739130434782,0.14141086333587174,0.9197333275578167
19,75,2,96,0.20212765957446807,0.9791666666666666,0.16135767184651004,0.9251604984261641
31,74,3,108,0.29523809523809524,0.9722222222222222,0.18800659228425035,0.9242317581357218
92,250,35,377,0.26900584795321636,0.9071618037135278,0.21082975663771103,0.9332589256368438
4,73,20,97,0.05194805194805195,0.7938144329896907,0.18919521684336496,0.9128741394199514
0,29,4,33,0.0,0.8787878787878788,0.17861320626135438,0.9054103388527027
0,12,2,14,0.0,0.8571428571428571,0.16500776408448362,0.8914956820809029
1,8,2,11,0.1111111111111111,0.8181818181818182,0.1327758236892779,0.8866396685292373
36,144,59,239,0.2,0.7531380753138075,0.13247187232149676,0.8543498697645431
33,102,23,158,0.24444444444444444,0.8544303797468354,0.12521563649383236,0.8375224636966306
2,18,4,24,0.1,0.8333333333333334,0.10107194392908717,0.8269755393566028
3,23,96,122,0.11538461538461539,0.21311475409836064,0.11013431013431052,0.7440184423721271
4,34,10,48,0.10526315789473684,0.7916666666666666,0.12517190411927293,0.7315725549262398
10,152,26,188,0.06172839506172839,0.8617021276595744,0.1339902462709484,0.7322238792857707
13,118,3,134,0.09923664122137404,0.9776119402985075,0.1322938934295574,0.7549996110167264
15,122,7,144,0.10948905109489052,0.9513888888888888,0.11936375787168461,0.7833211558131665
10,94,2,106,0.09615384615384616,0.9811320754716981,0.09817938668731342,0.8014213980595756
45,172,6,223,0.2073732718894009,0.9730941704035875,0.11351842552865642,0.8213872319267547
6,76,1,83,0.07317073170731707,0.9879518072289156,0.10748787071761379,0.9320782395168339
3,45,5,53,0.0625,0.9056603773584906,0.1013788481612228,0.9483630553299517
1,28,8,37,0.034482758620689655,0.7837837837837838,0.09748661438393158,0.9372318633476959
4,151,4,159,0.025806451612903226,0.9748427672955975,0.08699658729700717,0.9368362672044229
14,91,26,131,0.13333333333333333,0.8015267175572519,0.09040291333107042,0.9154273855856178
31,68,25,124,0.31313131313131315,0.7983870967741935,0.12139969432785144,0.8893209600574028
16,85,2,103,0.15841584158415842,0.9805825242718447,0.11440577571281678,0.8903907248957253
5,58,1,64,0.07936507936507936,0.984375,0.11529068252106855,0.8898797524344516
7,101,12,120,0.06481481481481481,0.9,0.11562137035175638,0.8890711270975242
10,36,1,47,0.21739130434782608,0.9787234042553191,0.14175116259849016,0.9169196443077438
14,82,1,97,0.14583333333333334,0.9896907216494846,0.15889785998712305,0.9190407806440133
3,22,4,29,0.12,0.8620689655172413,0.15699309808236112,0.9276896732097261
5,65,11,81,0.07142857142857142,0.8641975308641975,0.12246413498196944,0.9370911637940124
18,33,1,52,0.35294117647058826,0.9807692307692307,0.1502534685371737,0.9371178361507818
0,2,59,61,0.0,0.03278688524590164,0.13891560005644807,0.8011766769001962
5,168,9,182,0.028901734104046242,0.9505494505494505,0.13378515995490972,0.8083980269786892
17,168,13,198,0.0918918918918919,0.9343434343434344,0.11585667246120483,0.8020580312769914
37,88,12,137,0.296,0.9124087591240876,0.13730905341358576,0.7910177509162205
4,52,7,63,0.07142857142857142,0.8888888888888888,0.1303702779033817,0.7948491685407415
28,175,6,209,0.13793103448275862,0.9712918660287081,0.1398706297682656,0.8101483592785287
0,15,50,65,0.0,0.23076923076923078,0.08945046170103868,0.7030055021356716
4,9,1,14,0.3076923076923077,0.9285714285714286,0.13340650565708265,0.8309747226107468
19,51,5,75,0.2714285714285714,0.9333333333333333,0.16805319670344337,0.8285152772941586
0,61,3,64,0.0,0.953125,0.15492578357603026,0.8311983581022394
32,76,33,141,0.2962962962962963,0.7659574468085106,0.1549681116183583,0.810276742057157
23,76,408,507,0.23232323232323232,0.1952662721893491,0.1779530631747384,0.7111877968143656
1,44,9,54,0.022222222222222223,0.8333333333333334,0.16142323285180463,0.6914794350007407
18,63,20,101,0.2222222222222222,0.801980198019802,0.1931692645978364,0.7730810017508223
2,0,0,2,1.0,1.0,0.2920703634989353,0.7832850833834755
1,15,1,17,0.0625,0.9411764705882353,0.2622234247234251,0.7844055315627472
12,80,2,94,0.13043478260869565,0.9787234042553191,0.28085696509609587,0.7880624464563641
14,105,22,141,0.11764705882352941,0.8439716312056738,0.2553356454571292,0.7992073299416731
13,46,4,63,0.22033898305084745,0.9365079365079365,0.2536236098467885,0.9050989962728998
2,25,2,29,0.07407407407407407,0.9310344827586207,0.2610310172541959,0.9190563033336553
2,19,1,22,0.09523809523809523,0.9545454545454546,0.2375808504994931,0.9412380162231069
30,67,18,115,0.30927835051546393,0.8434782608695652,0.13890632914455936,0.9188777677759019
18,76,2,96,0.19148936170212766,0.9791666666666666,0.15733338081629186,0.9243049386442493
30,75,3,108,0.2857142857142857,0.9722222222222222,0.18566704437880427,0.9230577731113695
84,258,36,378,0.24561403508771928,0.9047619047619048,0.20488174780403398,0.9323094737916416
5,72,20,97,0.06493506493506493,0.7938144329896907,0.18510249557926123,0.9119246875747493
0,29,4,33,0.0,0.8787878787878788,0.17032417045610848,0.9038252601204831
0,12,2,14,0.0,0.8571428571428571,0.15671872827923775,0.8899106033486835
1,8,2,11,0.1111111111111111,0.8181818181818182,0.12840912265004448,0.8862968258218624
33,148,58,239,0.18232044198895028,0.7573221757322176,0.12709927697673343,0.8546047556883698
32,103,23,158,0.23703703703703705,0.8544303797468354,0.12014538430855504,0.8377773496204574
2,18,4,24,0.1,0.8333333333333334,0.0993433792960237,0.8275732679878043
3,24,95,122,0.1111111111111111,0.22131147540983606,0.10593995732117319,0.7457871311906822
4,35,10,49,0.10256410256410256,0.7959183673469388,0.12059197197318783,0.7339486295562622
12,152,24,188,0.07317073170731707,0.8723404255319149,0.1310449336456617,0.7361197107546991
14,117,3,134,0.10687022900763359,0.9776119402985075,0.1304390933451649,0.7588954424856548
14,123,7,144,0.10218978102189781,0.9513888888888888,0.11899185606415741,0.7866192586508934
10,94,2,106,0.09615384615384616,0.9811320754716981,0.09886568593798728,0.8047195008973024
45,172,6,223,0.2073732718894009,0.9730941704035875,0.11420472477933027,0.8246853347644816
6,76,1,83,0.07317073170731707,0.9879518072289156,0.10878467057878825,0.9342053821672073
3,45,5,53,0.0625,0.9056603773584906,0.10306122735534504,0.9498828121688574
1,28,8,37,0.034482758620689655,0.7837837837837838,0.09753437405725542,0.9372318633476959
4,151,4,159,0.025806451612903226,0.9748427672955975,0.08595383442943678,0.9368362672044229
16,99,16,131,0.1391304347826087,0.8778625954198473,0.09123107068096692,0.9263325109945599
30,70,24,124,0.3,0.8064516129032258,0.12035194980184603,0.9013781591990639
15,85,2,102,0.15,0.9803921568627451,0.11215576810336018,0.9024207286932293
5,58,1,64,0.07936507936507936,0.984375,0.11304067491161195,0.9019097562319557
7,101,12,120,0.06481481481481481,0.9,0.11337136274229978,0.9011011308950284
10,36,1,47,0.21739130434782608,0.9787234042553191,0.13950115498903354,0.9289496481052477
13,84,1,98,0.13402061855670103,0.9897959183673469,0.1549603216952904,0.931085812544069
3,22,4,29,0.12,0.8620689655172413,0.152227402440632,0.9288295797008397
5,63,13,81,0.07352941176470588,0.8395061728395061,0.11987446126416142,0.9335516596917367
18,32,1,51,0.36,0.9803921568627451,0.1498744612641614,0.9335516596917367
0,2,59,61,0.0,0.03278688524590164,0.1385365927834358,0.7976105004411513
5,163,13,181,0.02976190476190476,0.9281767955801105,0.13352903420444862,0.8016357569525957
16,169,14,199,0.08648648648648649,0.9296482412060302,0.11482834593854298,0.7946250193741259
34,90,12,136,0.27419354838709675,0.9117647058823529,0.13485305020002808,0.7834777033048411
2,54,7,63,0.03571428571428571,0.8888888888888888,0.12281223387349748,0.787309120929362
28,176,6,210,0.13725490196078433,0.9714285714285714,0.1319158753300801,0.8061551778706572
0,14,51,65,0.0,0.2153846153846154,0.08048730390150867,0.6968683862309243
4,8,2,14,0.3333333333333333,0.8571428571428571,0.12810635152055627,0.8146335250733464
19,51,5,75,0.2714285714285714,0.9333333333333333,0.16263016104436584,0.8153701733238069
1,60,3,64,0.01639344262295082,0.953125,0.1526168690638607,0.8187239960086597
31,78,32,141,0.28440366972477066,0.7730496453900709,0.15407545782638557,0.7989075587954765
16,84,408,508,0.16,0.1968503937007874,0.1718305598672019,0.7000449166257479
1,44,9,54,0.022222222222222223,0.8333333333333334,0.15539731990455016,0.6803170254692852
19,64,20,103,0.2289156626506024,0.8058252427184466,0.1880995574260648,0.7646656865169754
2,0,0,2,1.0,1.0,0.28333765266416006,0.7850738497822816
1,15,1,17,0.0625,0.9411764705882353,0.2534907138886498,0.7861942979615533
10,82,2,94,0.10869565217391304,0.9787234042553191,0.26667674382450157,0.7898512128551702
13,106,22,141,0.1092436974789916,0.8439716312056738,0.24165389064653314,0.7999829251145422
12,47,4,63,0.2033898305084746,0.9365079365079365,0.24785243786202948,0.9056482883727063
2,25,2,29,0.07407407407407407,0.9310344827586207,0.2552598452694369,0.9196055954334615
2,20,1,23,0.09090909090909091,0.9565217391304348,0.2322894886391896,0.9415203425923897
30,68,19,117,0.30612244897959184,0.8376068376068376,0.13316412420770274,0.9183213193933666
21,88,2,111,0.1926605504587156,0.9819819819819819,0.15175848855894783,0.9241506781639018
31,91,3,125,0.2540983606557377,0.976,0.1741886288467994,0.9234431951707046
80,300,36,416,0.21052631578947367,0.9134615384615384,0.18952458779178089,0.9339377006652102
6,80,20,106,0.06976744186046512,0.8113207547169812,0.17043567512777955,0.9160538175522165
0,36,4,40,0.0,0.9,0.16058345837901106,0.9109846931282534
0,12,2,14,0.0,0.8571428571428571,0.14759644539199807,0.8967877099871708
1,12,2,15,0.07692307692307693,0.8666666666666667,0.11485367795535309,0.900939114138575
33,175,59,267,0.15865384615384615,0.7790262172284644,0.10999557734037177,0.8719454334595012
31,117,23,171,0.20945945945945946,0.8654970760233918,0.10361859145518915,0.8561593014628427
1,21,4,26,0.045454545454545456,0.8461538461538461,0.08003690997877082,0.846543916847458
1,30,94,125,0.03225806451612903,0.248,0.07467842750100852,0.7660695233164608
4,39,10,53,0.09302325581395349,0.8113207547169812,0.08796746404585902,0.7534010597046008
8,172,27,207,0.044444444444444446,0.8695652173913043,0.09431667039506537,0.7551756825972362
13,150,3,166,0.07975460122699386,0.9819277108433735,0.0947211738670535,0.7716415460510514
14,129,7,150,0.0979020979020979,0.9533333333333334,0.08604235268823232,0.7965425626374613
10,104,2,116,0.08771929824561403,0.9827586206896551,0.0686509010862544,0.813294211875499
45,172,6,223,0.2073732718894009,0.9730941704035875,0.0917821477198052,0.8314285439111764
10,90,1,101,0.1,0.9900990099009901,0.1014595670746439,0.9374426881827463
2,57,1,60,0.03389830508474576,0.9833333333333333,0.09301314554189995,0.962015913699368
1,29,9,39,0.03333333333333333,0.7692307692307693,0.09142584395459837,0.947682421105006
4,155,4,163,0.025157232704402517,0.9754601226993865,0.08362621987994245,0.9467584799415791
16,108,16,140,0.12903225806451613,0.8857142857142857,0.08807338561743076,0.937098615996001
32,83,24,139,0.2782608695652174,0.8273381294964028,0.11529361009165982,0.9148956886826792
11,96,2,109,0.102803738317757,0.981651376146789,0.10035510529571068,0.9161181466459937
5,59,2,66,0.078125,0.9696969696969697,0.09723010529571068,0.9132035694739907
6,115,12,133,0.049586776859504134,0.9097744360902256,0.09947131554924758,0.9026951555821183
9,40,1,50,0.1836734693877551,0.98,0.12094847784273642,0.9328050456920084
14,85,1,100,0.1414141414141414,0.99,0.1375566076584134,0.9348821710206675
3,23,4,30,0.11538461538461539,0.8666666666666667,0.13560694441842758,0.9321610825852932
6,79,11,96,0.07058823529411765,0.8854166666666666,0.1059394252368419,0.9404580164667594
15,39,2,56,0.2777777777777778,0.9642857142857143,0.13093571658827344,0.9379772076294631
0,4,59,63,0.0,0.06349206349206349,0.11977500230255915,0.8085193638859051
5,191,13,209,0.025510204081632654,0.937799043062201,0.11633549190572037,0.8125228791676158
16,207,12,235,0.07174887892376682,0.948936170212766,0.10034626469657917,0.8080851891980111
35,103,13,151,0.2536231884057971,0.9139072847682119,0.11637612855253002,0.7972148013077556
3,55,7,65,0.05172413793103448,0.8923076923076924,0.10728177463058988,0.8008778049707593
32,190,6,228,0.14414414414414414,0.9736842105263158,0.1177897616091651,0.8134874540935664
0,10,55,65,0.0,0.15384615384615385,0.07810722192662542,0.6977103740307719
4,10,1,15,0.2857142857142857,0.9333333333333333,0.11892354845723765,0.8219734125795248
20,62,5,87,0.24390243902439024,0.9425287356321839,0.15012243916334592,0.8226490829466652
0,62,3,65,0.0,0.9538461538461539,0.13987259931709348,0.8233505091800063
29,82,32,143,0.26126126126126126,0.7762237762237763,0.1409637525821598,0.8036814365308012
17,109,469,595,0.1349206349206349,0.21176470588235294,0.15284896643781698,0.7064610098986098
1,50,9,60,0.0196078431372549,0.85,0.13505806629397568,0.688791836966279
19,67,20,106,0.22093023255813954,0.8113207547169812,0.1666195280879956,0.7827167799478258
2,0,0,2,1.0,1.0,0.26866034441452624,0.7922405894716353
1,15,1,17,0.0625,0.9411764705882353,0.24274571026818476,0.7920474087510712
9,94,2,105,0.08737864077669903,0.9809523809523809,0.2552283732362846,0.7959197269091037
14,112,24,150,0.1111111111111111,0.84,0.2337783517862632,0.8050306160199927
12,47,4,63,0.2033898305084746,0.9365079365079365,0.24355966544166888,0.9085653632522189
3,26,2,31,0.10344827586206896,0.9354838709677419,0.25553687011664233,0.9207773448190393
2,20,1,23,0.09090909090909091,0.9565217391304348,0.23243553487716853,0.9424727235447706
30,68,19,117,0.30612244897959184,0.8376068376068376,0.13331017044568166,0.9192737003457475
19,90,2,111,0.1743119266055046,0.9819819819819819,0.1492833028178966,0.9251030591162827
30,92,3,125,0.2459016393442623,0.976,0.16915552036638346,0.9243955761230855
82,298,36,416,0.21578947368421053,0.9134615384615384,0.18648427532464523,0.9339377006652102
4,82,20,106,0.046511627906976744,0.8113207547169812,0.16407310352443125,0.9160538175522165
0,36,4,40,0.0,0.9,0.15422088677566279,0.9109846931282534
0,12,2,14,0.0,0.8571428571428571,0.14123387378864982,0.8967877099871708
1,12,2,15,0.07692307692307693,0.8666666666666667,0.1084911063520048,0.900939114138575
32,176,59,267,0.15384615384615385,0.7790262172284644,0.10556742452924042,0.8719454334595012
30,118,23,171,0.20270270270270271,0.8654970760233918,0.0993961478661605,0.8561593014628427
2,20,4,26,0.09090909090909091,0.8461538461538461,0.08155609318400055,0.846543916847458
1,26,98,125,0.037037037037037035,0.216,0.0802025802025806,0.7614980947450322
5,38,10,53,0.11627906976744186,0.8113207547169812,0.09681387588364372,0.7488296311331722
7,173,27,207,0.03888888888888889,0.8695652173913043,0.10236943143919927,0.7506042540258077
13,150,3,166,0.07975460122699386,0.9819277108433735,0.10277393491118739,0.7670701174796228
15,128,7,150,0.1048951048951049,0.9533333333333334,0.0957809279181804,0.7919711340660326
10,103,3,116,0.08849557522123894,0.9741379310344828,0.079465623992257,0.8074912562104742
45,172,6,223,0.2073732718894009,0.9730941704035875,0.09610336413230128,0.8256255882461517
10,90,1,101,0.1,0.9900990099009901,0.10509807312701029,0.9362111610891503
4,51,5,60,0.07272727272727272,0.9166666666666666,0.09887638783555756,0.9512605770819624
1,29,9,39,0.03333333333333333,0.7692307692307693,0.09808273704190676,0.9369270844876004
4,155,4,163,0.025157232704402517,0.9754601226993865,0.09028311296725086,0.9360031433241736
14,110,16,140,0.11290322580645161,0.8857142857142857,0.09142713024030037,0.9263432793785954
30,85,24,139,0.2608695652173913,0.8273381294964028,0.11605198595403644,0.9053718791588697
14,93,2,109,0.1308411214953271,0.981651376146789,0.10511882161202589,0.9065943371221842
5,59,2,66,0.078125,0.9696969696969697,0.10199382161202589,0.9036797599501812
6,69,58,133,0.08,0.5639097744360902,0.10303278265098693,0.8532859182029561
9,40,1,50,0.1836734693877551,0.98,0.12450994494447576,0.8833958083128461
15,84,1,100,0.15151515151515152,0.99,0.1425610762031542,0.8854729336415053
3,23,4,30,0.11538461538461539,0.8666666666666667,0.14291556042860615,0.882751845206131
6,80,10,96,0.06976744186046512,0.8958333333333334,0.11561525709190242,0.8925368743256925
16,38,2,56,0.2962962962962963,0.9642857142857143,0.13925171063489802,0.8900560654883962
0,4,59,63,0.0,0.06349206349206349,0.12809099634918372,0.7605982217448382
5,191,13,209,0.025510204081632654,0.937799043062201,0.12030673978941697,0.8140109744057111
16,207,12,235,0.07174887892376682,0.948936170212766,0.10431751258027577,0.8095732844361062
35,101,15,151,0.25735294117647056,0.9006622516556292,0.11943719681760707,0.796810748958339
3,55,7,65,0.05172413793103448,0.8923076923076924,0.11034284289566695,0.8004737526213427
28,194,6,228,0.12612612612612611,0.9736842105263158,0.11839408350504708,0.8115953065060545
0,11,54,65,0.0,0.16923076923076924,0.07606604117700476,0.6980160286410623
4,9,2,15,0.3076923076923077,0.8666666666666667,0.12002208513304871,0.8127552576660056
20,62,5,87,0.24390243902439024,0.9425287356321839,0.15122097583915695,0.813430928033146
0,62,3,65,0.0,0.9538461538461539,0.14097113599290453,0.8141323542664871
31,81,32,144,0.2767857142857143,0.7777777777777778,0.1437472464370822,0.796577429426794
17,111,467,595,0.1328125,0.21512605042016808,0.15533129816122013,0.6998371948714334
1,50,9,60,0.0196078431372549,0.85,0.1401144005913814,0.6821680219391026
19,67,20,106,0.22093023255813954,0.8113207547169812,0.17167586238540133,0.7738951627228472
2,0,0,2,1.0,1.0,0.2705769612865002,0.7929427817704663
1,15,1,17,0.0625,0.9411764705882353,0.24466232714015876,0.7927496010499022
10,93,2,105,0.0970873786407767,0.9809523809523809,0.25853195266026974,0.7966219192079346
13,113,24,150,0.10317460317460317,0.84,0.2337303653586824,0.8055108080968234
12,47,4,63,0.2033898305084746,0.9365079365079365,0.24381284114560733,0.9085653632522189
2,27,2,31,0.06896551724137931,0.9354838709677419,0.25086393744619656,0.9207773448190393
2,20,1,23,0.09090909090909091,0.9565217391304348,0.16250105546656782,0.9415203425923898
31,69,17,117,0.31,0.8547008547008547,0.13535819832371068,0.920763321835369
22,87,2,111,0.2018348623853211,0.9819819819819819,0.15526317866447084,0.9265926806059043
30,92,3,125,0.2459016393442623,0.976,0.17374843366094658,0.9258851976127069
91,290,35,416,0.2388451443569554,0.9158653846153846,0.19426372639221232,0.936723109700619
6,80,20,106,0.06976744186046512,0.8113207547169812,0.17517481372821098,0.9188392265876254
0,36,4,40,0.0,0.9,0.1653225969794425,0.9137701021636623
0,13,1,14,0.0,0.9285714285714286,0.1523355839924295,0.9097772006552328
1,12,2,15,0.07692307692307693,0.8666666666666667,0.11903888069572621,0.9114866023646346
33,175,59,267,0.15865384615384615,0.7790262172284644,0.11287016409122977,0.8824929216855606
29,119,23,171,0.19594594594594594,0.8654970760233918,0.10573363646289888,0.8667067896889024
2,20,4,26,0.09090909090909091,0.8461538461538461,0.08459991454177539,0.8567479984801112
2,29,94,125,0.06451612903225806,0.248,0.08384972699488867,0.7762736049491138
5,38,10,53,0.11627906976744186,0.8113207547169812,0.10046102267595179,0.763605141337254
12,170,25,207,0.06593406593406594,0.8792270531400966,0.10988017495224692,0.7565559448470637
15,148,3,166,0.09202453987730061,0.9819277108433735,0.1120375268028503,0.7730218083008789
13,130,7,150,0.09090909090909091,0.9533333333333334,0.10235970462502812,0.7979228248872887
6,108,2,116,0.05263157894736842,0.9827586206896551,0.08188622362523133,0.8146744741253265
44,173,6,223,0.20276497695852536,0.9730941704035875,0.09786563591800769,0.8328088061610038
10,90,1,101,0.1,0.9900990099009901,0.10293476034197081,0.9388229504325738
3,56,1,60,0.05084745762711865,0.9833333333333333,0.09358738717906749,0.9633961759491955
1,29,9,39,0.03333333333333333,0.7692307692307693,0.08893013966467714,0.947682421105006
5,154,4,163,0.031446540880503145,0.9754601226993865,0.08027613980799178,0.9467584799415791
16,108,16,140,0.12903225806451613,0.8857142857142857,0.0857223065444811,0.937098615996001
31,83,25,139,0.2719298245614035,0.8201438848920863,0.1170506273464861,0.9138679394534911
16,91,2,109,0.14953271028037382,0.981651376146789,0.10944601782103588,0.9150903974168056
6,59,1,66,0.09230769230769231,0.9848484848484849,0.10834711672213479,0.9143403224093049
1,34,98,133,0.02857142857142857,0.2631578947368421,0.10516482685703621,0.8114581168955205
12,37,1,50,0.24489795918367346,0.98,0.13538834483565623,0.8415680070054107
15,84,1,100,0.15151515151515152,0.99,0.15254100349774885,0.8436451323340696
2,24,4,30,0.07692307692307693,0.8666666666666667,0.14509683476325755,0.8409240438986955
6,80,10,96,0.06976744186046512,0.8958333333333334,0.1162164943774092,0.851736822247445
21,34,1,56,0.38181818181818183,0.9821428571428571,0.14940013316852463,0.8518070338183118
0,4,59,63,0.0,0.06349206349206349,0.13621331998171146,0.7201846879102518
5,191,13,209,0.025510204081632654,0.937799043062201,0.1357760021974549,0.8165619948138744
17,203,15,235,0.07727272727272727,0.9361702127659575,0.11182954049589114,0.8103005966375827
37,101,13,151,0.26811594202898553,0.9139072847682119,0.1284867962835817,0.7994302087473272
2,56,7,65,0.034482758620689655,0.8923076923076924,0.12242389366895497,0.8030932124103308
29,193,6,228,0.13063063063063063,0.9736842105263158,0.13111863492183576,0.8142147662950426
0,15,50,65,0.0,0.23076923076923078,0.0765731803763812,0.7068756768130958
4,10,1,15,0.2857142857142857,0.9333333333333333,0.11738950690699346,0.8311387153618488
20,62,5,87,0.24390243902439024,0.9425287356321839,0.14858839761310166,0.8318143857289891
0,62,3,65,0.0,0.9538461538461539,0.13754943657414062,0.8343395201690172
32,81,31,144,0.2831858407079646,0.7847222222222222,0.1397022792425662,0.815884511233876
18,125,452,595,0.1258741258741259,0.24033613445378152,0.15275818885019996,0.7227457172547458
1,50,9,60,0.0196078431372549,0.85,0.13689779063686058,0.705076544322415
18,68,20,106,0.20930232558139536,0.8113207547169812,0.16679812286277418,0.7880124763149509
2,0,0,2,1.0,1.0,0.2688389391893048,0.7975362858387604
1,15,1,17,0.0625,0.9411764705882353,0.24292430504296333,0.7973431051181963
11,92,2,105,0.10679611650485436,0.9809523809523809,0.2581808931150854,0.8012154232762286
12,115,23,150,0.09448818897637795,0.8466666666666667,0.23122408572485872,0.810064629625435
12,47,4,63,0.2033898305084746,0.9365079365079365,0.24229775781547996,0.9095177442046
2,27,2,31,0.06896551724137931,0.9354838709677419,0.24934885411606916,0.9217297257714202
2,20,1,23,0.09090909090909091,0.9565217391304348,0.1685609506890246,0.9415203425923898
31,71,15,117,0.30392156862745096,0.8717948717948718,0.1405497462072319,0.9232053242773715
24,85,2,111,0.22018348623853212,0.9819819819819819,0.16307595852702222,0.9290346830479067
30,92,3,125,0.2459016393442623,0.976,0.18156121352349794,0.9283272000547094
91,291,34,416,0.23821989528795812,0.9182692307692307,0.20085339811112007,0.9395085187360281
6,80,20,106,0.06976744186046512,0.8113207547169812,0.18176448544711873,0.9216246356230345
0,36,4,40,0.0,0.9,0.16698616032396602,0.9165555111990714
0,12,2,14,0.0,0.8571428571428571,0.15399914733695302,0.9023585280579889
1,12,2,15,0.07692307692307693,0.8666666666666667,0.12157079137918532,0.9016259273253882
33,177,58,268,0.15714285714285714,0.7835820895522388,0.11256498722266033,0.8732830855497105
30,118,23,171,0.20270270270270271,0.8654970760233918,0.10639371055958037,0.8574969535530521
1,21,4,26,0.045454545454545456,0.8461538461538461,0.07885580344052144,0.8471947557508545
2,26,97,125,0.07142857142857142,0.224,0.07909310766453662,0.7632917907912856
5,38,10,53,0.11627906976744186,0.8113207547169812,0.09570440334559974,0.7506233271794258
10,170,27,207,0.05555555555555555,0.8695652173913043,0.10364091128210769,0.7523979500720611
13,150,3,166,0.07975460122699386,0.9819277108433735,0.10404541475409582,0.7688638135258764
12,131,7,150,0.08391608391608392,0.9533333333333334,0.09358444715027107,0.7931139912088899
5,109,2,116,0.043859649122807015,0.9827586206896551,0.07089258235314311,0.8098656404469275
43,174,6,223,0.19815668202764977,0.9730941704035875,0.09270717329215802,0.8279999724826048
10,90,1,101,0.1,0.9900990099009901,0.09678880594521924,0.9374426881827463
3,52,5,60,0.05454545454545454,0.9166666666666666,0.0879697180563639,0.9524921041755585
1,29,9,39,0.03333333333333333,0.7692307692307693,0.08479511488176074,0.9381586115811963
6,153,4,163,0.03773584905660377,0.9754601226993865,0.07879243600027644,0.9372346704177696
15,108,17,140,0.12195121951219512,0.8785714285714286,0.0842260267997209,0.926554398308926
32,82,25,139,0.2807017543859649,0.8201438848920863,0.11806061326588631,0.9033237217664164
14,93,2,109,0.1308411214953271,0.981651376146789,0.10844410461841163,0.9045461797297307
6,59,1,66,0.09230769230769231,0.9848484848484849,0.10734520351951053,0.90379610472223
6,70,57,133,0.07894736842105263,0.5714285714285714,0.11083119121602454,0.8544763768310736
11,38,1,50,0.22448979591836735,0.98,0.13813925729960083,0.8845862669409635
15,84,1,100,0.15151515151515152,0.99,0.15439344336510766,0.8866633922696227
2,24,4,30,0.07692307692307693,0.8666666666666667,0.1479608515666622,0.884962711997514
6,79,11,96,0.07058823529411765,0.8854166666666666,0.11794463455354116,0.8942873951081681
19,36,1,56,0.34545454545454546,0.9821428571428571,0.14860369511914379,0.8943576066790352
0,4,59,63,0.0,0.06349206349206349,0.1354168819323306,0.7627352607709749
5,191,13,209,0.025510204081632654,0.937799043062201,0.12778300131241346,0.8150738995757791
16,203,16,235,0.0730593607305936,0.9319148936170213,0.10615008199987434,0.8082045986639249
37,102,12,151,0.26618705035971224,0.9205298013245033,0.12253178183481159,0.7982802845674256
4,54,7,65,0.06896551724137931,0.8923076923076924,0.12139498759456908,0.8019432882304292
30,192,6,228,0.13513513513513514,0.9736842105263158,0.130615973286143,0.8145529373532362
0,14,51,65,0.0,0.2153846153846154,0.08126532393549366,0.7050160456734874
4,10,1,15,0.2857142857142857,0.9333333333333333,0.12208165046610589,0.8292790842222403
20,62,5,87,0.24390243902439024,0.9425287356321839,0.1532805411722141,0.8299547545893807
0,62,3,65,0.0,0.9538461538461539,0.14284348963927218,0.833087791764971
31,81,32,144,0.2767857142857143,0.7777777777777778,0.14435758448584388,0.8126946455440102
24,117,453,594,0.1702127659574468,0.23737373737373738,0.15882147715956782,0.7191326519820167
0,51,9,60,0.0,0.85,0.13951645785454853,0.7014634790496859
19,67,20,106,0.22093023255813954,0.8113207547169812,0.17107791964856847,0.7865972132400237
1,1,0,2,0.5,1.0,0.20169016454652766,0.7961210227638332
1,15,1,17,0.0625,0.9411764705882353,0.17577553040018618,0.7959278420432693
12,91,2,105,0.11650485436893204,0.9809523809523809,0.19241908102431934,0.7998001602013016
12,114,24,150,0.09523809523809523,0.84,0.16648370687465947,0.8086890490901906
12,47,4,63,0.2033898305084746,0.9365079365079365,0.17122328752480628,0.908565363252219
2,27,2,31,0.06896551724137931,0.9354838709677419,0.18107550427357477,0.9207773448190393
1,21,1,23,0.045454545454545456,0.9565217391304348,0.16454868491720867,0.9380941526716483
29,71,17,117,0.29,0.8547008547008547,0.13454868491720867,0.9173371319146275
25,84,2,111,0.22935779816513763,0.9819819819819819,0.15838551322651404,0.9231664906851628
31,91,3,125,0.2540983606557377,0.976,0.17915732872391757,0.922777432934403
89,292,34,415,0.2335958005249344,0.9180722891566265,0.19528677805999198,0.9364027548909222
4,82,20,106,0.046511627906976744,0.8113207547169812,0.17287560625977796,0.9185188717779285
0,36,4,40,0.0,0.9,0.15700259038676206,0.9140853742409826
0,13,1,14,0.0,0.9285714285714286,0.1505090838932556,0.9100924727325531
1,13,1,15,0.07142857142857142,0.9333333333333333,0.11928459409733724,0.9213256839657644
31,178,59,268,0.14832535885167464,0.7798507462686567,0.1077085313382711,0.8924497931495752
30,118,23,171,0.20270270270270271,0.8654970760233918,0.10036629448783752,0.8766636611529168
2,24,0,26,0.07692307692307693,1.0,0.0779844768304293,0.8883676198448273
1,56,68,125,0.017543859649122806,0.456,0.07384622422216447,0.8376075120281156
5,45,3,53,0.1,0.9433962264150944,0.08813193850787875,0.8438069729445576
8,172,27,207,0.044444444444444446,0.8695652173913043,0.0944811448570851,0.83537751420454
15,148,3,166,0.09202453987730061,0.9819277108433735,0.09742342606404641,0.8423195681345457
14,129,7,150,0.0979020979020979,0.9533333333333334,0.09022010307124972,0.8671027948580708
6,108,2,116,0.05263157894736842,0.9827586206896551,0.06878137110620199,0.8838544440961085
43,174,6,223,0.19815668202764977,0.9730941704035875,0.08610045754971239,0.8800107541537638
10,90,1,101,0.1,0.9900990099009901,0.09787990617126627,0.9563106127110482
3,56,1,60,0.05084745762711865,0.9833333333333333,0.09085811440371179,0.962015913699368
1,29,9,39,0.03333333333333333,0.7692307692307693,0.08927081281641022,0.9476824211050058
6,153,4,163,0.03773584905660377,0.9754601226993865,0.08151528555631067,0.9467584799415791
16,109,15,140,0.128,0.8928571428571429,0.08581498585601095,0.9381190241592663
35,80,24,139,0.30434782608695654,0.8273381294964028,0.12177444973309497,0.9159160968459444
12,94,2,108,0.11320754716981132,0.9814814814814815,0.10963885903911806,0.9171142841427865
6,59,1,66,0.09230769230769231,0.9848484848484849,0.10853995794021695,0.9163642091352858
6,115,12,133,0.049586776859504134,0.9097744360902256,0.10835986068770058,0.9058557952434132
11,38,1,50,0.22448979591836735,0.98,0.13566792677127687,0.9359656853533034
14,85,1,100,0.1414141414141414,0.99,0.15047911139378226,0.9380428106819624
2,24,4,30,0.07692307692307693,0.8666666666666667,0.14318240809707897,0.9343013140833228
6,85,5,96,0.06593406593406594,0.9479166666666666,0.10912329950380886,0.9515268193933607
19,36,1,56,0.34545454545454546,0.9821428571428571,0.14230144211591375,0.9516213016307
0,4,59,63,0.0,0.06349206349206349,0.12911462892910056,0.8199989557226398
5,191,13,209,0.025510204081632654,0.937799043062201,0.1256751185322618,0.8240024710043505
15,206,13,234,0.06787330316742081,0.9444444444444444,0.10330133385355514,0.8189231059249854
35,104,12,151,0.2517985611510791,0.9205298013245033,0.11907053667311766,0.808998791828486
5,53,7,65,0.08620689655172414,0.8923076923076924,0.12039679662006726,0.8126617954914896
31,191,6,228,0.13963963963963963,0.9736842105263158,0.13092616429229206,0.8163428731857252
4,60,1,65,0.0625,0.9846153846153847,0.09050408637021415,0.8166960913960863
4,10,1,15,0.2857142857142857,0.9333333333333333,0.13132041290082638,0.9409591299448392
20,62,5,87,0.24390243902439024,0.9425287356321839,0.16251930360693462,0.9416348003119797
1,61,3,65,0.016129032258064516,0.9538461538461539,0.155127264905598,0.942977901655081
30,85,29,144,0.2608695652173913,0.7986111111111112,0.1564231226293569,0.9255609459103107
23,124,447,594,0.1564625850340136,0.2474747474747475,0.16645964955539824,0.8334419537913185
1,50,9,60,0.0196078431372549,0.85,0.14931225005505758,0.8157727808589877
17,68,20,105,0.2,0.8095238095238095,0.1689551071979147,0.7907596987030484
1,1,0,2,0.5,1.0,0.1995673520958739,0.8002835082268579
1,15,1,17,0.0625,0.9411764705882353,0.1736527179495324,0.8000903275062938
12,91,2,105,0.11650485436893204,0.9809523809523809,0.1879921211082278,0.8039626456643261
13,113,24,150,0.10317460317460317,0.84,0.16546426938782946,0.8098753440770247
12,47,4,63,0.2033898305084746,0.9365079365079365,0.17216816159846676,0.9083086567960516
3,26,2,31,0.10344827586206896,0.9354838709677419,0.18414536627344022,0.9205206383628718
1,20,1,22,0.047619047619047616,0.9545454545454546,0.2361391087243812,0.9388249975283026
30,68,16,114,0.30612244897959184,0.8596491228070176,0.13701374429289434,0.9187748722150194
17,77,2,96,0.18085106382978725,0.9791666666666666,0.1539210391257211,0.9242020430833667
31,74,3,108,0.29523809523809524,0.9722222222222222,0.1805699595634614,0.9232733027929243
85,257,35,377,0.24853801169590642,0.9071618037135278,0.19898137271171668,0.9343268127459208
4,73,20,97,0.05194805194805195,0.7938144329896907,0.1773468329173706,0.9139420265290285
0,29,4,33,0.0,0.8787878787878788,0.16147381704435473,0.9064782259617796
0,13,1,14,0.0,0.9285714285714286,0.15467109595591935,0.9027676508226331
1,8,2,11,0.1111111111111111,0.8181818181818182,0.12681233340327924,0.8968437501618903
33,148,59,240,0.18232044198895028,0.7541666666666667,0.12702224456887395,0.8647008930190332
30,106,23,159,0.22058823529411764,0.8553459119496856,0.11635797886259144,0.8480042772658136
2,18,4,24,0.1,0.8333333333333334,0.09513826290603337,0.8374573529257859
1,25,96,122,0.038461538461538464,0.21311475409836064,0.09321161812224574,0.7545002559413101
3,36,10,49,0.07692307692307693,0.7959183673469388,0.10420062911125673,0.7426617543068901
11,153,24,188,0.06707317073170732,0.8723404255319149,0.11378251064435776,0.7346287538726738
12,119,3,134,0.0916030534351145,0.9776119402985075,0.11099564526207253,0.7574044856036295
17,120,7,144,0.12408759124087591,0.9513888888888888,0.1026766665837762,0.7855790887782327
5,99,2,106,0.04807692307692308,0.9811320754716981,0.07803219340989127,0.8035485407099487
43,174,6,223,0.19815668202764977,0.9730941704035875,0.09205457655669838,0.8235143745771278
6,76,1,83,0.07317073170731707,0.9879518072289156,0.09701303273466676,0.9342053821672073
3,49,1,53,0.057692307692307696,0.9811320754716981,0.094265779987414,0.9606644833278872
0,29,8,37,0.0,0.7837837837837838,0.08468389845431294,0.9480135345067255
5,150,4,159,0.03225806451612903,0.9748427672955975,0.07620604289445788,0.9476179383634526
15,99,17,131,0.13157894736842105,0.8702290076335878,0.07727623662696434,0.9360236696126955
31,69,24,124,0.31,0.8064516129032258,0.11469381904454676,0.9110693178171992
12,87,2,101,0.12121212121212122,0.9801980198019802,0.10370173892804267,0.9120841534455411
6,58,1,65,0.09375,0.9846153846153847,0.10664163439842596,0.9116075216436081
5,57,58,120,0.08064516129032258,0.5166666666666667,0.10992061348385665,0.8452553203857465
8,38,1,47,0.17391304347826086,0.9787234042553191,0.13476533398075105,0.8731038375959658
13,83,1,97,0.13541666666666666,0.9896907216494846,0.14950227714511358,0.8752249739322354
2,23,4,29,0.08,0.8620689655172413,0.142133856092482,0.8740592536299001
5,65,11,81,0.07142857142857142,0.8641975308641975,0.10805222343942077,0.8823086704814677
18,32,1,51,0.36,0.9803921568627451,0.1421647775519749,0.8823364043472912
0,2,59,61,0.0,0.03278688524590164,0.12877192040911775,0.746360904437365
5,162,13,180,0.029940119760479042,0.9277777777777778,0.12152834304771151,0.8050910631675238
17,168,14,199,0.0918918918918919,0.9296482412060302,0.10981103567823024,0.798080325589054
32,94,12,138,0.25396825396825395,0.9130434782608695,0.12674697672131413,0.7871307193906804
3,53,7,63,0.05357142857142857,0.8888888888888888,0.12297146651723252,0.7909621370152015
28,177,6,211,0.13658536585365855,0.9715639810426541,0.13227958000653067,0.8063002013264094
0,16,49,65,0.0,0.24615384615384617,0.08085100857795924,0.7014090140822811
4,9,1,14,0.3076923076923077,0.9285714285714286,0.12480705253400319,0.8293782345573563
19,51,5,75,0.2714285714285714,0.9333333333333333,0.15930540277230212,0.830171885351007
0,61,3,64,0.0,0.953125,0.14617798964488898,0.8335257080358599
31,79,32,142,0.2818181818181818,0.7746478873239436,0.15015655076630724,0.8137549093305848
17,81,410,508,0.17346938775510204,0.19291338582677164,0.1672848306496892,0.714329837464568
1,44,9,54,0.022222222222222223,0.8333333333333334,0.15094723870234114,0.6945826020775223
17,64,20,101,0.20987654320987653,0.801980198019802,0.1809296020180378,0.7739863666298017
1,1,0,2,0.5,1.0,0.20840212949056522,0.7841904482624548
1,15,1,17,0.0625,0.9411764705882353,0.17855519071505505,0.7853108964417265
10,82,2,94,0.10869565217391304,0.9787234042553191,0.19408314102561405,0.7889678113353434
14,102,25,141,0.1206896551724138,0.8226950354609929,0.17106478007621861,0.7958316896406361
12,47,4,63,0.2033898305084746,0.9365079365079365,0.1753391290409861,0.9020594825950884
3,24,2,29,0.1111111111111111,0.9310344827586207,0.18803754173939885,0.9160167896558437
1,20,1,22,0.047619047619047616,0.9545454545454546,0.16666952500076074,0.9421903971754879
29,68,17,114,0.29896907216494845,0.8508771929824561,0.1379508210243248,0.9208871390301245
21,73,2,96,0.22340425531914893,0.9791666666666666,0.16093714321277464,0.9263143098984717
31,74,3,108,0.29523809523809524,0.9722222222222222,0.18785742588895188,0.9250671443655919
82,260,35,377,0.23976608187134502,0.9071618037135278,0.20411197301792922,0.9337093068008578
5,72,20,97,0.06493506493506493,0.7938144329896907,0.1819114132871031,0.9133245205839656
0,29,4,33,0.0,0.8787878787878788,0.1671330881639504,0.9052250931296995
0,12,2,14,0.0,0.8571428571428571,0.160330367075515,0.8913104363578997
0,9,2,11,0.0,0.8181818181818182,0.11762049962337953,0.8866396685292371
30,151,59,240,0.16574585635359115,0.7541666666666667,0.1093835854854427,0.8544968113863801
30,106,23,159,0.22058823529411764,0.8553459119496856,0.0987193197791602,0.8378001956331607
2,18,4,24,0.1,0.8333333333333334,0.07875273665468234,0.8272532712931328
1,24,97,122,0.04,0.20491803278688525,0.07519058452110162,0.7431252141213035
3,36,10,49,0.07692307692307693,0.7959183673469388,0.08617959551011263,0.7312867124868835
9,154,26,189,0.05521472392638037,0.8624338624338624,0.09406741321388125,0.7320425703855985
13,119,3,135,0.09848484848484848,0.9777777777777777,0.10813667728314533,0.7548419931850212
13,124,7,144,0.0948905109489051,0.9513888888888888,0.09801448508247589,0.7830165963596245
4,100,2,106,0.038461538461538464,0.9811320754716981,0.07199638553496457,0.8009860482913406
43,174,6,223,0.19815668202764977,0.9730941704035875,0.08601876868177169,0.8209518821585197
6,76,1,83,0.07317073170731707,0.9879518072289156,0.09075744463995983,0.9328138499359525
2,46,5,53,0.041666666666666664,0.9056603773584906,0.0857208146033298,0.9484912799376028
1,28,8,37,0.034482758620689655,0.7837837837837838,0.08275910527394541,0.937255554416163
5,150,4,159,0.03225806451612903,0.9748427672955975,0.07329813613555691,0.9368362672044231
14,91,26,131,0.13333333333333333,0.8015267175572519,0.07878996790476094,0.9154273855856178
32,68,24,124,0.32,0.8064516129032258,0.11900974812454117,0.8904730337901218
13,86,2,101,0.13131313131313133,0.9801980198019802,0.10946066945103852,0.8914878694184635
5,58,2,65,0.07936507936507936,0.9692307692307692,0.1103455762592903,0.8888134354187284
5,103,12,120,0.046296296296296294,0.9,0.11100695192066594,0.8880048100818011
10,36,1,47,0.21739130434782608,0.9787234042553191,0.1371367441673997,0.9158533272920204
15,81,1,97,0.15625,0.9896907216494846,0.15484987780795273,0.9179744636282899
2,23,4,29,0.08,0.8620689655172413,0.14723083018890512,0.9266233561940027
5,65,11,81,0.07142857142857142,0.8641975308641975,0.11172062610727244,0.9348727730455701
17,34,1,52,0.3333333333333333,0.9807692307692307,0.1405806549673013,0.9349543746123202
0,2,59,61,0.0,0.03278688524590164,0.1292427864865757,0.8011766769001962
5,162,13,180,0.029940119760479042,0.9277777777777778,0.12690618983860177,0.8051449308684503
18,168,14,200,0.0967741935483871,0.93,0.1096751740101105,0.7981844445462618
33,94,12,139,0.25984251968503935,0.9136690647482014,0.12447410539368756,0.7873242078460786
5,52,7,64,0.08771929824561403,0.890625,0.12557686228591813,0.7914036413436154
25,180,6,211,0.12195121951219512,0.9715639810426541,0.1327943834407215,0.8067417056548235
0,14,51,65,0.0,0.2153846153846154,0.0851753358216739,0.6974010463141642
4,8,2,14,0.3333333333333333,0.8571428571428571,0.13279438344072153,0.8151661851565865
19,51,5,75,0.2714285714285714,0.9333333333333333,0.16729273367902042,0.8159598359502372
1,60,3,64,0.01639344262295082,0.953125,0.15580976926110093,0.8192634073788087
30,79,32,141,0.27522935779816515,0.7730496453900709,0.1580078889915475,0.7991749188990757
135,339,33,507,0.2848101265822785,0.9349112426035503,0.18616372161107098,0.8055015249852971
1,44,9,54,0.022222222222222223,0.8333333333333334,0.17191672199821775,0.7857542895982513
17,64,20,101,0.20987654320987653,0.801980198019802,0.2018990853139144,0.8695536585461353
2,0,0,2,1.0,1.0,0.2971371805520096,0.8899618218114413
1,15,1,17,0.0625,0.9411764705882353,0.2672902417764994,0.891082269990713
10,82,2,94,0.10869565217391304,0.9787234042553191,0.2804762717123511,0.8947391848843299
14,103,24,141,0.11965811965811966,0.8297872340425532,0.2582518091209161,0.9028445546918275
12,47,4,63,0.2033898305084746,0.9365079365079365,0.24662033825322985,0.9030726538210255
3,24,2,29,0.1111111111111111,0.9310344827586207,0.25931875095164253,0.9170299608817809
1,22,1,24,0.043478260869565216,0.9583333333333334,0.23171066978133933,0.9427315227166133
28,71,18,117,0.2828282828282828,0.8461538461538461,0.12925756732823687,0.9207535007385914
20,89,2,111,0.1834862385321101,0.9819819819819819,0.1465413156899669,0.9265828595091266
29,94,3,126,0.23577235772357724,0.9761904761904762,0.16496649300692728,0.9259025874002831
76,305,35,416,0.1994750656167979,0.9158653846153846,0.17883975884869704,0.9357881185358143
6,80,20,106,0.06976744186046512,0.8113207547169812,0.15975084618469573,0.9179042354228206
0,36,4,40,0.0,0.9,0.14497252106154299,0.9128351109988575
0,12,2,14,0.0,0.8571428571428571,0.13876134093731943,0.8983793286859323
1,13,2,16,0.07142857142857142,0.875,0.10856138216593206,0.9025002078068114
32,177,59,268,0.15311004784688995,0.7798507462686567,0.10422192635375775,0.8736243169906223
30,116,23,169,0.2054794520547945,0.863905325443787,0.0998943684010745,0.8575835811696665
2,20,4,26,0.09090909090909091,0.8461538461538461,0.08438494344283065,0.8476247899608753
1,27,97,125,0.03571428571428571,0.224,0.0795202068505193,0.7637218250013066
4,39,10,53,0.09302325581395349,0.8113207547169812,0.0928092433953698,0.7510533613894468
7,171,27,205,0.03932584269662921,0.8682926829268293,0.0984272209234597,0.7526461936443
11,152,3,166,0.06748466257668712,0.9819277108433735,0.09786380537319052,0.767921580907639
13,130,7,150,0.09090909090909091,0.9533333333333334,0.08897795438207635,0.7927048076311642
3,112,2,117,0.02608695652173913,0.9829059829059829,0.0633504550202113,0.809704901554335
40,177,6,223,0.18433179723502305,0.9730941704035875,0.07669655592391589,0.8278392335900123
10,90,1,101,0.1,0.9900990099009901,0.08588022939330364,0.9372819492901538
4,51,5,60,0.07272727272727272,0.9166666666666666,0.08298080323806355,0.952331365282966
0,30,9,39,0.0,0.7692307692307693,0.07736282570997366,0.938179663326386
5,155,4,164,0.03125,0.975609756097561,0.07218644534187549,0.9372770983626986
16,108,16,140,0.12903225806451613,0.8857142857142857,0.0776326120783648,0.9276172344171202
32,82,25,139,0.2807017543859649,0.8201438848920863,0.11400615463039707,0.9043655061294208
12,94,2,108,0.11320754716981132,0.9814814814814815,0.10384554747822396,0.9055636934262629
5,60,2,67,0.07692307692307693,0.9701492537313433,0.10054884418152066,0.9027137282591704
7,114,12,133,0.05785123966942149,0.9097744360902256,0.09842369660182763,0.9017291238911074
8,39,1,48,0.1702127659574468,0.9791666666666666,0.12273980602432003,0.9317199663819499
12,87,1,100,0.12121212121212122,0.99,0.13559153762605164,0.9337757155108697
2,24,4,30,0.07692307692307693,0.8666666666666667,0.12814736889156034,0.9310546270754957
7,78,11,96,0.08235294117647059,0.8854166666666666,0.09981182414734684,0.9403793101861498
15,39,2,56,0.2777777777777778,0.9642857142857143,0.12332185709134207,0.9379227720153259
0,4,59,63,0.0,0.06349206349206349,0.11233284610233106,0.8084003162668576
4,191,13,208,0.020512820512820513,0.9375,0.10699878622281664,0.812361111111111
16,207,12,235,0.07174887892376682,0.948936170212766,0.09293251664657665,0.8080424687605536
33,105,12,150,0.2391304347826087,0.92,0.10977799001378916,0.7980424687605537
3,55,7,65,0.05172413793103448,0.8923076923076924,0.10617814158635451,0.8017054724235574
26,196,6,228,0.11711711711711711,0.9736842105263158,0.11114445243501832,0.8143151215463645
1,14,51,66,0.06666666666666667,0.22727272727272727,0.08098572227628813,0.7090275519730806
4,9,2,15,0.3076923076923077,0.8666666666666667,0.1249417662323321,0.8237667809980238
20,62,5,87,0.24390243902439024,0.9425287356321839,0.15685456887684207,0.8244851718026215
0,62,3,65,0.0,0.9538461538461539,0.14660472903058966,0.8251865980359627
30,81,32,143,0.2702702702702703,0.7762237762237763,0.15105327695739845,0.8046471374965023
134,418,43,595,0.2427536231884058,0.9277310924369748,0.1783432034227372,0.8097076232292568
1,50,9,60,0.0196078431372549,0.85,0.16441330713989974,0.792038450296926
18,68,20,106,0.20930232558139536,0.8113207547169812,0.18478982984200387,0.8754738827889622
1,1,0,2,0.5,1.0,0.2122623573145313,0.8945215018365813
1,15,1,17,0.0625,0.9411764705882353,0.18634772316818987,0.8943283211160172
11,92,2,105,0.10679611650485436,0.9809523809523809,0.20160431124031192,0.8982006392740497
16,111,23,150,0.12598425196850394,0.8466666666666667,0.18099202291148814,0.9082639093373198
13,46,4,63,0.22033898305084745,0.9365079365079365,0.17778993146326552,0.9095177442046
3,26,2,31,0.10344827586206896,0.9354838709677419,0.18976713613823895,0.9217297257714201
1,22,1,24,0.043478260869565216,0.9583333333333334,0.23588817246479848,0.9417791417642325
28,71,18,117,0.2828282828282828,0.8461538461538461,0.133435070011696,0.9198011197862105
20,89,2,111,0.1834862385321101,0.9819819819819819,0.15071881837342602,0.9256304785567456
29,94,3,126,0.23577235772357724,0.9761904761904762,0.16637007058636424,0.9249502064479022
76,306,34,416,0.19895287958115182,0.9182692307692307,0.18118646834965801,0.9361315251292207
7,79,20,106,0.08139534883720931,0.8113207547169812,0.16133737774770976,0.9182476420162272
0,36,4,40,0.0,0.9,0.14655905262455704,0.9131785175922642
0,12,2,14,0.0,0.8571428571428571,0.14034787250033343,0.8987227352793389
1,13,2,16,0.07142857142857142,0.875,0.11014791372894608,0.902843614400218
10,199,59,268,0.04784688995215311,0.7798507462686567,0.09077086393180937,0.8739677235840286
29,117,23,169,0.19863013698630136,0.863905325443787,0.0854648323979128,0.8579269877630731
3,19,4,26,0.13636363636363635,0.8461538461538461,0.07652351193826774,0.8476247899608752
2,26,97,125,0.07142857142857142,0.224,0.07509968659417662,0.7637218250013066
4,39,10,53,0.09302325581395349,0.8113207547169812,0.08838872313902711,0.7510533613894468
7,171,27,205,0.03932584269662921,0.8682926829268293,0.094006700667117,0.7526461936443
11,152,3,166,0.06748466257668712,0.9819277108433735,0.09344328511684782,0.767921580907639
12,131,7,150,0.08391608391608392,0.9533333333333334,0.09859602711169509,0.7927048076311642
4,111,2,117,0.034782608695652174,0.9829059829059829,0.07518923735588805,0.809704901554335
40,177,6,223,0.18433179723502305,0.9730941704035875,0.08204183176608615,0.8278392335900124
10,90,1,101,0.1,0.9900990099009901,0.08612346441914738,0.9372819492901538
4,51,5,60,0.07272727272727272,0.9166666666666666,0.08322403826390726,0.9523313652829659
0,30,9,39,0.0,0.7692307692307693,0.07760606073581737,0.9381796633263859
5,155,4,164,0.03125,0.975609756097561,0.07242968036771923,0.9372770983626985
15,109,16,140,0.12096774193548387,0.8857142857142857,0.07772277437049065,0.9276172344171203
34,80,25,139,0.2982456140350877,0.8201438848920863,0.11536034656183856,0.9043655061294208
12,94,2,108,0.11320754716981132,0.9814814814814815,0.10519973940966547,0.9055636934262628
5,60,2,67,0.07692307692307693,0.9701492537313433,0.10190303611296217,0.9027137282591704
5,116,12,133,0.04132231404958678,0.9097744360902256,0.09741661344472131,0.9017291238911075
8,39,1,48,0.1702127659574468,0.9791666666666666,0.12173272286721372,0.9317199663819499
13,86,1,100,0.13131313131313133,0.99,0.1360274559119468,0.9337757155108698
2,24,4,30,0.07692307692307693,0.8666666666666667,0.12973536091017435,0.9310546270754957
8,77,11,96,0.09411764705882353,0.8854166666666666,0.10057422277070803,0.9403793101861498
17,37,2,56,0.3148148148148148,0.9642857142857143,0.12937526100570854,0.937922772015326
0,4,59,63,0.0,0.06349206349206349,0.11838625001669756,0.8084003162668575
5,190,13,208,0.02564102564102564,0.9375,0.11614606595833168,0.8123611111111109
15,208,12,235,0.06726457399103139,0.948936170212766,0.10143918139170091,0.8080424687605537
33,105,13,151,0.2391304347826087,0.9139072847682119,0.11684165331591194,0.7971720808702983
4,54,7,65,0.06896551724137931,0.8923076923076924,0.11570485907566944,0.8008350845333021
26,196,6,228,0.11711711711711711,0.9736842105263158,0.11899049765542567,0.813444733656109
1,14,51,66,0.06666666666666667,0.22727272727272727,0.0835407622056902,0.7081571640828251
4,10,1,15,0.2857142857142857,0.9333333333333333,0.12435708873630245,0.832420202631578
20,62,5,87,0.24390243902439024,0.9425287356321839,0.15553729064821167,0.8331385934361757
0,62,3,65,0.0,0.9538461538461539,0.14592806579235004,0.8338400196695168
30,82,32,144,0.26785714285714285,0.7777777777777778,0.15003188123156924,0.8143929472423119
131,423,41,595,0.2364620938628159,0.9310924369747899,0.17395996360606017,0.8199336250518973
1,50,9,60,0.0196078431372549,0.85,0.1600300673232227,0.8022644521195664
19,67,20,106,0.22093023255813954,0.8113207547169812,0.1820677195934331,0.8856998846116028
2,0,0,2,1.0,1.0,0.2841085359199637,0.8952236941354123
1,15,1,17,0.0625,0.9411764705882353,0.2581939017736223,0.8950305134148481
11,92,2,105,0.10679611650485436,0.9809523809523809,0.2734504898457443,0.8989028315728805
13,114,23,150,0.10236220472440945,0.8466666666666667,0.24980835582678243,0.9087441014141504
12,47,4,63,0.2033898305084746,0.9365079365079365,0.2450837467761622,0.9095177442046
3,26,2,31,0.10344827586206896,0.9354838709677419,0.25706095145113567,0.9217297257714202
0,23,1,24,0.0,0.9583333333333334,0.23081077918864742,0.9417791417642324
28,72,17,117,0.28,0.8547008547008547,0.12795363633150456,0.9210221210072118
19,90,2,111,0.1743119266055046,0.9819819819819819,0.1439267687037195,0.9268514797777468
28,95,3,126,0.22764227642276422,0.9761904761904762,0.15841658073082732,0.9261712076689034
85,295,36,416,0.2236842105263158,0.9134615384615384,0.1756322389239291,0.9366657131634089
7,79,20,106,0.08139534883720931,0.8113207547169812,0.15578314832198076,0.9187818300504152
0,36,4,40,0.0,0.9,0.1410048231988281,0.913712705626452
0,12,2,14,0.0,0.8571428571428571,0.1410048231988281,0.899256923313527
1,13,2,16,0.07142857142857142,0.875,0.11120890483148115,0.9021568012134048
8,201,59,268,0.03827751196172249,0.7798507462686567,0.09177541702522654,0.8732809103972156
29,116,24,169,0.2,0.8579881656804734,0.0878265203934031,0.8563948660386437
2,20,4,26,0.09090909090909091,0.8461538461538461,0.06885864616237097,0.8467794814232591
2,30,93,125,0.0625,0.256,0.06615931061419822,0.7674479450351189
4,39,10,53,0.09302325581395349,0.8113207547169812,0.07944834715904871,0.7547794814232592
12,166,27,205,0.06741573033707865,0.8682926829268293,0.08907916577863138,0.7563723136781123
13,150,3,166,0.07975460122699386,0.9819277108433735,0.09026859860697743,0.7716477009414513
13,130,7,150,0.09090909090909091,0.9533333333333334,0.09778739559945863,0.7964309276649766
4,111,2,117,0.034782608695652174,0.9829059829059829,0.07418491112740896,0.8142763301257636
40,177,6,223,0.18433179723502305,0.9730941704035875,0.08753101203111355,0.832410662161441
10,90,1,101,0.1,0.9900990099009901,0.0928881548882564,0.9372819492901538
1,54,5,60,0.01818181818181818,0.9166666666666666,0.08219652094080851,0.9523313652829659
0,30,9,39,0.0,0.7692307692307693,0.07256570232122583,0.938179663326386
5,155,4,164,0.03125,0.975609756097561,0.06563647357451242,0.9372770983626986
16,108,16,140,0.12903225806451613,0.8857142857142857,0.07108264031100174,0.9276172344171203
33,81,25,139,0.2894736842105263,0.8201438848920863,0.10746707967026947,0.9043655061294208
12,94,2,108,0.11320754716981132,0.9814814814814815,0.09730647251809636,0.9055636934262628
5,61,1,67,0.07575757575757576,0.9850746268656716,0.0938432690548929,0.9048459244212174
6,68,59,133,0.08108108108108109,0.556390977443609,0.10282887804050189,0.8533779688179235
10,37,1,48,0.2127659574468085,0.9791666666666666,0.1332240148186174,0.8833688113087658
14,85,1,100,0.1414141414141414,0.99,0.1489617493063519,0.8854245604376857
2,24,4,30,0.07692307692307693,0.8666666666666667,0.14151758057186056,0.8827034720023116
7,77,12,96,0.08333333333333333,0.875,0.11206895901797585,0.8905400598748707
19,36,1,56,0.34545454545454546,0.9821428571428571,0.14524710163008073,0.89063454211221
0,4,59,63,0.0,0.06349206349206349,0.1344245908075699,0.7589798902016945
6,189,13,208,0.03076923076923077,0.9375,0.12723718362016273,0.813424036281179
18,203,14,235,0.08144796380090498,0.9404255319148936,0.10847747024217651,0.8078895884594972
35,104,12,151,0.2517985611510791,0.9205298013245033,0.12424667306173902,0.7979652743629977
4,54,7,65,0.06896551724137931,0.8923076923076924,0.1231098788214965,0.8016282780260012
29,193,6,228,0.13063063063063063,0.9736842105263158,0.12986663557825326,0.8157260223869036
1,16,49,66,0.058823529411764705,0.25757575757575757,0.08891934757214173,0.7122164367344608
4,9,2,15,0.3076923076923077,0.8666666666666667,0.1328753915281857,0.826955665759404
20,62,5,87,0.24390243902439024,0.9425287356321839,0.16332299270749417,0.8276740565640017
1,61,3,65,0.016129032258064516,0.9538461538461539,0.15399171677280268,0.8295912882684675
29,83,32,144,0.25892857142857145,0.7777777777777778,0.1550102896695873,0.8091981420475066
136,418,41,595,0.24548736462093862,0.9310924369747899,0.1802276964380958,0.8147388198570921
1,50,9,60,0.0196078431372549,0.85,0.1643672982247564,0.7970696469247612
17,69,20,106,0.19767441860465115,0.8113207547169812,0.1842031395380259,0.8761760750877932
2,0,0,2,1.0,1.0,0.2831042384391248,0.8952236941354123
1,15,1,17,0.0625,0.9411764705882353,0.2571896042927833,0.8950305134148483
13,90,2,105,0.1262135922330097,0.9809523809523809,0.27291597000348977,0.8989028315728805
12,114,24,150,0.09523809523809523,0.84,0.24953161626199316,0.9077917204617696
13,46,4,63,0.22033898305084745,0.9365079365079365,0.24593899032340868,0.9085653632522189
3,26,2,31,0.10344827586206896,0.9354838709677419,0.25791619499838214,0.9207773448190393
1,21,2,24,0.045454545454545456,0.9166666666666666,0.23745033192013285,0.9367791417642325
29,72,16,117,0.2871287128712871,0.8632478632478633,0.135611576616031,0.917243122228213
20,89,2,111,0.1834862385321101,0.9819819819819819,0.152895324977761,0.9230724809987482
28,95,3,126,0.22764227642276422,0.9761904761904762,0.16599817445285772,0.9223922088899046
84,295,36,415,0.22163588390501318,0.9132530120481928,0.18416213087123418,0.9319045439444084
6,80,20,106,0.06976744186046512,0.8113207547169812,0.16265191070117951,0.9140206608314146
0,36,4,40,0.0,0.9,0.14787358557802682,0.9089515364074516
0,13,1,14,0.0,0.9285714285714286,0.14138007908452033,0.9106522166795604
1,13,2,16,0.07142857142857142,0.875,0.1105657731641324,0.9123310933584371
9,200,59,268,0.0430622009569378,0.7798507462686567,0.0905051963676792,0.8834552025422477
29,116,24,169,0.2,0.8579881656804734,0.08655629973585574,0.866569158183676
2,20,4,26,0.09090909090909091,0.8461538461538461,0.06788104359358113,0.8569835630559123
1,23,101,125,0.041666666666666664,0.192,0.0638666471373242,0.7685091695249149
4,39,10,53,0.09302325581395349,0.8113207547169812,0.07715568368217471,0.755840705913055
13,167,25,205,0.07222222222222222,0.8780487804878049,0.08747314399963502,0.7486231847582516
15,148,3,166,0.09202453987730061,0.9819277108433735,0.09041542520659633,0.7638985720215908
12,131,7,150,0.08391608391608392,0.9533333333333334,0.09625169420076007,0.7886817987451159
4,111,2,117,0.034782608695652174,0.9829059829059829,0.07264920972871038,0.8065272012059029
40,177,6,223,0.18433179723502305,0.9730941704035875,0.08599531063241496,0.8246615332415803
9,91,1,101,0.09,0.9900990099009901,0.09290007253717689,0.9386756775131503
1,58,1,60,0.01694915254237288,0.9833333333333333,0.08203234349837965,0.9632489030297721
0,30,9,39,0.0,0.7692307692307693,0.07171488318091933,0.9477034728501955
5,155,4,164,0.03125,0.975609756097561,0.06303280605559067,0.946800907886508
15,109,16,140,0.12096774193548387,0.8857142857142857,0.0683259000583621,0.9371410439409298
32,81,26,139,0.2831858407079646,0.8129496402877698,0.10381207606012101,0.9128615664240423
12,94,2,108,0.11320754716981132,0.9814814814814815,0.09365146890794791,0.9140597537208842
6,60,1,67,0.09090909090909091,0.9850746268656716,0.09378133903781805,0.9133419847158388
6,115,12,133,0.049586776859504134,0.9097744360902256,0.09844385679740822,0.9028335708239662
10,37,1,48,0.2127659574468085,0.9791666666666666,0.12883899357552372,0.9328244133148088
13,86,1,100,0.13131313131313133,0.99,0.14313372662025678,0.9348801624437286
2,24,4,30,0.07692307692307693,0.8666666666666667,0.13684163161848434,0.9321590740083544
8,76,12,96,0.09523809523809523,0.875,0.1099919536942173,0.9410234111101016
17,38,1,56,0.3090909090909091,0.9821428571428571,0.137975291111517,0.9411178933474409
0,4,59,63,0.0,0.06349206349206349,0.12498827812450398,0.8094632414369256
5,190,13,208,0.02564102564102564,0.9375,0.12156745652186421,0.8134240362811791
17,204,14,235,0.07692307692307693,0.9404255319148936,0.10216133073275968,0.8078895884594972
35,104,12,151,0.2517985611510791,0.9205298013245033,0.11937353499532366,0.7979652743629976
3,56,6,65,0.05084745762711865,0.9076923076923077,0.11564844652447247,0.8038260802238035
28,194,6,228,0.12612612612612611,0.9736842105263158,0.12006102236561975,0.8179238245847058
1,13,52,66,0.07142857142857142,0.21212121212121213,0.08610925984242865,0.7079207324387565
4,9,2,15,0.3076923076923077,0.8666666666666667,0.13006530379847261,0.8226599614636997
20,62,5,87,0.24390243902439024,0.9425287356321839,0.16124550571038185,0.8233783522682974
1,61,3,65,0.016129032258064516,0.9538461538461539,0.15256064218680865,0.8252955839727631
30,82,32,144,0.26785714285714285,0.7777777777777778,0.15485472528767488,0.8049024377518024
128,425,41,594,0.2314647377938517,0.930976430976431,0.18065719388292245,0.8082287410781058
1,50,9,60,0.0196078431372549,0.85,0.1654402963130837,0.7905595681457749
17,69,20,106,0.19767441860465115,0.8113207547169812,0.18347541733823794,0.8761595028023133
2,0,0,2,1.0,1.0,0.28237651623933685,0.8952071218499326
1,15,1,17,0.0625,0.9411764705882353,0.2564618820929954,0.8950139411293684
13,90,2,105,0.1262135922330097,0.9809523809523809,0.2721882478037018,0.8988862592874007
13,113,24,150,0.10317460317460317,0.84,0.2486621707061962,0.9077751481762897
13,46,4,63,0.22033898305084745,0.9365079365079365,0.24707277717148132,0.9085653632522189
3,26,2,31,0.10344827586206896,0.9354838709677419,0.2590499818464547,0.9207773448190393
1,22,1,24,0.043478260869565216,0.9583333333333334,0.16747402172052173,0.9389224280369962
29,73,15,117,0.28431372549019607,0.8717948717948718,0.13666169679054974,0.9206074097219779
20,89,2,111,0.1834862385321101,0.9819819819819819,0.15394544515227976,0.9264367684925132
27,95,3,125,0.22131147540983606,0.976,0.17003341990026874,0.9260477107417533
85,296,34,415,0.2230971128608924,0.9180722891566265,0.18616593723390715,0.9384886212651345
10,76,20,106,0.11627906976744186,0.8113207547169812,0.16901099914873652,0.9212196733917735
0,36,4,40,0.0,0.9,0.15313798327572065,0.9167861758548277
0,13,1,14,0.0,0.9285714285714286,0.14692680315149703,0.9125344751745557
1,14,1,16,0.06666666666666667,0.9375,0.1158343661767071,0.9219209220610025
8,201,59,268,0.03827751196172249,0.7798507462686567,0.09509026238093744,0.893045031244813
30,115,24,169,0.20689655172413793,0.8579881656804734,0.09303098756869486,0.876186197770595
1,25,0,26,0.038461538461538464,1.0,0.06665447694021573,0.8878901564625056
1,50,74,125,0.0196078431372549,0.408,0.05284430170733188,0.8302729057886511
4,46,3,53,0.08,0.9433962264150944,0.06427287313590331,0.8364723667050932
12,165,27,204,0.06779661016949153,0.8676470588235294,0.07395810316011638,0.8277688853125361
13,150,3,166,0.07975460122699386,0.9819277108433735,0.07582780809730598,0.8341157011473037
13,129,8,150,0.09154929577464789,0.9466666666666667,0.0834380629277239,0.8579465469184481
3,112,2,117,0.02608695652173913,0.9829059829059829,0.05760812075595263,0.8757919493792351
40,177,6,223,0.18433179723502305,0.9730941704035875,0.0784467291521647,0.8719482594368905
9,91,1,101,0.09,0.9900990099009901,0.0885027515611283,0.9551052608513176
2,57,1,60,0.03389830508474576,0.9833333333333333,0.0819167951446634,0.9608105618396375
1,29,9,39,0.03333333333333333,0.7692307692307693,0.0769934698823551,0.9467510918978146
5,155,4,164,0.03125,0.975609756097561,0.07006424113564169,0.9458485269341271
15,110,15,140,0.12,0.8928571428571429,0.07412862745354913,0.9381614521041952
36,78,25,139,0.3157894736842105,0.8201438848920863,0.11551470133390218,0.9149097238164956
11,95,2,108,0.10377358490566038,0.9814814814814815,0.10400638528685038,0.9161079111133377
3,63,1,67,0.045454545454545456,0.9850746268656716,0.09764274892321402,0.9153901421082921
5,116,12,133,0.04132231404958678,0.9097744360902256,0.09870332163247701,0.9048817282164195
3,44,1,48,0.06382978723404255,0.9791666666666666,0.10305995790400692,0.9348725707072622
14,85,1,100,0.1414141414141414,0.99,0.1187976923917414,0.9369283198361819
4,22,4,30,0.15384615384615385,0.8666666666666667,0.12363285722690623,0.9331868232375425
8,80,8,96,0.09090909090909091,0.9166666666666666,0.091507088259032,0.9469757920624825
17,38,1,56,0.3090909090909091,0.9821428571428571,0.12083813457121038,0.9470702742998219
0,4,59,63,0.0,0.06349206349206349,0.11434462807770389,0.8154156223893064
4,195,9,208,0.020100502512562814,0.9567307692307693,0.1113129407152719,0.8221236699808127
18,204,13,235,0.08108108108108109,0.9446808510638298,0.11377741126484883,0.8171971248946932
34,114,3,151,0.22972972972972974,0.9801324503311258,0.12639392388136145,0.8157874749419969
6,52,7,65,0.10344827586206896,0.8923076923076924,0.11919422702649218,0.8194504786050005
28,194,6,228,0.12612612612612611,0.9736842105263158,0.12422523205749722,0.8275958420135219
7,57,2,66,0.109375,0.9696969696969697,0.09569438790165306,0.8258178580926808
4,9,2,15,0.3076923076923077,0.8666666666666667,0.13965043185769702,0.9405570871176241
19,63,5,87,0.23170731707317074,0.9425287356321839,0.1698799767949267,0.938528225174969
1,61,3,65,0.016129032258064516,0.9538461538461539,0.16060111267735291,0.9398375541438725
29,87,28,144,0.25,0.8055555555555556,0.1634968655731058,0.9148979977473625
127,428,39,594,0.22882882882882882,0.9343434343434344,0.18140837313978578,0.9209031037524683
1,50,9,60,0.0196078431372549,0.85,0.16619147556994704,0.9032339308201376
18,68,20,106,0.20930232558139536,0.8113207547169812,0.18046680779586066,0.8806087572515677
2,0,0,2,1.0,1.0,0.27936790669695954,0.8996563762991868
1,15,1,17,0.0625,0.9411764705882353,0.25519543282936374,0.8994631955786228
14,89,2,105,0.13592233009708737,0.9809523809523809,0.2723087610920813,0.9033355137366552
12,115,23,150,0.09448818897637795,0.8466666666666667,0.2500927880887067,0.9092085296096711
13,46,4,63,0.22033898305084745,0.9365079365079365,0.24887995297756654,0.9095177442046
3,26,2,31,0.10344827586206896,0.9354838709677419,0.26085715765254,0.9217297257714202
1,20,1,22,0.047619047619047616,0.9545454545454546,0.23188807031711584,0.9392232335146071
28,62,16,106,0.3111111111111111,0.8490566037735849,0.13347537190441744,0.9176598911965479
16,73,2,91,0.1797752808988764,0.978021978021978,0.15022898346139982,0.922923535115654
26,72,3,101,0.2653061224489796,0.9702970297029703,0.1741547028174652,0.9217197673224613
81,256,35,372,0.2403560830860534,0.9059139784946236,0.19880605609125973,0.9315818453039627
6,69,20,95,0.08,0.7894736842105263,0.1764683937535974,0.9111918873582512
0,29,4,33,0.0,0.8787878787878788,0.16059537788058154,0.9037280867910022
0,13,1,14,0.0,0.9285714285714286,0.15379265679214615,0.9000175116518557
2,6,2,10,0.25,0.8,0.14506249806198745,0.8930094253984865
6,161,59,226,0.03592814371257485,0.7389380530973452,0.12451290703537292,0.8588545789806817
28,104,24,156,0.21212121212121213,0.8461538461538461,0.11691506270283471,0.841119838473664
2,18,4,24,0.1,0.8333333333333334,0.09686419369054138,0.8307511748791939
1,28,92,121,0.034482758620689655,0.2396694214876033,0.09036173063635419,0.7522077087759191
3,35,10,48,0.07894736842105263,0.7916666666666666,0.101639926125076,0.7397618213300319
15,148,24,187,0.09202453987730061,0.8716577540106952,0.11478628896469036,0.7316312963927842
13,116,3,132,0.10077519379844961,0.9772727272727273,0.09346845950732603,0.7569559717174593
11,122,8,141,0.08270676691729323,0.9432624113475178,0.10015111996514293,0.7861451657531984
4,97,2,103,0.039603960396039604,0.9805825242718447,0.07550579829011829,0.8053492626271981
40,177,6,223,0.18433179723502305,0.9730941704035875,0.08755319789512159,0.8253150964943774
5,73,1,79,0.0641025641025641,0.9873417721518988,0.09178459867824651,0.9321254323035625
2,49,1,52,0.0392156862745098,0.9807692307692307,0.08610864408588324,0.9591400843182144
0,28,8,36,0.0,0.7777777777777778,0.07296228124626887,0.9457286591420833
5,150,4,159,0.03225806451612903,0.9748427672955975,0.06317411992022307,0.9453815220024934
15,100,16,131,0.13043478260869565,0.8778625954198473,0.0699924078761377,0.9360386911556834
29,69,25,123,0.29591836734693877,0.7967479674796748,0.10660875172626616,0.9097766116139449
12,86,2,100,0.12244897959183673,0.98,0.09776834920581097,0.9107631586991466
4,59,2,65,0.06349206349206349,0.9692307692307692,0.09768113483288231,0.9081758725675567
5,101,13,119,0.04716981132075472,0.8907563025210085,0.0988174384109173,0.8953168828178105
9,37,1,47,0.1956521739130435,0.9787234042553191,0.1267677489699235,0.9240234008860309
13,83,1,97,0.13541666666666666,0.9896907216494846,0.14150469213428601,0.9261445372223004
2,22,4,28,0.08333333333333333,0.8571428571428571,0.13477591366637712,0.9231845746113018
7,59,12,78,0.10606060606060606,0.8461538461538461,0.10765337633975816,0.9302425572790406
16,34,1,51,0.32,0.9803921568627451,0.1358749506837815,0.930298579688004
0,1,59,60,0.0,0.016666666666666666,0.126804655899201,0.7942179936074181
5,162,13,180,0.029940119760479042,0.9277777777777778,0.12434327139059019,0.7995067757869565
17,167,13,197,0.09239130434782608,0.934010152284264,0.10959171859555913,0.79311916836252
32,93,12,137,0.256,0.9124087591240876,0.12681790907174958,0.7820788880017491
4,51,7,62,0.07272727272727272,0.8870967741935484,0.1253027575565981,0.7863580190089907
32,169,6,207,0.15920398009950248,0.9710144927536232,0.13289466813358328,0.8041952542375302
0,12,53,65,0.0,0.18461538461538463,0.08718038241929757,0.6905128582021931
4,8,2,14,0.3333333333333333,0.8571428571428571,0.13479943003834519,0.8105808854130773
19,44,5,68,0.30158730158730157,0.9264705882352942,0.17360617029931985,0.8103941440498655
1,59,3,63,0.016666666666666666,0.9523809523809523,0.16278836491629706,0.8130185440636781
28,82,32,142,0.2545454545454545,0.7746478873239436,0.16258057270850484,0.7933384195208003
113,337,30,480,0.2511111111111111,0.9375,0.1880639781919103,0.8005388803502934
1,43,9,53,0.022727272727272728,0.8301886792452831,0.16856730571016323,0.7804209069919592
17,58,20,95,0.22666666666666666,0.7894736842105263,0.20094825809111563,0.8668292355055508
1,1,0,2,0.5,1.0,0.22475778190063941,0.887237398770857
1,15,1,17,0.0625,0.9411764705882353,0.1906024531024535,0.8893382391069914
10,82,2,94,0.10869565217391304,0.9787234042553191,0.2037494510320601,0.8931014465176152
13,105,24,142,0.11016949152542373,0.8309859154929577,0.18312431345777,0.9011497362560459
13,42,4,59,0.23636363636363636,0.9322033898305084,0.1810175313509879,0.9003930776604042
3,24,2,29,0.1111111111111111,0.9310344827586207,0.19364379397725054,0.9147996210194523
1,20,1,22,0.047619047619047616,0.9545454545454546,0.22397540832262236,0.9412380162231069
30,61,16,107,0.32967032967032966,0.8504672897196262,0.12821402684695515,0.9198762004687678
15,75,2,92,0.16666666666666666,0.9782608695652174,0.14309497922790754,0.9251739717511936
28,70,3,101,0.2857142857142857,0.9702970297029703,0.17142864279041994,0.9236517787155636
72,266,34,372,0.21301775147928995,0.9086021505376344,0.19278945536002373,0.9334520859352258
3,72,20,95,0.04,0.7894736842105263,0.16944805100167018,0.9124471927498815
0,29,4,33,0.0,0.8787878787878788,0.15466972587851746,0.9043477652956152
0,13,1,14,0.0,0.9285714285714286,0.14786700479008208,0.9006371901564687
1,7,2,10,0.125,0.8,0.1186283862657493,0.8934275773393792
7,160,59,226,0.041916167664670656,0.7389380530973452,0.10080688640832129,0.8592386035582547
29,103,23,155,0.2196969696969697,0.8516129032258064,0.09137584126299045,0.8422837283472313
2,18,4,24,0.1,0.8333333333333334,0.07523044819452045,0.8315310401751883
1,25,95,121,0.038461538461538464,0.21487603305785125,0.07501066797474022,0.7494456614390917
3,35,10,48,0.07894736842105263,0.7916666666666666,0.08628886346346203,0.7369997739932044
14,150,24,188,0.08536585365853659,0.8723404255319149,0.09848398541468154,0.7289667735589881
10,119,3,132,0.07751937984496124,0.9772727272727273,0.09170103967824743,0.7542914488836635
12,122,7,141,0.08955223880597014,0.950354609929078,0.09850619269843308,0.7844938141453396
5,96,2,103,0.04950495049504951,0.9805825242718447,0.07419304709815876,0.8029180457233451
40,177,6,223,0.18433179723502305,0.9730941704035875,0.08624044670316204,0.8228838795905241
5,73,1,79,0.0641025641025641,0.9873417721518988,0.08990345036616573,0.933236128032531
2,49,1,52,0.0392156862745098,0.9807692307692307,0.08422749577380247,0.960250780047183
0,28,8,36,0.0,0.7777777777777778,0.07203237382258296,0.9467418303680205
5,150,4,159,0.03225806451612903,0.9748427672955975,0.06556647163274977,0.9463946932284306
16,99,16,131,0.1391304347826087,0.8778625954198473,0.07264907105798384,0.9360386911556832
30,68,25,123,0.30612244897959184,0.7967479674796748,0.10930871369863275,0.9097766116139449
12,86,2,100,0.12244897959183673,0.98,0.10046831117817756,0.9107631586991466
5,59,1,65,0.078125,0.9846153846153847,0.1024715163063827,0.9103736747653589
5,102,12,119,0.04672897196261682,0.8991596638655462,0.10354484283325513,0.8987151652076896
10,36,1,47,0.21739130434782608,0.9787234042553191,0.13460074345437315,0.9274216832759098
14,82,1,97,0.14583333333333334,0.9896907216494846,0.1508257818568309,0.9295428196121794
2,22,4,28,0.08333333333333333,0.8571428571428571,0.14285476736407726,0.9265828570011809
7,59,12,78,0.10606060606060606,0.8461538461538461,0.11427450408993645,0.9336408396689196
16,34,1,51,0.32,0.9803921568627451,0.14249607843395976,0.9336968620778832
0,1,59,60,0.0,0.016666666666666666,0.13133536414824548,0.7954184737994948
4,167,9,180,0.023391812865497075,0.95,0.12800148427722838,0.8026813789615597
18,166,14,198,0.09782608695652174,0.9292929292929293,0.11092073893561347,0.7956198825383611
33,92,11,136,0.264,0.9191176470588235,0.12780169131656585,0.7855380147396953
4,51,7,62,0.07272727272727272,0.8870967741935484,0.12628653980141433,0.7898171457469368
30,171,6,207,0.14925373134328357,0.9710144927536232,0.13245698627036825,0.8076543809754764
0,12,53,65,0.0,0.18461538461538463,0.08674270055608255,0.6939719849401392
3,9,2,14,0.25,0.8571428571428571,0.12245698627036826,0.8140400121510236
19,44,5,68,0.30158730158730157,0.9264705882352942,0.16219919894491172,0.8106786676132084
1,59,3,63,0.016666666666666666,0.9523809523809523,0.15060499604636104,0.8139769566257832
29,80,32,141,0.26605504587155965,0.7730496453900709,0.1508985740280124,0.7931100992445328
113,339,29,481,0.25,0.9397089397089398,0.1762232493526877,0.8006261228895888
1,43,9,53,0.022727272727272728,0.8301886792452831,0.1581480409789719,0.7805081495312544
17,58,20,95,0.22666666666666666,0.7894736842105263,0.19052899335992426,0.8669164780448462
2,0,0,2,1.0,1.0,0.2976718505027814,0.8873246413101522
1,15,1,17,0.0625,0.9411764705882353,0.2635165217045955,0.8894254816462868
9,83,2,94,0.09782608695652174,0.9787234042553191,0.2751107246031462,0.8931886890569105
8,110,23,141,0.06779661016949153,0.8368794326241135,0.24678809093142218,0.9023072300903452
13,42,4,59,0.23636363636363636,0.9322033898305084,0.24484003898337023,0.9012350086791406
3,24,2,29,0.1111111111111111,0.9310344827586207,0.25746630160963285,0.915641552038189
1,22,1,24,0.043478260869565216,0.9583333333333334,0.21877442675145692,0.9408267608118515
29,71,17,117,0.29,0.8547008547008547,0.11734585532288551,0.9200697400548307
18,91,2,111,0.1651376146788991,0.9819819819819819,0.13200837170558538,0.9258990988253659
27,94,3,124,0.2231404958677686,0.9758064516129032,0.15001595988086994,0.9251639660625834
76,305,33,414,0.1994750656167979,0.9202898550724637,0.17051239782612676,0.9375863263110306
6,80,20,106,0.06976744186046512,0.8113207547169812,0.15142348516212542,0.9197024431980371
0,36,4,40,0.0,0.9,0.14157126841335696,0.914633318774074
0,12,2,14,0.0,0.8571428571428571,0.13536008828913335,0.9001775364611487
1,13,2,16,0.07142857142857142,0.875,0.10413559849321498,0.9030774143610267
6,202,59,267,0.028846153846153848,0.7790262172284644,0.08466538980282282,0.8740837336819526
28,118,23,169,0.1917808219178082,0.863905325443787,0.0801854363813999,0.8580978585149361
1,21,4,26,0.045454545454545456,0.8461538461538461,0.05818250492964954,0.8475070000979906
1,22,102,125,0.043478260869565216,0.184,0.05442690764523528,0.7578897494241362
3,40,10,53,0.06976744186046512,0.8113207547169812,0.06439368505387315,0.7452212858122765
9,171,27,207,0.05,0.8695652173913043,0.0715365421967303,0.7469959087049116
13,150,3,166,0.07975460122699386,0.9819277108433735,0.07272597502507636,0.7622712959682508
12,131,7,150,0.08391608391608392,0.9533333333333334,0.08059310789220922,0.7871723125546607
3,111,2,116,0.02631578947368421,0.9827586206896551,0.05695524611447722,0.8041513547326418
40,177,6,223,0.18433179723502305,0.9730941704035875,0.07679485351168831,0.8222856867683193
9,91,1,101,0.09,0.9900990099009901,0.08344081624460756,0.9374426881827463
1,54,5,60,0.01818181818181818,0.9166666666666666,0.07607144143337229,0.9524921041755585
1,29,9,39,0.03333333333333333,0.7692307692307693,0.0736904890524199,0.9381586115811965
5,155,4,164,0.03125,0.975609756097561,0.06676126030570649,0.9372560466175088
15,109,16,140,0.12096774193548387,0.8857142857142857,0.07205435430847792,0.9275961826719306
29,85,25,139,0.2543859649122807,0.8201438848920863,0.10463580794256314,0.9043655061294208
11,95,2,108,0.10377358490566038,0.9814814814814815,0.09312749189551132,0.9055636934262628
5,60,2,67,0.07692307692307693,0.9701492537313433,0.09125936002737946,0.9027137282591704
4,116,12,132,0.03333333333333333,0.9090909090909091,0.09342386219188162,0.9016314771769194
9,40,1,50,0.1836734693877551,0.98,0.11490102448537044,0.9317413672868093
13,86,1,100,0.13131313131313133,0.99,0.1291957575301035,0.9337971164157292
2,24,4,30,0.07692307692307693,0.8666666666666667,0.12290366252833107,0.9310760279803552
7,77,12,96,0.08333333333333333,0.875,0.09846757230276716,0.9389126158529143
14,40,2,56,0.25925925925925924,0.9642857142857143,0.12067981149613842,0.9364560776820905
0,4,59,63,0.0,0.06349206349206349,0.10969080050712744,0.8069336219336218
4,196,9,209,0.02,0.9569377990430622,0.10778603860236553,0.8137688919267865
20,202,12,234,0.09009009009009009,0.9487179487179487,0.09441698441698483,0.809300027457922
30,107,13,150,0.21897810218978103,0.9133333333333333,0.10694055168507763,0.7983476465055411
3,54,7,64,0.05263157894736842,0.890625,0.10347033768854784,0.8017702655531601
31,191,6,228,0.13963963963963963,0.9736842105263158,0.11151409573230588,0.8158680099140624
1,11,54,66,0.08333333333333333,0.18181818181818182,0.08638182060003076,0.704086933847272
4,9,1,14,0.3076923076923077,0.9285714285714286,0.1303378645560747,0.8276697002871813
20,62,5,87,0.24390243902439024,0.9425287356321839,0.16232392727384476,0.8256112626570559
0,62,3,65,0.0,0.9538461538461539,0.14945391440383188,0.8263438633896566
28,81,34,143,0.25688073394495414,0.7622377622377622,0.15486857608314233,0.804758781804575
121,431,43,595,0.21920289855072464,0.9277310924369748,0.17866447888362177,0.8100596521527142
1,50,9,60,0.0196078431372549,0.85,0.1615170793832811,0.7923904792203835
16,69,20,105,0.18823529411764706,0.8095238095238095,0.17650307378104024,0.8820627117497589
2,0,0,2,1.0,1.0,0.2754041726821391,0.8922667933824119
1,15,1,17,0.0625,0.9411764705882353,0.24948953853579767,0.8920736126618479
9,94,2,105,0.08737864077669903,0.9809523809523809,0.26197220150389755,0.8959459308198802
8,118,24,150,0.06349206349206349,0.84,0.23434524858205602,0.9070548219287715
12,47,4,63,0.2033898305084746,0.9365079365079365,0.23208623886173457,0.9083086567960516
3,26,2,31,0.10344827586206896,0.9354838709677419,0.24406344353670797,0.9205206383628718
1,22,1,24,0.043478260869565216,0.9583333333333334,0.22565144105455567,0.9417791417642325
29,71,17,117,0.29,0.8547008547008547,0.12422286962598426,0.9210221210072117
17,92,2,111,0.1559633027522936,0.9819819819819819,0.13757477001916904,0.9268514797777468
27,94,3,124,0.2231404958677686,0.9758064516129032,0.15696932074646472,0.9261163470149644
72,307,35,414,0.18997361477572558,0.9154589371980676,0.17277054009084278,0.9368961951861169
7,79,20,106,0.08139534883720931,0.8113207547169812,0.1553427569949477,0.9190123120731233
0,36,4,40,0.0,0.9,0.140564431871795,0.9139431876491602
0,12,2,14,0.0,0.8571428571428571,0.1343532517475714,0.8994874053362348
1,13,2,16,0.07142857142857142,0.875,0.10312876195165302,0.9023872832361128
6,203,58,267,0.028708133971291867,0.7827715355805244,0.08494945212579565,0.8739286480359046
29,117,23,169,0.19863013698630136,0.863905325443787,0.08144797228558602,0.8579427728688881
1,21,4,26,0.045454545454545456,0.8461538461538461,0.06080239095398887,0.8480420455768564
1,24,100,125,0.04,0.2,0.05488876969153039,0.7607105091887163
4,39,10,53,0.09302325581395349,0.8113207547169812,0.0681778062363809,0.7480420455768565
10,170,27,207,0.05555555555555555,0.8695652173913043,0.07611431417288883,0.7498166684694917
12,151,3,166,0.0736196319018405,0.9819277108433735,0.07642732281192728,0.7650920557328309
12,131,7,150,0.08391608391608392,0.9533333333333334,0.08431417280404041,0.789458026840375
3,111,2,116,0.02631578947368421,0.9827586206896551,0.05969783744509511,0.8064370690183561
40,177,6,223,0.18433179723502305,0.9730941704035875,0.0795374448423062,0.8245714010540335
9,91,1,101,0.09,0.9900990099009901,0.08668030198516333,0.9374426881827463
2,53,5,60,0.03636363636363636,0.9166666666666666,0.07858607063511804,0.9524921041755585
1,29,9,39,0.03333333333333333,0.7692307692307693,0.07541146746051486,0.9381586115811965
5,155,4,164,0.03125,0.975609756097561,0.06935866290310908,0.9372560466175088
15,109,16,140,0.12096774193548387,0.8857142857142857,0.07465175690588051,0.9275961826719306
29,85,25,139,0.2543859649122807,0.8201438848920863,0.10723321053996572,0.9043655061294208
11,95,2,108,0.10377358490566038,0.9814814814814815,0.09572489449291391,0.9055636934262628
4,61,2,67,0.06153846153846154,0.9701492537313433,0.09165896042697984,0.9027137282591704
4,115,13,132,0.03361344537815126,0.9015151515151515,0.09126607600048198,0.9005492260946683
9,40,1,50,0.1836734693877551,0.98,0.1127432382939708,0.9306591162045583
13,86,1,100,0.13131313131313133,0.99,0.12703797133870384,0.9327148653334782
2,24,4,30,0.07692307692307693,0.8666666666666667,0.12074587633693142,0.929993776898104
7,75,14,96,0.08536585365853659,0.8541666666666666,0.09660014615782511,0.9348541742944727
15,39,2,56,0.2777777777777778,0.9642857142857143,0.12145788799669902,0.9323976361236487
0,4,59,63,0.0,0.06349206349206349,0.11266667920549023,0.8028751803751802
4,196,9,209,0.02,0.9569377990430622,0.11072190129432577,0.8107927014505961
19,203,12,234,0.08558558558558559,0.9487179487179487,0.0967093464654444,0.8063238369817316
29,107,14,150,0.21323529411764705,0.9066666666666666,0.10841251258037522,0.7944190750769697
3,54,7,64,0.05263157894736842,0.890625,0.10494229858384545,0.7978416941245887
31,191,6,228,0.13963963963963963,0.9736842105263158,0.11269569658114588,0.8149156289616813
1,8,57,66,0.1111111111111111,0.13636363636363635,0.08888617277162207,0.6966410464013847
4,9,1,14,0.3076923076923077,0.9285714285714286,0.13284221672766602,0.8202238128412939
20,62,5,87,0.24390243902439024,0.9425287356321839,0.16482827944543607,0.8181653752111685
0,62,3,65,0.0,0.9538461538461539,0.15260176721892385,0.8188979759437691
29,81,33,143,0.2636363636363636,0.7692307692307693,0.15980192000731192,0.7992642763100696
117,433,45,595,0.21272727272727274,0.9243697478991597,0.18267273340444112,0.8040849545813781
1,50,9,60,0.0196078431372549,0.85,0.16552533390410043,0.7864157816490474
16,69,20,105,0.18823529411764706,0.8095238095238095,0.17654307433360558,0.8825815206719291
2,0,0,2,1.0,1.0,0.2754441732347045,0.8927856023045823
1,15,1,17,0.0625,0.9411764705882353,0.249529539088363,0.8925924215840182
10,93,2,105,0.0970873786407767,0.9809523809523809,0.26339916460847396,0.8964647397420507
7,118,25,150,0.056,0.8333333333333334,0.23373682694613632,0.9056222488995597
12,47,4,63,0.2033898305084746,0.9365079365079365,0.23240290662916513,0.9073562758436707
2,27,2,31,0.06896551724137931,0.9354838709677419,0.23945400292975436,0.9195682574104909
1,22,1,24,0.043478260869565216,0.9583333333333334,0.22867464151788197,0.9427315227166133
30,72,15,117,0.29411764705882354,0.8717948717948718,0.1278343053834282,0.9244165044015951
18,91,2,111,0.1651376146788991,0.9819819819819819,0.14249682176612805,0.9302458631721304
28,94,3,125,0.22950819672131148,0.976,0.16418800659594093,0.929538380178933
78,300,36,414,0.20634920634920634,0.9130434782608695,0.17791843314976455,0.9390207818352477
8,78,20,106,0.09302325581395349,0.8113207547169812,0.1621517796219758,0.921136898722254
0,36,4,40,0.0,0.9,0.14737345449882308,0.916067774298291
0,13,1,14,0.0,0.9285714285714286,0.14116227437459952,0.911816073618019
1,13,2,16,0.07142857142857142,0.875,0.1093495492845635,0.9122739490758943
7,204,58,269,0.03317535545023697,0.7843866171003717,0.0904977979661832,0.8840460398070927
28,117,24,169,0.19310344827586207,0.8579881656804734,0.08529711961683328,0.8671872063328747
2,20,4,26,0.09090909090909091,0.8461538461538461,0.06880567455395965,0.8576315446032999
2,26,97,125,0.07142857142857142,0.224,0.06572071964176221,0.7737285796437313
4,39,10,53,0.09302325581395349,0.8113207547169812,0.0790097561866127,0.7610601160318715
11,171,25,207,0.06043956043956044,0.8792270531400966,0.0876439791065499,0.7540109195416811
13,150,3,166,0.07975460122699386,0.9819277108433735,0.08883341193489598,0.7692863068050203
12,131,7,150,0.08391608391608392,0.9533333333333334,0.09608208743001698,0.7934215519811577
6,108,2,116,0.05263157894736842,0.9827586206896551,0.07601467752594646,0.811245902696755
40,177,6,223,0.18433179723502305,0.9730941704035875,0.08936077842965104,0.8293802347324323
9,91,1,101,0.09,0.9900990099009901,0.09201383965414082,0.9388229504325738
2,57,1,60,0.03389830508474576,0.9833333333333333,0.08356741812139687,0.9633961759491955
1,29,9,39,0.03333333333333333,0.7692307692307693,0.07969509996336444,0.947682421105006
6,154,4,164,0.0375,0.975609756097561,0.07365872835950817,0.9467798561413183
15,109,16,140,0.12096774193548387,0.8857142857142857,0.07895182236227959,0.93711999219574
33,81,25,139,0.2894736842105263,0.8201438848920863,0.112786408828445,0.9138893156532303
11,95,2,108,0.10377358490566038,0.9814814814814815,0.10127809278139319,0.9150875029500724
5,61,1,67,0.07575757575757576,0.9850746268656716,0.09924346074676116,0.9143697339450269
5,114,13,132,0.04201680672268908,0.9015151515151515,0.10040324669503876,0.9026814222567151
10,39,1,50,0.20408163265306123,0.98,0.12479586088357132,0.9327913123666053
14,85,1,100,0.1414141414141414,0.99,0.13964073822844866,0.934847061495525
2,24,4,30,0.07692307692307693,0.8666666666666667,0.13334864322667625,0.932125973060151
7,77,12,96,0.08333333333333333,0.875,0.10390002167279154,0.9399625609327101
18,37,1,56,0.32727272727272727,0.9821428571428571,0.13582847058237252,0.9400570431700493
0,4,59,63,0.0,0.06349206349206349,0.1250059597598617,0.808402391259534
5,195,9,209,0.025,0.9569377990430622,0.12257498737090612,0.8163199123349498
18,204,12,234,0.08108108108108109,0.9487179487179487,0.10500348000348038,0.8118510478660853
31,104,15,150,0.22962962962962963,0.9,0.11760569260569298,0.7989939050089425
3,54,7,64,0.05263157894736842,0.890625,0.1141354786091632,0.8024165240565615
31,191,6,228,0.13963963963963963,0.9736842105263158,0.12217923665292123,0.8165142684174638
1,14,51,66,0.06666666666666667,0.22727272727272727,0.08494979942348402,0.7086756784360168
4,8,2,14,0.3333333333333333,0.8571428571428571,0.13256884704253163,0.822054363243273
20,62,5,87,0.24390243902439024,0.9425287356321839,0.16384062404601593,0.8199959256131474
1,61,3,65,0.016129032258064516,0.9538461538461539,0.15456175992844215,0.8207285263457481
30,81,33,144,0.2702702702702703,0.7708333333333334,0.16036756573424796,0.8022761453933673
120,434,41,595,0.21660649819494585,0.9310924369747899,0.1837925541981876,0.8080572078183372
1,50,9,60,0.0196078431372549,0.85,0.1666451546978469,0.7903880348860064
17,68,20,105,0.2,0.8095238095238095,0.18569277374546594,0.8735667609218752
2,0,0,2,1.0,1.0,0.2809308689835612,0.8939749241871814
1,15,1,17,0.0625,0.9411764705882353,0.25501623483721975,0.8937817434666174
9,94,2,105,0.08737864077669903,0.9809523809523809,0.2651947503398818,0.8976540616246498
10,116,24,150,0.07936507936507936,0.84,0.23792258021056883,0.9075350140056021
12,47,4,63,0.2033898305084746,0.9365079365079365,0.2360344848267872,0.9083086567960516
3,26,2,31,0.10344827586206896,0.9354838709677419,0.24801168950176064,0.9205206383628718
1,22,1,24,0.043478260869565216,0.9583333333333334,0.22677754033069902,0.9427315227166133
30,72,15,117,0.29411764705882354,0.8717948717948718,0.12593720419624524,0.9244165044015951
18,91,2,111,0.1651376146788991,0.9819819819819819,0.14059972057894513,0.9302458631721303
27,95,3,125,0.22131147540983606,0.976,0.15834602011738216,0.9295383801789331
78,302,34,414,0.20526315789473684,0.9178743961352657,0.1741710156771477,0.9397109129601615
5,81,20,106,0.05813953488372093,0.8113207547169812,0.15584228095109334,0.9218270298471679
0,36,4,40,0.0,0.9,0.14106395582794062,0.9167579054232047
0,13,1,14,0.0,0.9285714285714286,0.13485277570371704,0.9125062047429326
1,13,2,16,0.07142857142857142,0.875,0.10304005061368102,0.9129640802008081
8,202,59,269,0.0380952380952381,0.7806691449814126,0.08489113967315799,0.884205103486441
29,116,24,169,0.2,0.8579881656804734,0.08184664318603858,0.8673462700122229
3,19,4,26,0.13636363636363635,0.8461538461538461,0.07200385439588135,0.8571004771577344
3,29,93,125,0.09375,0.256,0.07709106369820694,0.7777689407695944
4,39,10,53,0.09302325581395349,0.8113207547169812,0.09038010024305744,0.7651004771577344
9,171,27,207,0.05,0.8695652173913043,0.09752295738591457,0.7566710184177167
14,149,3,166,0.08588957055214724,0.9819277108433735,0.09958881440356827,0.7719464056810558
12,131,7,150,0.08391608391608392,0.9533333333333334,0.10613464952083194,0.7966127183027588
5,109,2,116,0.043859649122807015,0.9827586206896551,0.08382888510980438,0.8144370690183561
40,177,6,223,0.18433179723502305,0.9730941704035875,0.09068147952000248,0.8325714010540334
9,91,1,101,0.09,0.9900990099009901,0.0901457652342882,0.9374426881827463
2,57,1,60,0.03389830508474576,0.9833333333333333,0.08169934370154423,0.962015913699368
1,29,9,39,0.03333333333333333,0.7692307692307693,0.07931839132059185,0.947682421105006
5,155,4,164,0.03125,0.975609756097561,0.07151273838457083,0.9467798561413183
16,108,16,140,0.12903225806451613,0.8857142857142857,0.07795790612006114,0.93711999219574
33,81,25,139,0.2894736842105263,0.8201438848920863,0.11304562541830676,0.9138893156532303
11,95,2,108,0.10377358490566038,0.9814814814814815,0.10153730937125494,0.9150875029500724
5,60,2,67,0.07692307692307693,0.9701492537313433,0.09966917750312308,0.9122375377829799
5,114,13,132,0.04201680672268908,0.9015151515151515,0.10082896345140069,0.9005492260946681
9,40,1,50,0.1836734693877551,0.98,0.12230612574488951,0.9306591162045583
15,84,1,100,0.15151515151515152,0.99,0.13948686167562546,0.9327148653334782
3,23,4,30,0.11538461538461539,0.8666666666666667,0.13753719843563963,0.929993776898104
7,76,13,96,0.08433734939759036,0.8645833333333334,0.10823200774807736,0.9363422695325679
15,40,1,56,0.2727272727272727,0.9821428571428571,0.13236824886545054,0.9364367517699073
0,4,59,63,0.0,0.06349206349206349,0.12137923787643955,0.8069142960214387
4,196,9,209,0.02,0.9569377990430622,0.11823397977319826,0.8148318170968546
18,204,12,234,0.08108108108108109,0.9487179487179487,0.10357792430081625,0.8103629526279901
32,106,12,150,0.2318840579710145,0.92,0.1150591966516538,0.80036295262799
3,54,7,64,0.05263157894736842,0.890625,0.10609447716061851,0.8037855716756093
31,191,6,228,0.13963963963963963,0.9736842105263158,0.11399480433805413,0.8193714112746066
1,13,52,66,0.07142857142857142,0.21212121212121213,0.08523784700966826,0.7093683191286574
4,8,2,14,0.3333333333333333,0.8571428571428571,0.13285689462871586,0.8227470039359136
20,62,5,87,0.24390243902439024,0.9425287356321839,0.16484295734648588,0.820688566305788
1,61,3,65,0.016129032258064516,0.9538461538461539,0.1555640932289121,0.821421167038389
29,82,33,144,0.26126126126126126,0.7708333333333334,0.15976083655609022,0.800111643228865
116,438,41,595,0.20938628158844766,0.9310924369747899,0.18215436550481584,0.8058927056538351
1,50,9,60,0.0196078431372549,0.85,0.16500696600447512,0.7882235327215042
17,68,20,105,0.2,0.8095238095238095,0.18337431294325063,0.8735667609218752
2,0,0,2,1.0,1.0,0.27861240818134586,0.8939749241871814
1,15,1,17,0.0625,0.9411764705882353,0.25269777403500443,0.8937817434666172
8,95,2,105,0.07766990291262135,0.9809523809523809,0.2614893269856554,0.8976540616246497
14,113,23,150,0.11023622047244094,0.8466666666666667,0.23991432115868108,0.908487394957983
12,47,4,63,0.2033898305084746,0.9365079365079365,0.23905768529011345,0.9092610377484326
3,26,2,31,0.10344827586206896,0.9354838709677419,0.25103488996508694,0.9214730193152529
1,22,1,24,0.043478260869565216,0.9583333333333334,0.23142666058163994,0.9407995086278677
29,74,14,117,0.2815533980582524,0.8803418803418803,0.12879143173281885,0.9237054915338504
16,92,2,110,0.14814814814814814,0.9818181818181818,0.14102688146826856,0.9295114502809857
28,94,3,125,0.22950819672131148,0.976,0.15845278361125162,0.9290903976494066
76,306,36,418,0.19895287958115182,0.9138755980861244,0.17377938545617808,0.9389197084423943
5,81,20,106,0.05813953488372093,0.8113207547169812,0.15298450419618054,0.9218177472935887
0,36,4,40,0.0,0.9,0.13711148832316467,0.9173842497566429
0,13,1,14,0.0,0.9285714285714286,0.13090030819894108,0.9131325490763709
1,14,1,16,0.06666666666666667,0.9375,0.10020220371442881,0.9212979947418164
6,204,59,269,0.02857142857142857,0.7806691449814126,0.08311981520346888,0.8925624180508495
30,115,24,169,0.20689655172413793,0.8579881656804734,0.07988958020387264,0.8757035845766313
2,24,0,26,0.07692307692307693,1.0,0.0624567512527191,0.8880070705643278
3,57,65,125,0.05,0.48,0.06129396055504468,0.8406755341761877
4,46,3,53,0.08,0.9433962264150944,0.07272253198361611,0.8468749950926296
13,169,25,207,0.07142857142857142,0.8792270531400966,0.08292661361626917,0.8398257986024394
14,149,3,166,0.08588957055214724,0.9819277108433735,0.0856727427427664,0.846172614437207
13,129,8,150,0.09154929577464789,0.9466666666666667,0.09466958091465487,0.8698865461065292
5,109,2,116,0.043859649122807015,0.9827586206896551,0.07137859482875046,0.8877108968221264
39,178,6,223,0.17972350230414746,0.9730941704035875,0.0860643698831891,0.8838672068797819
9,91,1,101,0.09,0.9900990099009901,0.0917786555974748,0.9567384940084948
1,58,1,60,0.01694915254237288,0.9833333333333333,0.08277139167495666,0.9624437949968145
1,29,9,39,0.03333333333333333,0.7692307692307693,0.07732921480420836,0.946730040152625
5,155,4,164,0.03125,0.975609756097561,0.06952356186818733,0.9458274751889375
15,109,16,140,0.12096774193548387,0.8857142857142857,0.07372619703402104,0.93711999219574
38,78,24,140,0.3275862068965517,0.8285714285714286,0.11425856243027029,0.915093250464565
11,95,2,108,0.10377358490566038,0.9814814814814815,0.10340857423048641,0.9162914377614069
5,61,1,67,0.07575757575757576,0.9850746268656716,0.10137394219585438,0.9155736687563615
5,115,12,132,0.041666666666666664,0.9090909090909091,0.10490501564218205,0.9049676081503008
10,39,1,50,0.20408163265306123,0.98,0.1292976298307146,0.9350774982601909
14,85,1,100,0.1414141414141414,0.99,0.14503536431844907,0.9371332473891109
3,23,4,30,0.11538461538461539,0.8666666666666667,0.1442377748111822,0.9344121589537366
7,81,8,96,0.07954545454545454,0.9166666666666666,0.10880338161816829,0.9469971929673421
16,39,1,56,0.2909090909090909,0.9821428571428571,0.13553702533294407,0.9470916752046815
0,4,59,63,0.0,0.06349206349206349,0.12471451451043326,0.8154370232941659
4,196,9,209,0.02,0.9569377990430622,0.12161927641519517,0.8222722932873309
19,202,13,234,0.08597285067873303,0.9444444444444444,0.10474659327600543,0.8171929282079657
34,114,2,150,0.22972972972972974,0.9866666666666667,0.11736310589251804,0.8167167377317751
3,60,2,65,0.047619047619047616,0.9692307692307692,0.10768231049743693,0.8313687523837899
32,190,6,228,0.14414414414414414,0.9736842105263158,0.11691069472582116,0.8395141157923112
6,58,2,66,0.09375,0.9696969696969697,0.08874511031023673,0.8377361318714701
4,8,2,14,0.3333333333333333,0.8571428571428571,0.13636415792928436,0.9511148166787263
19,63,5,87,0.23170731707317074,0.9425287356321839,0.16660806036830875,0.9490563790486009
1,61,3,65,0.016129032258064516,0.9538461538461539,0.15663037202249894,0.9503994803917022
30,85,29,144,0.2608695652173913,0.7986111111111112,0.16107891994930776,0.9235344010266228
110,451,34,595,0.19607843137254902,0.9428571428571428,0.1822874033426651,0.9197667401161047
1,50,9,60,0.0196078431372549,0.85,0.16449650319882375,0.902097567183774
17,68,20,105,0.2,0.8095238095238095,0.1796750746273952,0.8792156871590368
2,0,0,2,1.0,1.0,0.27491316986549047,0.8996238504243429
1,15,1,17,0.0625,0.9411764705882353,0.25074069599789467,0.8994306697037787
10,93,2,105,0.0970873786407767,0.9809523809523809,0.2623061740525678,0.9033029878618112
12,115,23,150,0.09448818897637795,0.8466666666666667,0.23853740601813733,0.9101680672268906
11,48,4,63,0.1864406779661017,0.9365079365079365,0.23716058410293056,0.9092610377484326
3,26,2,31,0.10344827586206896,0.9354838709677419,0.24913778877790402,0.9214730193152528
1,20,1,22,0.047619047619047616,0.9545454545454546,0.22866506062904354,0.9375464593705318
29,63,14,106,0.31521739130434784,0.8679245283018868,0.1308389736725218,0.9186785348422298
19,70,2,91,0.21348314606741572,0.978021978021978,0.1524079945392955,0.9239421787613359
28,70,3,101,0.2857142857142857,0.9702970297029703,0.179399436277281,0.9227064160873242
78,264,39,381,0.22807017543859648,0.8976377952755905,0.2007026944226444,0.9329279644807315
3,72,20,95,0.04,0.7894736842105263,0.177316451036401,0.9127049932595753
0,29,4,33,0.0,0.8787878787878788,0.16144343516338516,0.9052411926923263
0,13,1,14,0.0,0.9285714285714286,0.15464071407494978,0.9015306175531796
1,7,2,10,0.125,0.8,0.1274668010314715,0.8918271135100532
6,163,59,228,0.03550295857988166,0.7412280701754386,0.10204105996182379,0.8579994123891189
28,103,24,155,0.21374045801526717,0.8451612903225807,0.0917590845762497,0.8401228781919203
2,18,4,24,0.1,0.8333333333333334,0.07346334522787878,0.8309365264858837
2,23,96,121,0.08,0.2066115702479339,0.0791776309421645,0.7476705102055133
3,35,10,48,0.07894736842105263,0.7916666666666666,0.09045582643088632,0.7352246227596257
12,151,24,187,0.0736196319018405,0.8716577540106952,0.10097291670257781,0.7270940978223782
12,117,3,132,0.09302325581395349,0.9772727272727273,0.09640481039028545,0.7524187731470535
12,122,7,141,0.08955223880597014,0.950354609929078,0.10412613613686951,0.7822939931118592
5,96,2,103,0.04950495049504951,0.9805825242718447,0.08066392077683841,0.8016398836760398
39,178,6,223,0.17972350230414746,0.9730941704035875,0.09205299253457376,0.8216057175432189
5,73,1,79,0.0641025641025641,0.9873417721518988,0.08978193026351151,0.9331386035294996
2,49,1,52,0.0392156862745098,0.9807692307692307,0.08410597567114823,0.9601532555441518
1,27,8,36,0.03571428571428571,0.7777777777777778,0.07869092621578326,0.9467418303680206
5,150,4,159,0.03225806451612903,0.9748427672955975,0.07001018460180834,0.9463946932284306
16,99,16,131,0.1391304347826087,0.8778625954198473,0.07709278402704244,0.9360386911556834
33,65,25,123,0.336734693877551,0.7967479674796748,0.11812560451025693,0.9097766116139449
10,88,2,100,0.10204081632653061,0.98,0.10702807794202594,0.9107631586991465
5,59,1,65,0.078125,0.9846153846153847,0.10903128307023106,0.9103736747653588
5,102,12,119,0.04672897196261682,0.8991596638655462,0.11010460959710351,0.8987151652076896
9,37,1,47,0.1956521739130435,0.9787234042553191,0.1329528793397832,0.9274216832759097
15,82,0,97,0.15463917525773196,1.0,0.15043589516001218,0.9310155736622531
3,21,4,28,0.125,0.8571428571428571,0.1484172616196395,0.9280556110512544
6,59,13,78,0.09230769230769231,0.8333333333333334,0.11349911853823112,0.9332820918874913
17,33,1,51,0.34,0.9803921568627451,0.14749328763444103,0.933338114296455
0,1,59,60,0.0,0.016666666666666666,0.13633257334872675,0.7950597260180666
4,167,9,180,0.023391812865497075,0.95,0.13299869347770965,0.8023226311801315
18,165,14,197,0.09836065573770492,0.9289340101522843,0.11909990516694699,0.7952098605939837
32,91,13,136,0.2601626016260163,0.9044117647058824,0.13417468036241617,0.7815543984091098
4,52,7,63,0.07142857142857142,0.8888888888888888,0.1265216191379264,0.7860895458014
29,171,6,206,0.145,0.970873786407767,0.1340490916653989,0.8057381819548904
0,13,52,65,0.0,0.2,0.08547766309397033,0.6942535881173555
4,7,2,13,0.36363636363636365,0.8461538461538461,0.1374257150420223,0.8127517566155239
18,45,5,68,0.2857142857142857,0.9264705882352942,0.17490035402042065,0.8093904120777088
1,59,3,63,0.016666666666666666,0.9523809523809523,0.16322978415312947,0.8127399752532328
30,81,32,143,0.2702702702702703,0.7762237762237763,0.16467373681659433,0.7944274054700748
108,346,29,483,0.23788546255506607,0.9399585921325052,0.18845329269180788,0.80172307736202
1,43,9,53,0.022727272727272728,0.8301886792452831,0.17098576022427542,0.7816252049102366
17,57,20,94,0.22972972972972974,0.7872340425531915,0.2038042930428082,0.8655157824178354
2,0,0,2,1.0,1.0,0.2947133839518991,0.8874938043958575
1,15,1,17,0.0625,0.9411764705882353,0.26282562884985833,0.8895946447319919
10,83,2,95,0.10752688172043011,0.9789473684210527,0.27580565957182446,0.8933898470234347
11,109,22,142,0.09166666666666666,0.8450704225352113,0.250290859057024,0.9032250822107827
11,43,4,58,0.2037037037037037,0.9310344827586207,0.2454077506496865,0.9019502094430847
3,24,2,29,0.1111111111111111,0.9310344827586207,0.2580340132759491,0.916356752802133
1,20,1,22,0.047619047619047616,0.9545454545454546,0.22654846170138665,0.9410917211459362
29,63,14,106,0.31521739130434784,0.8679245283018868,0.12872237474486492,0.9222237966176344
16,73,2,91,0.1797752808988764,0.978021978021978,0.14547598630184727,0.9274874405367405
28,71,3,102,0.2828282828282828,0.9705882352941176,0.17339736373778783,0.9260068482998457
79,261,41,381,0.2323529411764706,0.8923884514435696,0.1929851988718414,0.9334909127917842
3,73,20,96,0.039473684210526314,0.7916666666666666,0.171530700557089,0.9129455978916307
0,29,4,33,0.0,0.8787878787878788,0.1567523754339363,0.9048461704373645
0,13,1,14,0.0,0.9285714285714286,0.14994965434550095,0.9011355952982179
1,7,2,10,0.125,0.8,0.12277574130202269,0.8914320912550913
5,164,59,228,0.029585798816568046,0.7412280701754386,0.10132010100455006,0.857604390134157
27,104,24,155,0.20610687022900764,0.8451612903225807,0.09035989920465361,0.839686255138223
2,18,4,24,0.1,0.8333333333333334,0.07145233617944353,0.8312498096939037
4,22,95,121,0.15384615384615385,0.21487603305785125,0.0877912604131046,0.7488511477497871
3,35,10,48,0.07894736842105263,0.7916666666666666,0.09906945590182639,0.7364052603038997
12,151,24,187,0.0736196319018405,0.8716577540106952,0.1095865461735179,0.7282747353666521
11,119,3,133,0.08461538461538462,0.9774436090225563,0.10381731540428714,0.7536238223698745
12,122,7,141,0.08955223880597014,0.950354609929078,0.11238394968848743,0.78349904233468
5,97,2,104,0.049019607843137254,0.9807692307692307,0.08994291220479166,0.8028716052556301
38,179,6,223,0.17511520737327188,0.9730941704035875,0.10067365611525907,0.8228374391228093
6,72,1,79,0.07692307692307693,0.9873417721518988,0.08968464512624807,0.9331896875648161
2,49,1,52,0.0392156862745098,0.9807692307692307,0.08400869053388482,0.9602043395794679
1,27,8,36,0.03571428571428571,0.7777777777777778,0.07859364107851986,0.9467929144033371
5,150,4,159,0.03225806451612903,0.9748427672955975,0.07111402392148335,0.9464213655852001
15,100,16,131,0.13043478260869565,0.8778625954198473,0.0769543873218727,0.9360653635124528
30,69,24,123,0.30303030303030304,0.8048780487804879,0.11324162949146781,0.9109380517997752
10,88,2,100,0.10204081632653061,0.98,0.10280243077050477,0.911924598884977
4,60,1,65,0.0625,0.9846153846153847,0.10074199121006522,0.9115351149511893
3,104,12,119,0.028037383177570093,0.8991596638655462,0.09914509076764526,0.8998766053935201
9,37,1,47,0.1956521739130435,0.9787234042553191,0.12199336051032494,0.9285831234617402
14,82,1,97,0.14583333333333334,0.9896907216494846,0.1382183989127827,0.9307042597980099
3,21,4,28,0.125,0.8571428571428571,0.13744200139725476,0.9277442971870112
7,57,14,78,0.109375,0.8205128205128205,0.10977695810721146,0.9299778360059159
16,34,1,51,0.32,0.9803921568627451,0.14091398434627853,0.9300338584148794
0,1,59,60,0.0,0.016666666666666666,0.1319854129177071,0.7917554701364911
5,166,9,180,0.029239766081871343,0.95,0.13215718190403583,0.799018375298556
19,164,14,197,0.10382513661202186,0.9289340101522843,0.1190390337181756,0.7919056047124081
31,92,13,136,0.25203252032520324,0.9044117647058824,0.1342103461455856,0.7797228965776078
4,51,8,63,0.07272727272727272,0.873015873015873,0.12674281367805312,0.781990470273753
32,169,6,207,0.15920398009950248,0.9710144927536232,0.13386123940655348,0.8034907091652962
0,15,50,65,0.0,0.23076923076923078,0.08814695369226776,0.6964017197233657
4,7,2,13,0.36363636363636365,0.8461538461538461,0.1400950056403197,0.8148998882215341
18,45,5,68,0.2857142857142857,0.9264705882352942,0.1767342227306646,0.811538543683719
1,59,3,63,0.016666666666666666,0.9523809523809523,0.16428301273847104,0.8148881068592431
30,81,32,143,0.2702702702702703,0.7762237762237763,0.16688840558776633,0.796575537076085
102,351,30,483,0.2251655629139073,0.937888198757764,0.18866530418585697,0.8058430121820693
1,43,9,53,0.022727272727272728,0.8301886792452831,0.16916863170410987,0.785725038823735
17,57,20,94,0.22972972972972974,0.7872340425531915,0.20198716452264268,0.8652200119357295
2,0,0,2,1.0,1.0,0.29289625543173353,0.8871980339137515
1,15,1,17,0.0625,0.9411764705882353,0.26100850032969275,0.889298874249886
9,84,2,95,0.0967741935483871,0.9789473684210527,0.2724524327413671,0.8930940765413288
9,105,24,138,0.07894736842105263,0.8260869565217391,0.2451205896200503,0.9002173880124664
11,43,4,58,0.2037037037037037,0.9310344827586207,0.24205460973287835,0.8992382857268745
3,24,2,29,0.1111111111111111,0.9310344827586207,0.254680872359141,0.9136448290859228
1,22,1,24,0.043478260869565216,0.9583333333333334,0.22570374503323637,0.9416328466870618
29,72,16,117,0.2871287128712871,0.8632478632478633,0.12386498972913451,0.9220968271510422
19,90,2,111,0.1743119266055046,0.9819819819819819,0.13983812210134944,0.9279261859215774
27,95,3,125,0.22131147540983606,0.976,0.16035834674380872,0.9272187029283802
78,301,40,419,0.20580474934036938,0.9045346062052506,0.17501979619606103,0.936437932386273
6,80,20,106,0.06976744186046512,0.8113207547169812,0.15789297754558557,0.9187003443504501
0,36,4,40,0.0,0.9,0.14311465242243288,0.9136312199264871
0,12,2,14,0.0,0.8571428571428571,0.1369034722982093,0.8991754376135619
1,13,2,16,0.07142857142857142,0.875,0.10608916637782131,0.9008543142924387
7,202,59,268,0.03349282296650718,0.7798507462686567,0.08597215157225027,0.8719784234762492
29,116,23,168,0.2,0.8630952380952381,0.08292765508513082,0.855849171775569
1,21,4,26,0.045454545454545456,0.8461538461538461,0.060020483101441695,0.8475090631967969
0,25,100,125,0.0,0.2,0.05005370569280382,0.7601775268086567
4,39,10,53,0.09302325581395349,0.8113207547169812,0.06334274223765432,0.747509063196797
11,171,25,207,0.06043956043956044,0.8792270531400966,0.07197696515759153,0.7506639483392596
12,151,3,166,0.0736196319018405,0.9819277108433735,0.07228997379662996,0.7659393356025987
12,131,7,150,0.08391608391608392,0.9533333333333334,0.07949329678942664,0.790722562326124
5,110,2,117,0.043478260869565216,0.9829059829059829,0.057133048342221666,0.8078383830133733
38,179,6,223,0.17511520737327188,0.9730941704035875,0.07565600004489688,0.8259727150490506
10,90,1,101,0.1,0.9900990099009901,0.08994171433061116,0.9388440021777634
2,53,5,60,0.03636363636363636,0.9166666666666666,0.08184748298056586,0.9538934181705756
1,29,9,39,0.03333333333333333,0.7692307692307693,0.07797516482253342,0.938179663326386
5,155,4,164,0.03125,0.975609756097561,0.07192236026512763,0.9372770983626985
14,110,16,140,0.11290322580645161,0.8857142857142857,0.07606338053518015,0.9276172344171203
31,85,24,140,0.2672413793103448,0.8285714285714286,0.10802954031243438,0.9055694409407554
11,95,2,108,0.10377358490566038,0.9814814814814815,0.09783787995991845,0.9067676282375975
4,61,2,67,0.06153846153846154,0.9701492537313433,0.09234337446541296,0.903917663070505
4,117,12,133,0.03305785123966942,0.9097744360902256,0.0918711194477034,0.902933058702442
9,40,1,50,0.1836734693877551,0.98,0.11334828174119223,0.9330429488123322
12,87,1,100,0.12121212121212122,0.99,0.12620001334292383,0.935098697941252
1,25,4,30,0.038461538461538464,0.8666666666666667,0.1155654865793648,0.9323776095058778
7,75,14,96,0.08536585365853659,0.8541666666666666,0.08958326862910648,0.9360340720909118
17,37,2,56,0.3148148148148148,0.9642857142857143,0.11973201575898569,0.9335775339200879
0,4,59,63,0.0,0.06349206349206349,0.11094080696777689,0.8040550781716195
5,195,9,209,0.025,0.9569377990430622,0.10978968536210984,0.8107927014505961
18,202,14,234,0.08181818181818182,0.9401709401709402,0.09523892999502793,0.8051028357607305
31,106,13,150,0.22627737226277372,0.9133333333333333,0.11024825157369257,0.7941504548083494
4,53,8,65,0.07017543859649122,0.8769230769230769,0.1147788087358287,0.7956156562735508
29,193,6,228,0.13063063063063063,0.9736842105263158,0.12124520544612784,0.8126895911106436
0,10,55,65,0.0,0.15384615384615385,0.07627166047258285,0.6969125110478493
4,9,1,14,0.3076923076923077,0.9285714285714286,0.12022770442862682,0.8204952774877585
19,63,5,87,0.23170731707317074,0.9425287356321839,0.1497573211533655,0.8184368398576332
0,62,3,65,0.0,0.9538461538461539,0.13806900946505382,0.820390441811235
31,81,32,144,0.2767857142857143,0.7777777777777778,0.1452844868969025,0.8010253624461557
104,447,44,595,0.18874773139745918,0.9260504201680673,0.16222338586846932,0.8080435543382972
1,50,9,60,0.0196078431372549,0.85,0.14636298765512992,0.7903743814059664
19,67,20,106,0.22093023255813954,0.8113207547169812,0.17792444944914987,0.884299324387513
2,0,0,2,1.0,1.0,0.27682554835024875,0.8945034060201661
1,15,1,17,0.0625,0.9411764705882353,0.25265307448265295,0.894310225299602
9,94,2,105,0.08737864077669903,0.9809523809523809,0.2651357374507528,0.8981825434576345
12,114,24,150,0.09523809523809523,0.84,0.23920036330109293,0.9070714323465233
11,47,4,62,0.1896551724137931,0.9354838709677419,0.23932999773199778,0.9084190681750484
3,26,2,31,0.10344827586206896,0.9354838709677419,0.25130720240697124,0.9206310497418686
1,22,1,24,0.043478260869565216,0.9583333333333334,0.22441406096180927,0.9425852276394426
30,72,15,117,0.29411764705882354,0.8717948717948718,0.1235737248273555,0.9242702093244244
17,92,2,111,0.1559633027522936,0.9819819819819819,0.13692562522054028,0.9300995680949597
28,93,3,124,0.23140495867768596,0.9758064516129032,0.16027473859613206,0.9293644353321772
81,297,41,419,0.21428571428571427,0.9021479713603818,0.17851353017575602,0.937290336002708
4,82,20,106,0.046511627906976744,0.8113207547169812,0.15560139820187585,0.9195527479668849
0,36,4,40,0.0,0.9,0.14082307307872316,0.9144836235429218
0,12,2,14,0.0,0.8571428571428571,0.13461189295449955,0.9000278412299966
1,13,2,16,0.07142857142857142,0.875,0.10279916786446353,0.900485716687872
7,202,59,268,0.03349282296650718,0.7798507462686567,0.0853033850379226,0.8716098258716827
30,115,23,168,0.20689655172413793,0.8630952380952381,0.0818021840445586,0.8555082239405877
1,21,4,26,0.045454545454545456,0.8461538461538461,0.05768344564010591,0.8475090631967969
1,26,98,125,0.037037037037037035,0.216,0.05632993265868596,0.7624632410943711
4,39,10,53,0.09302325581395349,0.8113207547169812,0.06961896920353645,0.7497947774825112
12,170,25,207,0.06593406593406594,0.8792270531400966,0.0790381214798316,0.7529496626249739
12,151,3,166,0.0736196319018405,0.9819277108433735,0.07935113011887003,0.7682250498883131
12,131,7,150,0.08391608391608392,0.9533333333333334,0.0865544531116667,0.7930082766118384
4,111,2,117,0.034782608695652174,0.9829059829059829,0.06196674696474017,0.8101240972990874
38,179,6,223,0.17511520737327188,0.9730941704035875,0.08048969866741537,0.8282584293347649
10,90,1,101,0.1,0.9900990099009901,0.08948440766212437,0.9388440021777634
3,52,5,60,0.05454545454545454,0.9166666666666666,0.08398757890948165,0.9538934181705756
1,29,9,39,0.03333333333333333,0.7692307692307693,0.07933033139509128,0.938179663326386
5,155,4,164,0.03125,0.975609756097561,0.0732775268376855,0.9372770983626986
14,110,16,140,0.11290322580645161,0.8857142857142857,0.07741854710773802,0.9276172344171202
32,84,24,140,0.27586206896551724,0.8285714285714286,0.11185847000343305,0.9055694409407555
10,96,2,108,0.09433962264150944,0.9814814814814815,0.10031910075603842,0.9067676282375974
5,60,2,67,0.07692307692307693,0.9701492537313433,0.0970223974593351,0.903917663070505
4,117,12,133,0.03305785123966942,0.9097744360902256,0.09395273984422294,0.902933058702442
10,39,1,50,0.20408163265306123,0.98,0.11834535403275549,0.9330429488123321
15,84,1,100,0.15151515151515152,0.99,0.13552608996349141,0.935098697941252
1,25,4,30,0.038461538461538464,0.8666666666666667,0.12489156319993243,0.9323776095058778
7,75,14,96,0.08536585365853659,0.8541666666666666,0.09767781815607803,0.9360340720909118
17,37,2,56,0.3148148148148148,0.9642857142857143,0.12917427418083594,0.933577533920088
0,4,59,63,0.0,0.06349206349206349,0.11818526319182496,0.8040550781716194
5,195,9,209,0.025,0.9569377990430622,0.1170341415861579,0.8107927014505961
20,201,13,234,0.09049773755656108,0.9444444444444444,0.10080787085808644,0.805713336371231
30,108,13,151,0.21739130434782608,0.9139072847682119,0.11021874983418282,0.7948429484809756
2,54,8,64,0.03571428571428571,0.875,0.10982628515600386,0.7960334246714519
31,191,6,228,0.13963963963963963,0.9736842105263158,0.11757968315330428,0.8131073595085445
0,10,55,65,0.0,0.15384615384615385,0.07260613817975929,0.6973302794457501
4,9,1,14,0.3076923076923077,0.9285714285714286,0.11656218213580326,0.8209130458856595
19,63,5,87,0.23170731707317074,0.9425287356321839,0.14609179886054194,0.8188546082555339
0,62,3,65,0.0,0.9538461538461539,0.1331635506381761,0.8201977095986354
30,82,32,144,0.26785714285714285,0.7777777777777778,0.14037295613950704,0.8007506371714304
108,446,41,595,0.19494584837545126,0.9310924369747899,0.16312032223395925,0.8087638424535433
1,50,9,60,0.0196078431372549,0.85,0.1459729227336186,0.7910946695212123
19,68,19,106,0.21839080459770116,0.8207547169811321,0.17717160910471877,0.886367321397638
2,0,0,2,1.0,1.0,0.2760727080058177,0.8965714030302909
1,15,1,17,0.0625,0.9411764705882353,0.2519002341382218,0.8963782223097269
8,95,2,105,0.07766990291262135,0.9809523809523809,0.2629959345543106,0.9002505404677592
13,113,24,150,0.10317460317460317,0.84,0.23946985745680496,0.9091394293566483
11,47,4,62,0.1896551724137931,0.9354838709677419,0.23871404660513948,0.909766777069927
3,26,2,31,0.10344827586206896,0.9354838709677419,0.25069125128011294,0.9219787586367473
1,22,1,24,0.043478260869565216,0.9583333333333334,0.2262690308507215,0.9369983874443076
31,73,13,117,0.2980769230769231,0.8888888888888888,0.12599430557599622,0.9211253715712917
19,90,2,111,0.1743119266055046,0.9819819819819819,0.14196743794821115,0.9269547303418271
29,92,3,124,0.2396694214876033,0.9758064516129032,0.16640200516352704,0.9262457618909231
79,304,35,418,0.206266318537859,0.916267942583732,0.18226317992063615,0.9371411822600277
7,79,20,106,0.08139534883720931,0.8113207547169812,0.1643344366510749,0.9194035942242047
0,36,4,40,0.0,0.9,0.14902831420209534,0.9189427647311171
0,12,2,14,0.0,0.8571428571428571,0.14281713407787172,0.9044869824181919
1,13,2,16,0.07142857142857142,0.875,0.1104387981281072,0.9025028554340649
8,202,58,268,0.0380952380952381,0.7835820895522388,0.09097927119806913,0.8741600136583872
28,116,24,168,0.19444444444444445,0.8571428571428571,0.0845185601919036,0.8572080715912379
2,20,4,26,0.09090909090909091,0.8461538461538461,0.06803895624493671,0.8471917721012542
1,25,99,125,0.038461538461538464,0.208,0.06190555476269801,0.7610030928559712
4,39,10,53,0.09302325581395349,0.8113207547169812,0.07519459130754853,0.7483346292441114
13,169,25,207,0.07142857142857142,0.8792270531400966,0.08539867294020158,0.7514895143865742
12,151,3,166,0.0736196319018405,0.9819277108433735,0.08571168157924003,0.7667649016499132
11,132,7,150,0.07692307692307693,0.9533333333333334,0.09125851569750269,0.7910150793329267
6,109,2,117,0.05217391304347826,0.9829059829059829,0.07093415406879325,0.8089812401562304
38,179,6,223,0.17511520737327188,0.9730941704035875,0.08296359927796194,0.8271155721919078
10,90,1,101,0.1,0.9900990099009901,0.09175480806917076,0.9388440021777634
3,52,5,60,0.05454545454545454,0.9166666666666666,0.08625797931652804,0.9538934181705756
1,29,9,39,0.03333333333333333,0.7692307692307693,0.08081580244577975,0.938179663326386
5,155,4,164,0.03125,0.975609756097561,0.07476299788837396,0.9372770983626986
15,109,16,140,0.12096774193548387,0.8857142857142857,0.08105509289014638,0.9276172344171202
34,81,25,140,0.2956521739130435,0.8214285714285714,0.11583770158579855,0.9045490327774902
11,95,2,108,0.10377358490566038,0.9814814814814815,0.10564604123328261,0.9057472200743321
5,61,1,67,0.07575757575757576,0.9850746268656716,0.10218283777007917,0.9050294510692866
5,116,12,133,0.04132231404958678,0.9097744360902256,0.10029381769924091,0.9040448467012235
11,38,1,50,0.22448979591836735,0.98,0.1276018837828172,0.9341547368111137
15,84,1,100,0.15151515151515152,0.99,0.14478261971355313,0.9362104859400334
2,24,4,30,0.07692307692307693,0.8666666666666667,0.13849052471178072,0.9334893975046594
7,77,12,96,0.08333333333333333,0.875,0.10815926177182211,0.9411424587291491
17,38,1,56,0.3090909090909091,0.9821428571428571,0.1374903080840005,0.9412369409664886
0,4,59,63,0.0,0.06349206349206349,0.12666779726148966,0.8095822890559731
5,195,9,209,0.025,0.9569377990430622,0.12433603811154871,0.8163199123349498
17,204,13,234,0.07692307692307693,0.9444444444444444,0.10325507825507865,0.8112405472555847
30,107,14,151,0.21897810218978103,0.9072847682119205,0.11289264263716858,0.7994240855715734
2,55,7,64,0.03508771929824561,0.890625,0.1069161629764784,0.8028467046191924
30,192,6,228,0.13513513513513514,0.9736842105263158,0.11431642037673581,0.8169444489800947
0,12,53,65,0.0,0.18461538461538463,0.07016057622089164,0.7030119529047415
4,9,1,14,0.3076923076923077,0.9285714285714286,0.1141166201769356,0.8265947193446507
19,63,5,87,0.23170731707317074,0.9425287356321839,0.14364623690167427,0.8245362817145253
0,62,3,65,0.0,0.9538461538461539,0.1326572259126633,0.8258793830576266
30,82,32,144,0.26785714285714285,0.7777777777777778,0.1396399460080007,0.8073783844241776
102,438,55,595,0.18888888888888888,0.907563025210084,0.16161154166380687,0.8097981023113325
1,50,9,60,0.0196078431372549,0.85,0.14510764280696684,0.7921289293790016
19,67,20,106,0.22093023255813954,0.8113207547169812,0.17666910460098675,0.8816582679649442
2,0,0,2,1.0,1.0,0.27557020350208566,0.8918623495975971
1,15,1,17,0.0625,0.9411764705882353,0.25139772963448986,0.891669168877033
7,96,2,105,0.06796116504854369,0.9809523809523809,0.26110646749856753,0.8955414870350654
11,116,23,150,0.08661417322834646,0.8466666666666667,0.23521461469445376,0.9053827568763353
12,46,4,62,0.20689655172413793,0.9354838709677419,0.23778713795663217,0.9093714491274293
3,26,2,31,0.10344827586206896,0.9354838709677419,0.2497643426316056,0.9215834306942495
1,22,1,24,0.043478260869565216,0.9583333333333334,0.22335856433853524,0.9398555303014504
30,73,14,117,0.2912621359223301,0.8803418803418803,0.12211029804172524,0.9227615132074334
19,90,2,111,0.1743119266055046,0.9819819819819819,0.1380834304139402,0.9285908719779686
29,92,3,124,0.2396694214876033,0.9758064516129032,0.16111743740516646,0.9278819035270647
78,301,39,418,0.20580474934036938,0.9066985645933014,0.17612165962544069,0.9345531270403935
7,79,20,106,0.08139534883720931,0.8113207547169812,0.15819291635587948,0.9168155390045705
0,36,4,40,0.0,0.9,0.14798883472322638,0.9163547095114829
0,12,2,14,0.0,0.8571428571428571,0.1417776545990028,0.9018989271985578
1,13,2,16,0.07142857142857142,0.875,0.110372859671323,0.9011358014354319
7,202,59,268,0.03349282296650718,0.7798507462686567,0.09025584486575192,0.8722599106192427
30,114,24,168,0.20833333333333334,0.8571428571428571,0.08577926084371336,0.8553079685520932
2,20,4,26,0.09090909090909091,0.8461538461538461,0.06936559535353072,0.8466587230607424
0,30,95,125,0.0,0.24,0.057737688376786535,0.765041472386888
4,39,10,53,0.09302325581395349,0.8113207547169812,0.07102672492163703,0.7523730087750282
10,170,27,207,0.05555555555555555,0.8695652173913043,0.07896323285814498,0.7541476316676635
11,152,3,166,0.06748466257668712,0.9819277108433735,0.07839981730787579,0.7694230189310026
12,131,7,150,0.08391608391608392,0.9533333333333334,0.08560314030067247,0.7942062456545278
5,110,2,117,0.043478260869565216,0.9829059829059829,0.0620524156629913,0.8121724064778315
38,179,6,223,0.17511520737327188,0.9730941704035875,0.07408186087216,0.8303067385135087
10,90,1,101,0.1,0.9900990099009901,0.0883675751578743,0.937463739927936
3,56,1,60,0.05084745762711865,0.9833333333333333,0.08234246113118361,0.9620369654445576
1,29,9,39,0.03333333333333333,0.7692307692307693,0.07916785795658043,0.9477034728501955
6,154,4,164,0.0375,0.975609756097561,0.0748843347313394,0.946800907886508
15,109,16,140,0.12096774193548387,0.8857142857142857,0.08017742873411084,0.9371410439409298
30,85,25,140,0.2608695652173913,0.8214285714285714,0.11123332935522885,0.9140728423012996
12,94,2,108,0.11320754716981132,0.9814814814814815,0.10238937789759162,0.9152710295981417
5,61,1,67,0.07575757575757576,0.9850746268656716,0.09892617443438816,0.9145532605930962
5,116,12,133,0.04132231404958678,0.9097744360902256,0.0975654396375979,0.9040448467012236
10,39,1,50,0.20408163265306123,0.98,0.12195805382613044,0.9341547368111137
15,84,2,101,0.15151515151515152,0.9801980198019802,0.13824593261400922,0.9348102030546022
2,24,4,30,0.07692307692307693,0.8666666666666667,0.1319538376122368,0.932089114619228
7,76,13,96,0.08433734939759036,0.8645833333333334,0.10673494963797954,0.9382540806056225
16,39,1,56,0.2909090909090909,0.9821428571428571,0.13212088445787662,0.9383485628429619
0,4,59,63,0.0,0.06349206349206349,0.12129837363536579,0.8066939109324466
5,195,9,209,0.025,0.9569377990430622,0.11896661448542482,0.8134315342114231
18,202,14,234,0.08181818181818182,0.9401709401709402,0.1015004072232992,0.8077416685215575
29,108,14,151,0.2116788321167883,0.9072847682119205,0.11009521873781873,0.7973254897229776
1,56,7,64,0.017543859649122806,0.890625,0.10161247341296815,0.8007481087705965
29,193,6,228,0.13063063063063063,0.9736842105263158,0.10822579930340248,0.816333948369594
0,13,52,65,0.0,0.2,0.06666735774496092,0.7045992544920431
4,9,1,14,0.3076923076923077,0.9285714285714286,0.11062340170100489,0.8281820209319523
19,63,5,87,0.23170731707317074,0.9425287356321839,0.14015301842574354,0.8261235833018269
1,61,3,65,0.016129032258064516,0.9538461538461539,0.13076885420286966,0.8280771852554288
29,84,31,144,0.25663716814159293,0.7847222222222222,0.1371914736349846,0.8105682501140433
106,453,36,595,0.18962432915921287,0.9394957983193277,0.16177439785071177,0.8175497927310902
1,50,9,60,0.0196078431372549,0.85,0.14591399963737237,0.7998806197987592
18,68,20,106,0.20930232558139536,0.8113207547169812,0.17581433186328596,0.8872121561868995
2,0,0,2,1.0,1.0,0.27471543076438487,0.8974162378195526
1,15,1,17,0.0625,0.9411764705882353,0.25054295689678907,0.8972230570989884
7,95,2,104,0.06862745098039216,0.9807692307692307,0.2580427309999787,0.9010692109451423
12,114,24,150,0.09523809523809523,0.84,0.23498572058519335,0.9089660363419677
12,46,4,62,0.20689655172413793,0.9354838709677419,0.2374531809516112,0.9083929038631696
3,25,3,31,0.10714285714285714,0.9032258064516129,0.2499581829524115,0.9159965904991144
1,22,1,24,0.043478260869565216,0.9583333333333334,0.23608257684344683,0.936864593133223
30,75,12,117,0.2857142857142857,0.8974358974358975,0.13404176051691621,0.9222125784812084
16,93,2,111,0.14678899082568808,0.9819819819819819,0.14608304492058594,0.9280419372517434
29,91,3,123,0.24166666666666667,0.975609756097561,0.16973728922700415,0.9275971303720637
75,312,31,418,0.1937984496124031,0.9258373205741627,0.18075611536210937,0.9382790576273393
9,77,20,106,0.10465116279069768,0.8113207547169812,0.1671348529036376,0.9210101097539782
0,36,4,40,0.0,0.9,0.14515683092561563,0.9215027205914167
0,13,1,14,0.0,0.9285714285714286,0.138945650801392,0.9172510199111444
1,14,1,16,0.06666666666666667,0.9375,0.10765313379458931,0.9229744631345876
5,206,57,268,0.023696682464454975,0.7873134328358209,0.09006851831441316,0.8951646703994219
29,115,24,168,0.2013888888888889,0.8571428571428571,0.08431455006044489,0.878240827691607
2,24,0,26,0.07692307692307693,1.0,0.067618068247684,0.8888354961810123
0,57,68,125,0.0,0.456,0.0526679021347272,0.8380753883643008
4,46,3,53,0.08,0.9433962264150944,0.06409647356329863,0.8442748492807428
12,172,23,207,0.06521739130434782,0.8888888888888888,0.07341324374963402,0.8386059150403801
11,152,3,166,0.06748466257668712,0.9819277108433735,0.07353010030820838,0.8449527308751478
12,130,8,150,0.08450704225352113,0.9466666666666667,0.08221729456378925,0.8677174785652684
5,110,2,117,0.043478260869565216,0.9829059829059829,0.05965863341817158,0.8856836393885722
38,179,6,223,0.17511520737327188,0.9730941704035875,0.07368608062534229,0.8818399494462276
10,90,1,101,0.1,0.9900990099009901,0.08797179491105658,0.9581398080035118
2,57,1,60,0.03389830508474576,0.9833333333333333,0.08138583849459169,0.9638451089918317
1,29,9,39,0.03333333333333333,0.7692307692307693,0.07683097307016104,0.9467510918978146
6,154,4,164,0.0375,0.975609756097561,0.07254744984492004,0.9458485269341271
15,110,15,140,0.12,0.8928571428571429,0.07761787238013129,0.9381614521041952
34,81,25,140,0.2956521739130435,0.8214285714285714,0.1136427171006282,0.915093250464565
13,93,2,108,0.12264150943396226,0.9814814814814815,0.10614647453786967,0.9162914377614069
5,61,1,67,0.07575757575757576,0.9850746268656716,0.10268327107466621,0.9155736687563615
4,117,12,133,0.03305785123966942,0.9097744360902256,0.1025632062396553,0.9050652548644889
11,38,1,50,0.22448979591836735,0.98,0.1298712723232316,0.935175144974379
14,85,2,101,0.1414141414141414,0.9801980198019802,0.14471614966810892,0.9358306112178675
4,22,4,30,0.15384615384615385,0.8666666666666667,0.14955131450327377,0.932089114619228
7,82,7,96,0.07865168539325842,0.9270833333333334,0.11855124471473304,0.947182652034194
17,38,1,56,0.3090909090909091,0.9821428571428571,0.145186873237154,0.9472771342715334
0,4,59,63,0.0,0.06349206349206349,0.1343643624146432,0.8156224823610179
5,195,9,209,0.025,0.9569377990430622,0.13321324080897615,0.8223601056399946
17,205,12,234,0.07657657657657657,0.9487179487179487,0.11208278090300604,0.81789124117113
31,110,10,151,0.2198581560283688,0.9337748344370861,0.12328906870503852,0.8112593575475737
2,60,2,64,0.03225806451612903,0.96875,0.1059193416578921,0.8258426908809071
28,194,6,228,0.12612612612612611,0.9736842105263158,0.11270140461973036,0.8324999590513331
4,60,1,65,0.0625,0.9846153846153847,0.07747413189245764,0.8328531772616943
4,9,1,14,0.3076923076923077,0.9285714285714286,0.12143017584850159,0.9564359437016037
18,64,5,87,0.21951219512195122,0.9425287356321839,0.14921763229449464,0.9543775060714781
1,61,3,65,0.016129032258064516,0.9538461538461539,0.14058226882042146,0.9551101068040789
29,86,29,144,0.25217391304347825,0.7986111111111112,0.14519880553686568,0.9358010034717967
118,443,34,595,0.2103386809269162,0.9428571428571428,0.17063889359554957,0.93210202387996
1,50,9,60,0.0196078431372549,0.85,0.15542199602571083,0.9144328509476293
18,68,20,106,0.20930232558139536,0.8113207547169812,0.176393756823053,0.8896764752478573
2,0,0,2,1.0,1.0,0.2752948557241519,0.8998805568805103
1,15,1,17,0.0625,0.9411764705882353,0.25286454213530174,0.8996873761599462
8,94,2,104,0.0784313725490196,0.9807692307692307,0.261764876462581,0.9035335300061
13,116,21,150,0.10077519379844961,0.86,0.2401364879990055,0.9123033712759413
12,46,4,62,0.20689655172413793,0.9354838709677419,0.23964475525575146,0.9112500467203126
2,26,3,31,0.07142857142857142,0.9032258064516129,0.24704771644022525,0.9188537333562572
1,20,1,22,0.047619047619047616,0.9545454545454546,0.23801465402214436,0.9344612303387904
29,63,15,107,0.31521739130434784,0.8598130841121495,0.14018856706562263,0.9144345280690972
16,73,2,91,0.1797752808988764,0.978021978021978,0.15694217862260498,0.9196981719882035
29,70,3,102,0.29292929292929293,0.9705882352941176,0.18791965525225554,0.9185360049937461
74,266,41,381,0.21764705882352942,0.8923884514435696,0.20100488934589295,0.9263017596265298
6,69,20,95,0.08,0.7894736842105263,0.18386203220303582,0.905911801680818
0,29,4,33,0.0,0.8787878787878788,0.16188401022501386,0.9033741094879533
0,12,2,14,0.0,0.8571428571428571,0.15508128913657848,0.8894594527161538
0,8,2,10,0.0,0.8,0.11005023323595735,0.8809147264144181
5,166,58,229,0.029239766081871343,0.7467248908296943,0.08854515969067091,0.847872285386949
27,103,24,154,0.2076923076923077,0.8441558441558441,0.07636844751395874,0.8298105152243386
2,18,4,24,0.1,0.8333333333333334,0.059561724824883124,0.8213740697800189
1,29,91,121,0.03333333333333333,0.24793388429752067,0.05289505815821645,0.7440112412210184
3,35,10,48,0.07894736842105263,0.7916666666666666,0.06417325364693825,0.7315653537751308
9,157,22,188,0.05421686746987952,0.8829787234042553,0.0719185204283496,0.7352561918124733
10,119,3,132,0.07751937984496124,0.9772727272727273,0.08299271754905836,0.7605808671371487
12,122,7,141,0.08955223880597014,0.950354609929078,0.09160878508107248,0.7896708270084892
5,95,2,102,0.05,0.9803921568627451,0.06908131255359995,0.8091331573951893
41,176,6,223,0.1889400921658986,0.9730941704035875,0.08178704000587118,0.8290989912623685
6,72,1,79,0.07692307692307693,0.9873417721518988,0.08801414623297742,0.9347286895272796
2,49,1,52,0.0392156862745098,0.9807692307692307,0.08233819164061415,0.9617433415419318
1,27,8,36,0.03571428571428571,0.7777777777777778,0.07969496567552932,0.9467146350238635
6,149,4,159,0.03870967741935484,0.9748427672955975,0.07415072247187125,0.9463674978842735
15,101,16,132,0.12931034482758622,0.8787878787878788,0.07983045190353069,0.9361436791498166
29,70,25,124,0.29292929292929293,0.7983870967741935,0.11453463660771539,0.9101429562800234
10,88,2,100,0.10204081632653061,0.98,0.10212045434494854,0.9111295033652251
4,60,1,65,0.0625,0.9846153846153847,0.10006001478450899,0.9107400194314375
4,103,12,119,0.037383177570093455,0.8991596638655462,0.09979822782673521,0.8990815098737682
9,37,1,47,0.1956521739130435,0.9787234042553191,0.1226464975694149,0.9277880279419884
14,82,2,98,0.14583333333333334,0.9795918367346939,0.13794987698569755,0.9284664664332879
2,22,4,28,0.08333333333333333,0.8571428571428571,0.13138173248651858,0.925374320483999
6,60,12,78,0.09090909090909091,0.8461538461538461,0.1025217036264897,0.9321981418239496
16,34,1,51,0.32,0.9803921568627451,0.13365872986555677,0.9322541642329131
0,1,59,60,0.0,0.016666666666666666,0.12473015843698533,0.7939757759545248
5,162,13,180,0.029940119760479042,0.9277777777777778,0.12366686446418328,0.7980640779419864
16,168,14,198,0.08695652173913043,0.9292929292929293,0.10813891415362427,0.7910025815187879
32,92,12,136,0.25806451612903225,0.9117647058823529,0.12417194026729554,0.7813129913970248
3,52,7,62,0.05454545454545454,0.8870967741935484,0.12005938615474142,0.7855921224042666
29,173,6,208,0.14356435643564355,0.9711538461538461,0.12758156694424896,0.8034492652614093
0,14,51,65,0.0,0.2153846153846154,0.08186728122996323,0.6941624736216765
4,8,1,13,0.3333333333333333,0.9230769230769231,0.12948632884901085,0.8236496531088561
18,45,5,68,0.2857142857142857,0.9264705882352942,0.16602549541384035,0.8234629117456441
0,60,3,63,0.0,0.9523809523809523,0.15360313516539317,0.8267612007582187
28,82,32,142,0.2545454545454545,0.7746478873239436,0.15310041208202493,0.8071730838213033
99,355,29,483,0.21806167400881057,0.9399585921325052,0.17645987200536148,0.814724772098297
1,43,9,53,0.022727272727272728,0.8301886792452831,0.15919743147559423,0.7945868911113595
16,58,20,94,0.21621621621621623,0.7872340425531915,0.19008546236362514,0.876279666421156
2,0,0,2,1.0,1.0,0.2853235576017204,0.8872686774101669
1,15,1,17,0.0625,0.9411764705882353,0.25343580249967956,0.8893695177463015
7,85,2,94,0.07608695652173914,0.9787234042553191,0.26430536771707086,0.8931327251569253
14,106,21,141,0.11666666666666667,0.851063829787234,0.24460839802010118,0.9040492883659667
11,44,4,59,0.2,0.9322033898305084,0.2420281588759854,0.9029414023228244
4,22,3,29,0.15384615384615385,0.896551724137931,0.2607594276072541,0.9124218373074883
1,20,1,22,0.047619047619047616,0.9545454545454546,0.22702005470389844,0.9375821022446124
30,63,14,107,0.3225806451612903,0.8691588785046729,0.13024586115551134,0.9188905134595655
16,73,2,91,0.1797752808988764,0.978021978021978,0.1469994727124937,0.9241541573786716
27,74,3,104,0.26732673267326734,0.9711538461538461,0.17686723063946533,0.9227543666931667
72,268,41,381,0.21176470588235294,0.8923884514435696,0.19137129998373845,0.9292860502327241
6,70,20,96,0.07894736842105263,0.7916666666666666,0.173593805399821,0.9085944402554
0,29,4,33,0.0,0.8787878787878788,0.15828768295084145,0.9051033077320094
0,12,2,14,0.0,0.8571428571428571,0.15148496186240606,0.8911886509602097
1,8,2,11,0.1111111111111111,0.8181818181818182,0.12127502842666618,0.8839062137712305
4,165,59,228,0.023668639053254437,0.7412280701754386,0.09897407959157732,0.8500785126502963
27,102,24,153,0.20930232558139536,0.8431372549019608,0.09068487857845275,0.8317904281857412
1,19,4,24,0.05,0.8333333333333334,0.06757563488097376,0.8233539827414218
1,22,98,121,0.043478260869565216,0.19008264462809918,0.06250861951647556,0.7374134081644835
3,35,10,48,0.07894736842105263,0.7916666666666666,0.07378681500519736,0.724967520718596
10,157,22,189,0.059880239520958084,0.8835978835978836,0.0823411349367628,0.7287468102121714
8,122,3,133,0.06153846153846154,0.9774436090225563,0.07525932785495572,0.751498494617991
10,124,7,141,0.07462686567164178,0.950354609929078,0.08253907451472534,0.7813737145827968
3,97,2,102,0.03,0.9803921568627451,0.056924456574526,0.8009815577200516
39,178,6,223,0.17972350230414746,0.9730941704035875,0.07545638547511849,0.8209473915872307
6,72,1,79,0.07692307692307693,0.9873417721518988,0.08023421633990589,0.9348415526620594
4,43,5,52,0.0851063829787234,0.9038461538461539,0.08111407556243029,0.9508671936877003
1,27,8,36,0.03571428571428571,0.7777777777777778,0.07766179644719137,0.9357500357133995
5,150,4,159,0.03225806451612903,0.9748427672955975,0.07347888258685817,0.9353784868952626
15,101,15,131,0.12931034482758622,0.8854961832061069,0.08129080818056451,0.9261129973634095
29,71,24,124,0.29,0.8064516129032258,0.11843366532342163,0.9012643482263353
9,89,2,100,0.09183673469387756,0.98,0.10587841280766881,0.9022508953115371
5,58,2,65,0.07936507936507936,0.9692307692307692,0.10622727029938342,0.8996636091799471
3,104,12,119,0.028037383177570093,0.8991596638655462,0.09807455604207582,0.898994110611289
9,37,1,47,0.1956521739130435,0.9787234042553191,0.12092282578475551,0.9277006286795091
12,87,2,101,0.12121212121212122,0.9801980198019802,0.13363054816989722,0.9284656647518494
2,22,4,28,0.08333333333333333,0.8571428571428571,0.12706240367071825,0.9244151895999567
6,59,13,78,0.09230769230769231,0.8333333333333334,0.09882064542896,0.9282554353756863
16,33,2,51,0.32653061224489793,0.9607843137254902,0.13234834222196293,0.9255103373364707
0,1,59,60,0.0,0.016666666666666666,0.12101047374123731,0.7894297512558845
5,163,13,181,0.02976190476190476,0.9281767955801105,0.12125683396757082,0.7935750557865366
18,169,11,198,0.0962566844919786,0.9444444444444444,0.10705747833599014,0.7886780615278403
32,91,12,135,0.2601626016260163,0.9111111111111111,0.12690754696654657,0.7788085031434304
3,52,7,62,0.05454545454545454,0.8870967741935484,0.12279499285399245,0.7830876341506718
29,173,6,208,0.14356435643564355,0.9711538461538461,0.13011737344369978,0.8027762788393167
0,11,54,65,0.0,0.16923076923076924,0.08347014312300008,0.6896972010543564
4,8,1,13,0.3333333333333333,0.9230769230769231,0.1310891907420477,0.819184380541536
18,45,5,68,0.2857142857142857,0.9264705882352942,0.16765381659238782,0.8189406366351336
0,60,3,63,0.0,0.9523809523809523,0.15390286166496228,0.8200744234832064
29,82,32,143,0.26126126126126126,0.7762237762237763,0.15405981304142588,0.8008048042135869
95,357,31,483,0.21017699115044247,0.9358178053830227,0.17629288969928128,0.8077649515263691
1,43,9,53,0.022727272727272728,0.8301886792452831,0.15903044916951403,0.7876270705394315
18,57,20,95,0.24,0.7894736842105263,0.1933161634552283,0.8762332012508253
2,0,0,2,1.0,1.0,0.2885542586933236,0.8872222122398364
1,15,1,17,0.0625,0.9411764705882353,0.25666650359128274,0.8893230525759707
7,85,2,94,0.07608695652173914,0.9787234042553191,0.26753606880867403,0.8930862599865945
15,104,23,142,0.12605042016806722,0.8380281690140845,0.24822023436678917,0.9019154589566386
11,44,4,59,0.2,0.9322033898305084,0.24676637848815458,0.901399113877708
4,22,3,29,0.15384615384615385,0.896551724137931,0.26549764721942326,0.910879548862372
1,22,1,24,0.043478260869565216,0.9583333333333334,0.2354293390526113,0.9381232277857378
29,73,15,117,0.28431372549019607,0.8717948717948718,0.13318844269406788,0.9198082094707196
22,86,2,110,0.2037037037037037,0.9818181818181818,0.15336040036602555,0.9256141682178548
27,94,3,124,0.2231404958677686,0.9758064516129032,0.17414191364533232,0.9248790354550722
75,299,41,415,0.20053475935828877,0.9012048192771084,0.1859168455221632,0.9326702001137067
5,81,20,106,0.05813953488372093,0.8113207547169812,0.16516680329005556,0.9147863170007131
0,36,4,40,0.0,0.9,0.14475864002474942,0.9143254875076254
0,12,2,14,0.0,0.8571428571428571,0.1385474599005258,0.8998697051947004
1,13,2,16,0.07142857142857142,0.875,0.10813529503457943,0.9003275806525758
6,204,59,269,0.02857142857142857,0.7806691449814126,0.08311639858711155,0.8715920039616087
28,116,23,167,0.19444444444444445,0.8622754491017964,0.07901696266949383,0.855373289317165
1,21,4,26,0.045454545454545456,0.8461538461538461,0.05686264639753049,0.8475088645852704
0,29,97,126,0.0,0.23015873015873015,0.04855699855699893,0.7644857182198059
3,40,10,53,0.06976744186046512,0.8113207547169812,0.05852377596563681,0.751817254607946
10,172,25,207,0.054945054945054944,0.8792270531400966,0.06637306952921608,0.7549721397504089
9,155,3,167,0.054878048780487805,0.9820359281437125,0.06400870915091843,0.7702629866280821
12,131,7,150,0.08391608391608392,0.9533333333333334,0.07191508848586918,0.7949292992497851
3,112,2,117,0.02608695652173913,0.9829059829059829,0.047864018782625584,0.8121622326503831
40,177,6,223,0.18433179723502305,0.9730941704035875,0.06770362617983666,0.8302965646860605
11,88,1,100,0.1111111111111111,0.99,0.08357664205285253,0.9388453175205276
2,57,1,60,0.03389830508474576,0.9833333333333333,0.0784524796563212,0.9634185430371494
1,29,9,39,0.03333333333333333,0.7692307692307693,0.07536509085464668,0.9477047881929597
5,155,4,164,0.03125,0.975609756097561,0.07198965531457699,0.946786763614938
14,101,25,140,0.12173913043478261,0.8214285714285714,0.07739294767439109,0.9279432261999722
30,85,25,140,0.2608695652173913,0.8214285714285714,0.11093332034519855,0.9048750245603419
10,96,2,108,0.09433962264150944,0.9814814814814815,0.09807729540326804,0.9060732118571837
4,61,2,67,0.06153846153846154,0.9701492537313433,0.09099548832146095,0.9032373909616614
4,117,12,133,0.03305785123966942,0.9097744360902256,0.09087542348645004,0.8927289770697889
9,40,1,50,0.1836734693877551,0.98,0.11235258577993888,0.922838867179679
12,88,2,102,0.12,0.9803921568627451,0.1250311572085103,0.9235220672889911
2,24,4,30,0.07692307692307693,0.8666666666666667,0.1186288638496952,0.9299846523230048
8,76,12,96,0.09523809523809523,0.875,0.09496722528122434,0.9376377135474945
15,39,2,56,0.2777777777777778,0.9642857142857143,0.12117267601497696,0.9351811753766707
0,4,59,63,0.0,0.06349206349206349,0.11238146722376817,0.805658719628202
5,191,13,209,0.025510204081632654,0.937799043062201,0.1113032319154772,0.8096622349099128
18,202,14,234,0.08181818181818182,0.9401709401709402,0.09675247654839529,0.8039723692200472
32,106,12,150,0.2318840579710145,0.92,0.11273591340139735,0.795344918239655
6,50,7,63,0.10714285714285714,0.8888888888888888,0.11705302486136597,0.7985195214142581
28,194,6,228,0.12612612612612611,0.9736842105263158,0.12146560070251324,0.8126172657751604
0,9,56,65,0.0,0.13846153846153847,0.08178306101997355,0.694642383514564
4,10,1,15,0.2857142857142857,0.9333333333333333,0.12259938755058579,0.8189054220633166
19,63,5,87,0.23170731707317074,0.9425287356321839,0.1520561179779484,0.8195810924304571
0,61,4,65,0.0,0.9384615384615385,0.1403678062896367,0.8193368921862569
28,83,33,144,0.25225225225225223,0.7708333333333334,0.1432775483298135,0.7980273683767329
112,441,42,595,0.20253164556962025,0.9294117647058824,0.1569045181050654,0.8038163506363035
1,50,9,60,0.0196078431372549,0.85,0.14168762053522663,0.7861471777039727
18,68,20,106,0.20930232558139536,0.8113207547169812,0.17158795276114028,0.8822699228833216
2,0,0,2,1.0,1.0,0.27362876908767086,0.8917937324071312
1,15,1,17,0.0625,0.9411764705882353,0.2494562952200751,0.8916005516865672
6,97,2,105,0.05825242718446602,0.9809523809523809,0.25777807053214163,0.8976706720424018
14,113,23,150,0.11023622047244094,0.8466666666666667,0.23749006599216857,0.9085040053757352
12,47,4,63,0.2033898305084746,0.9365079365079365,0.23761266384057636,0.9095177442046
3,25,3,31,0.10714285714285714,0.9032258064516129,0.2501176658413767,0.9171214308405446
1,22,1,24,0.043478260869565216,0.9583333333333334,0.230291190171799,0.9436839036689942
29,73,15,117,0.28431372549019607,0.8717948717948718,0.12805029381325556,0.925368885353976
21,87,2,110,0.19444444444444445,0.9818181818181818,0.14689950016246192,0.9311748441011113
28,94,3,125,0.22950819672131148,0.976,0.1644297973362415,0.9304673611079141
75,299,41,415,0.20053475935828877,0.9012048192771084,0.17745262010171134,0.9373061448141675
5,81,20,106,0.05813953488372093,0.8113207547169812,0.15912388537565694,0.9194222617011739
0,36,4,40,0.0,0.9,0.1443455602525042,0.9143531372772108
0,12,2,14,0.0,0.8571428571428571,0.13813438012828064,0.8998973549642857
1,13,2,16,0.07142857142857142,0.875,0.10772221526233425,0.900355230422161
7,203,59,269,0.03333333333333333,0.7806691449814126,0.08470634224646123,0.8716196537311941
27,116,24,167,0.1888111888111888,0.8562874251497006,0.07889248397358657,0.8545178573240084
2,20,4,26,0.09090909090909091,0.8461538461538461,0.06323167419512972,0.8466534325921139
2,27,97,126,0.06896551724137931,0.23015873015873015,0.06477824310336663,0.7636302862266494
4,39,10,53,0.09302325581395349,0.8113207547169812,0.07806727964821714,0.7509618226147896
11,171,25,207,0.06043956043956044,0.8792270531400966,0.08670150256815433,0.7541167077572524
11,153,3,167,0.06707317073170732,0.9820359281437125,0.08607930246860232,0.7694075546349255
12,131,7,150,0.08391608391608392,0.9533333333333334,0.09330540969470956,0.7940738672566285
3,112,2,117,0.02608695652173913,0.9829059829059829,0.07005909079621674,0.8121622326503832
40,177,6,223,0.18433179723502305,0.9730941704035875,0.08340519169992133,0.8302965646860604
11,88,1,100,0.1111111111111111,0.99,0.08942599082416873,0.9388453175205276
3,52,5,60,0.05454545454545454,0.9166666666666666,0.08392916207152604,0.9538947335133398
1,29,9,39,0.03333333333333333,0.7692307692307693,0.08005684391349359,0.9381809786691502
4,156,4,164,0.025,0.975609756097561,0.0740463909518211,0.9372629540911286
16,110,14,140,0.12698412698412698,0.9,0.08019896853297012,0.9296439064720808
31,85,24,140,0.2672413793103448,0.8285714285714286,0.11464960035991378,0.907596112995716
10,96,2,108,0.09433962264150944,0.9814814814814815,0.10179357541798327,0.908794300292558
5,60,2,67,0.07692307692307693,0.9701492537313433,0.09690957053397839,0.9059584793970357
4,117,12,133,0.03305785123966942,0.9097744360902256,0.09383991291886622,0.9049738750289728
8,41,1,50,0.16326530612244897,0.98,0.11240162331731132,0.9350837651388627
15,85,2,102,0.15,0.9803921568627451,0.13025876617445417,0.9357669652481747
3,23,4,30,0.11538461538461539,0.8666666666666667,0.12860169308880967,0.93100506048627
8,75,13,96,0.0963855421686747,0.8645833333333334,0.10419371635428534,0.9361496183093992
17,37,2,56,0.3148148148148148,0.9642857142857143,0.13569017237904327,0.9336930801385754
0,4,59,63,0.0,0.06349206349206349,0.12470116139003229,0.8041706243901068
5,191,13,209,0.025510204081632654,0.937799043062201,0.12362292608174132,0.8081741396718175
18,203,13,234,0.08144796380090498,0.9444444444444444,0.11193473432152076,0.8030947745924525
30,107,13,150,0.21897810218978103,0.9133333333333333,0.12178874892006089,0.7935149426596794
7,50,7,64,0.12280701754385964,0.890625,0.12284909208566722,0.7969375617072983
30,192,6,228,0.13513513513513514,0.9736842105263158,0.128384748223733,0.812523401306296
0,10,55,65,0.0,0.15384615384615385,0.08341120325018801,0.6967463212435016
4,9,2,15,0.3076923076923077,0.8666666666666667,0.12736724720623196,0.8114855502684449
19,63,5,87,0.23170731707317074,0.9425287356321839,0.15682397763359454,0.8121612206355853
0,61,4,65,0.0,0.9384615384615385,0.14518855423346527,0.8113065197808844
29,83,32,144,0.25892857142857145,0.7777777777777778,0.15089576412472105,0.791941440415805
108,441,46,595,0.19672131147540983,0.9226890756302522,0.16145494897208534,0.7965220226486983
1,50,9,60,0.0196078431372549,0.85,0.14495105011524534,0.7788528497163674
18,68,20,106,0.20930232558139536,0.8113207547169812,0.17485138234115896,0.8727777926979142
2,0,0,2,1.0,1.0,0.2737524812422579,0.8918254117455332
1,15,1,17,0.0625,0.9411764705882353,0.24958000737466204,0.8916322310249691
8,95,2,105,0.07766990291262135,0.9809523809523809,0.2606757077907508,0.8977023513808037
15,112,23,150,0.11811023622047244,0.8466666666666667,0.24055880276102237,0.9075436212220735
12,47,4,63,0.2033898305084746,0.9365079365079365,0.24151144833717447,0.9095177442046
4,24,3,31,0.14285714285714285,0.9032258064516129,0.2591184911543013,0.9171214308405446
1,22,1,24,0.043478260869565216,0.9583333333333334,0.22792393836259592,0.9400279896904998
31,69,17,117,0.31,0.8547008547008547,0.12935250979116736,0.919270968933479
20,88,2,110,0.18518518518518517,0.9818181818181818,0.14687896481762236,0.9250769276806141
27,95,3,125,0.22131147540983606,0.976,0.16601222690807055,0.9243694446874169
73,301,41,415,0.19518716577540107,0.9012048192771084,0.17839223176413557,0.9302558474412894
6,80,20,106,0.06976744186046512,0.8113207547169812,0.1617246266061875,0.9123719643282959
0,36,4,40,0.0,0.9,0.14641850415720792,0.9119111348352084
0,12,2,14,0.0,0.8571428571428571,0.14020732403298428,0.8974553525222831
1,13,2,16,0.07142857142857142,0.875,0.10612569137992307,0.900355230422161
6,205,58,269,0.02843601895734597,0.7843866171003717,0.08373295334737461,0.8721507211767596
28,115,24,167,0.1958041958041958,0.8562874251497006,0.0800890562608546,0.8550489247695741
2,20,4,26,0.09090909090909091,0.8461538461538461,0.06519218842281027,0.8471845000376794
2,27,97,126,0.06896551724137931,0.23015873015873015,0.06507762776294088,0.7641613536722149
4,39,10,53,0.09302325581395349,0.8113207547169812,0.07836666430779138,0.751492890060355
9,173,25,207,0.04945054945054945,0.8792270531400966,0.08543102851501272,0.7546477752028179
12,152,3,167,0.07317073170731707,0.9820359281437125,0.08567990855483353,0.7699386220804911
11,132,7,150,0.07692307692307693,0.9533333333333334,0.09260663112136651,0.7940738672566285
4,111,2,117,0.034782608695652174,0.9829059829059829,0.06960354724871744,0.8121622326503831
40,177,6,223,0.18433179723502305,0.9730941704035875,0.08294964815242202,0.8302965646860605
11,88,1,100,0.1111111111111111,0.99,0.0889704472766694,0.9388453175205276
3,52,5,60,0.05454545454545454,0.9166666666666666,0.08347361852402671,0.9538947335133399
1,29,9,39,0.03333333333333333,0.7692307692307693,0.08117115907871011,0.9381809786691502
5,155,4,164,0.03125,0.975609756097561,0.07518248312052198,0.9372629540911285
15,111,14,140,0.11904761904761904,0.9,0.08120027485259941,0.929643906472081
31,84,25,140,0.26956521739130435,0.8214285714285714,0.11474064752340686,0.9065757048324506
12,94,2,108,0.11320754716981132,0.9814814814814815,0.10458004037123377,0.9077738921292927
5,61,1,67,0.07575757575757576,0.9850746268656716,0.09952953532072872,0.9070702673958173
3,118,12,133,0.024793388429752067,0.9097744360902256,0.09527924016134266,0.9060856630277543
11,38,1,50,0.22448979591836735,0.98,0.12258730624491895,0.9361955531376444
15,85,2,102,0.15,0.9803921568627451,0.13955159195920466,0.9368787532469564
3,23,4,30,0.11538461538461539,0.8666666666666667,0.1390283057216327,0.9321168484850515
8,77,11,96,0.09411764705882353,0.8854166666666666,0.11396436710270687,0.9412580049476366
16,39,1,56,0.2909090909090909,0.9821428571428571,0.13935030192260395,0.9413524871849759
0,4,59,63,0.0,0.06349206349206349,0.12852779110009313,0.8096978352744605
6,190,13,209,0.030612244897959183,0.937799043062201,0.129359056309837,0.8137013505561713
17,203,14,234,0.07727272727272727,0.9401709401709402,0.108328046503317,0.8080114848663056
33,107,11,151,0.2357142857142857,0.9271523178807947,0.12057294446250066,0.8004057935831698
7,50,7,64,0.12280701754385964,0.890625,0.12163328762810699,0.803828412630789
28,194,6,228,0.12612612612612611,0.9736842105263158,0.1262059274948645,0.8164380617535959
0,11,54,65,0.0,0.16923076923076924,0.08464748593642293,0.7003077634804405
4,9,2,15,0.3076923076923077,0.8666666666666667,0.1286035298924669,0.8150469925053837
19,63,5,87,0.23170731707317074,0.9425287356321839,0.15733139734606855,0.8157226628725242
0,62,3,65,0.0,0.9538461538461539,0.1462924363071075,0.8176762648261262
29,83,32,144,0.25892857142857145,0.7777777777777778,0.1496087628377198,0.7963370448114094
118,434,43,595,0.213768115942029,0.9277310924369748,0.16260320546602966,0.8016379151595487
1,50,9,60,0.0196078431372549,0.85,0.14738630789619092,0.7839687422272179
17,69,20,106,0.19767441860465115,0.8113207547169812,0.1756255105539982,0.8756958830109625
2,0,0,2,1.0,1.0,0.27452660945509716,0.8947435020585816
1,15,1,17,0.0625,0.9411764705882353,0.2503541355875013,0.8945503213380174
11,92,2,105,0.10679611650485436,0.9809523809523809,0.26561072365962335,0.8984226394960498
14,114,22,150,0.109375,0.8533333333333334,0.24424592774125603,0.9092162902897006
11,48,4,63,0.1864406779661017,0.9365079365079365,0.24034200803040928,0.9104701251569809
3,26,2,31,0.10344827586206896,0.9354838709677419,0.2523192127053827,0.9226821067238012
1,22,1,24,0.043478260869565216,0.9583333333333334,0.22871002883075145,0.9446362846213754
29,73,15,117,0.28431372549019607,0.8717948717948718,0.126469132472208,0.9263212663063569
20,87,2,109,0.18691588785046728,0.981651376146789,0.14424283073656047,0.9321033956718647
26,95,3,124,0.21487603305785125,0.9758064516129032,0.16245674391958223,0.9313682629090821
72,303,40,415,0.192,0.9036144578313253,0.17548885909123227,0.9375988997421285
8,78,20,106,0.09302325581395349,0.8113207547169812,0.15972220556344355,0.9197150166291351
0,36,4,40,0.0,0.9,0.14494388044029086,0.9146458922051719
0,12,2,14,0.0,0.8571428571428571,0.13873270031606724,0.9001901098922467
1,13,2,16,0.07142857142857142,0.875,0.10832053545012085,0.9006479853501222
5,205,59,269,0.023809523809523808,0.7806691449814126,0.08501962630141464,0.8719362380407826
28,115,24,167,0.1958041958041958,0.8562874251497006,0.08229507812232102,0.8548620914031823
1,21,4,26,0.045454545454545456,0.8461538461538461,0.06136001318725608,0.8466534325921139
1,29,96,126,0.03333333333333333,0.23809523809523808,0.05283288140431034,0.7647640730747219
4,39,10,53,0.09302325581395349,0.8113207547169812,0.06612191794916084,0.7520956094628621
10,174,23,207,0.05434782608695652,0.8888888888888888,0.07388589310444035,0.7566307568551524
13,151,3,167,0.07926829268292683,0.9820359281437125,0.07500585328363397,0.7719216037328255
11,132,7,150,0.07692307692307693,0.9533333333333334,0.08259350372842726,0.7965879163545286
4,111,2,117,0.034782608695652174,0.9829059829059829,0.05959041985577818,0.8146762817482832
40,177,6,223,0.18433179723502305,0.9730941704035875,0.07943002725298927,0.8328106137839605
10,89,1,100,0.10101010101010101,0.99,0.08909813692109893,0.940225579770355
3,56,1,60,0.05084745762711865,0.9833333333333333,0.08307302289440825,0.9647988052869768
1,29,9,39,0.03333333333333333,0.7692307692307693,0.08007095250103351,0.9477047881929597
5,155,4,164,0.03125,0.975609756097561,0.07321119640347253,0.946786763614938
15,111,14,140,0.11904761904761904,0.9,0.07922898813554997,0.9391677159958904
28,87,25,140,0.24347826086956523,0.8214285714285714,0.10904265273182326,0.9160995143562601
11,95,2,108,0.10377358490566038,0.9814814814814815,0.09753433668477147,0.9172977016531022
5,61,1,67,0.07575757575757576,0.9850746268656716,0.09392683307726786,0.9165940769196268
3,118,12,133,0.024793388429752067,0.9097744360902256,0.09020482319192977,0.9060856630277543
11,38,1,50,0.22448979591836735,0.98,0.11751288927550606,0.9361955531376444
15,85,1,101,0.15,0.9900990099009901,0.13447717498979175,0.9382654465381342
2,24,4,30,0.07692307692307693,0.8666666666666667,0.1284593832577143,0.9335035417762294
8,76,12,96,0.09523809523809523,0.875,0.1072822167389329,0.9411566030007192
16,39,1,56,0.2909090909090909,0.9821428571428571,0.13401586045370867,0.9412510852380587
0,4,59,63,0.0,0.06349206349206349,0.12319334963119787,0.809596433327543
5,191,13,209,0.025510204081632654,0.937799043062201,0.1232957518671808,0.8135999486092539
17,203,14,234,0.07727272727272727,0.9401709401709402,0.10226474206066079,0.8079100829193883
32,107,12,151,0.2302158273381295,0.9205298013245033,0.11372414596610787,0.7979716245513186
7,50,7,64,0.12280701754385964,0.890625,0.12027899462621969,0.8013942435989377
30,192,6,228,0.13513513513513514,0.9736842105263158,0.12597857175436825,0.81549198795984
0,14,51,65,0.0,0.2153846153846154,0.08442013019592667,0.7059550962800911
4,9,2,15,0.3076923076923077,0.8666666666666667,0.12837617415197064,0.8206943253050346
19,63,5,87,0.23170731707317074,0.9425287356321839,0.15783290457933322,0.821369995672175
1,61,3,65,0.016129032258064516,0.9538461538461539,0.14909809100580995,0.8233235976257769
29,83,32,144,0.25892857142857145,0.7777777777777778,0.15319991159015883,0.8029304514048162
118,438,39,595,0.21223021582733814,0.934453781512605,0.16597465420208432,0.8091917059066168
1,50,9,60,0.0196078431372549,0.85,0.1494707553452443,0.791522532974286
17,69,20,106,0.19767441860465115,0.8113207547169812,0.17770995800305162,0.876656267164624
2,0,0,2,1.0,1.0,0.2766110569041505,0.895703886212243
1,15,1,17,0.0625,0.9411764705882353,0.2524385830365547,0.8955107054916789
9,94,2,105,0.08737864077669903,0.9809523809523809,0.2626170985392168,0.8993830236497112
14,115,21,150,0.10852713178294573,0.86,0.24113117858984162,0.9111290553957431
11,48,4,63,0.1864406779661017,0.9365079365079365,0.2374469588953793,0.9114225061093618
3,25,3,31,0.10714285714285714,0.9032258064516129,0.2499519608961796,0.9190261927453065
1,22,1,24,0.043478260869565216,0.9583333333333334,0.16521876040114836,0.9397643590557327
30,75,12,117,0.2857142857142857,0.8974358974358975,0.1346065155031892,0.9251123444037181
20,87,2,109,0.18691588785046728,0.981651376146789,0.15238021376754166,0.9308944737692258
28,91,3,122,0.23529411764705882,0.9754098360655737,0.168912913804078,0.9304211068849765
72,307,35,414,0.18997361477572558,0.9154589371980676,0.18152415659286206,0.9416467503955414
9,77,20,106,0.10465116279069768,0.8113207547169812,0.16530549153698768,0.9243778025221803
0,35,5,40,0.0,0.875,0.1494324756639718,0.9163728764138058
0,13,1,14,0.0,0.9285714285714286,0.14322129553974822,0.9121211757335337
1,14,1,16,0.06666666666666667,0.9375,0.1119287785329455,0.917844618956977
5,206,58,269,0.023696682464454975,0.7843866171003717,0.08861174919208659,0.8896639390932032
29,114,24,167,0.20279720279720279,0.8562874251497006,0.08396933278496431,0.872646451819507
2,24,0,26,0.07692307692307693,1.0,0.06781925594887164,0.8847237465054973
0,59,67,126,0.0,0.46825396825396826,0.052869089835914825,0.8357142055822097
4,46,3,53,0.08,0.9433962264150944,0.06429766126448626,0.8454850950700804
10,171,25,206,0.055248618784530384,0.8786407766990292,0.07219032109084775,0.8383521448025947
12,151,3,166,0.0736196319018405,0.9819277108433735,0.07318360183872971,0.8446989606373625
12,130,8,150,0.08450704225352113,0.9466666666666667,0.08187079609431058,0.8678818248611188
3,112,2,117,0.02608695652173913,0.9829059829059829,0.05662647519781579,0.8859701902548734
40,177,6,223,0.18433179723502305,0.9730941704035875,0.07197057809952237,0.8821265003125287
10,89,1,100,0.10101010101010101,0.99,0.0864005925295368,0.956661647704819
2,57,1,60,0.03389830508474576,0.9833333333333333,0.07981463611307192,0.9623669486931388
1,29,9,39,0.03333333333333333,0.7692307692307693,0.07668388104861519,0.9467369476262446
5,155,4,164,0.03125,0.975609756097561,0.07063107649120941,0.945834382662557
16,110,14,140,0.12698412698412698,0.9,0.07669923145272452,0.9391677159958904
29,87,24,140,0.25,0.8285714285714286,0.10868680909247609,0.9171199225195255
12,94,2,108,0.11320754716981132,0.9814814814814815,0.09852620194030297,0.9183181098163675
2,64,1,67,0.030303030303030304,0.9850746268656716,0.08842519183929287,0.9176144850828921
4,117,12,133,0.03305785123966942,0.9097744360902256,0.08830512700428197,0.9071060711910196
10,39,1,50,0.20408163265306123,0.98,0.11269774119281453,0.9372159613009096
15,85,1,101,0.15,0.9900990099009901,0.12966202690710024,0.9392858547013995
4,22,4,30,0.15384615384615385,0.8666666666666667,0.13349945931596122,0.9345239499394947
8,83,5,96,0.08791208791208792,0.9479166666666666,0.11034404330340238,0.9515732696673859
15,40,1,56,0.2727272727272727,0.9821428571428571,0.13313257552589683,0.9516677519047253
0,4,59,63,0.0,0.06349206349206349,0.1288035711968925,0.8200130999942098
5,194,9,208,0.02512562814070352,0.9567307692307693,0.1276703964684688,0.826721147585716
17,204,13,234,0.07692307692307693,0.9444444444444444,0.10950488850704247,0.821641782506351
29,110,12,151,0.20863309352517986,0.9205298013245033,0.11788104472492532,0.8117033241382815
9,48,7,64,0.15789473684210525,0.890625,0.11845941372434694,0.8151259431859005
30,192,6,228,0.13513513513513514,0.9736842105263158,0.1252055633276394,0.8188070208801361
5,59,1,65,0.078125,0.9846153846153847,0.09740523865231474,0.8191602390904971
4,10,1,15,0.2857142857142857,0.9333333333333333,0.13822156518292697,0.94342327763925
18,64,5,87,0.21951219512195122,0.9425287356321839,0.16599107475167665,0.941394415696595
2,60,3,65,0.03225806451612903,0.9538461538461539,0.15961035869354126,0.9427375170396963
30,85,28,143,0.2608695652173913,0.8041958041958042,0.1670727117924286,0.9261183745927394
115,446,34,595,0.20499108734402852,0.9428571428571428,0.1738007618641319,0.9335801092866168
1,50,9,60,0.0196078431372549,0.85,0.15729686300729187,0.915910936354286
17,68,20,105,0.2,0.8095238095238095,0.17470757729300618,0.8908978541983467
2,0,0,2,1.0,1.0,0.2767483936195368,0.9004216637221563
1,15,1,17,0.0625,0.9411764705882353,0.2543180800306866,0.9002284830015921
9,94,2,105,0.08737864077669903,0.9809523809523809,0.2621924480679109,0.9041008011596245
13,116,21,150,0.10077519379844961,0.86,0.23932182357949067,0.9120728291316526
12,47,4,63,0.2033898305084746,0.9365079365079365,0.23909307260298293,0.9111657996531944
3,26,2,31,0.10344827586206896,0.9354838709677419,0.2510702772779564,0.9233777812200147
1,20,1,22,0.047619047619047616,0.9545454545454546,0.23222029319573115,0.9413994111477821
29,65,13,107,0.30851063829787234,0.8785046728971962,0.13343609866685577,0.9240429358473816
19,69,2,90,0.2159090909090909,0.9777777777777777,0.15535168308244018,0.9292716940173164
26,73,3,102,0.26262626262626265,0.9705882352941176,0.18044736035203052,0.928109527022859
73,268,39,380,0.21407624633431085,0.8973684210526316,0.19686203072564515,0.9345746334509009
6,69,20,95,0.08,0.7894736842105263,0.17712177098538542,0.9141846755051891
0,32,1,33,0.0,0.9696969696969697,0.16124875511236955,0.9197078879249533
0,12,2,14,0.0,0.8571428571428571,0.15444603402393417,0.9057932311531536
1,7,2,10,0.125,0.8,0.12823022855280955,0.8945782778821256
5,165,58,228,0.029411764705882353,0.7456140350877193,0.10158775338092262,0.861412028926403
27,102,23,152,0.20930232558139536,0.8486842105263158,0.09397004808879872,0.8439971682452885
2,18,4,24,0.1,0.8333333333333334,0.07767344146961144,0.834849298571103
2,27,93,122,0.06896551724137931,0.23770491803278687,0.0760970867898085,0.7560251891171401
3,34,10,47,0.08108108108108109,0.7872340425531915,0.08768009837282008,0.7299590566680291
8,157,24,189,0.048484848484848485,0.873015873015873,0.094606505299227,0.7322266303641742
11,118,3,132,0.08527131782945736,0.9772727272727273,0.08893097927486378,0.7575513056888494
13,120,8,141,0.09774436090225563,0.9432624113475178,0.09869277873148853,0.7857867880116778
5,96,2,103,0.04950495049504951,0.9805825242718447,0.07586458229058197,0.804629404261039
40,177,6,223,0.18433179723502305,0.9730941704035875,0.08791198189558526,0.8245952381282182
6,72,1,79,0.07692307692307693,0.9873417721518988,0.08904877613582778,0.9316862172880914
3,49,1,53,0.057692307692307696,0.9811320754716981,0.08570752279457446,0.9593859362764494
1,27,8,36,0.03571428571428571,0.7777777777777778,0.08388315668449406,0.9457804940995788
5,150,4,159,0.03225806451612903,0.9748427672955975,0.07630983478259,0.9454333569599888
14,102,15,131,0.1206896551724138,0.8854961832061069,0.07958773396404117,0.9371810386540729
27,72,24,123,0.2727272727272727,0.8048780487804879,0.11147663714007305,0.9120803992981649
11,87,2,100,0.11224489795918367,0.98,0.10117850867209599,0.9130669463833666
4,60,1,65,0.0625,0.9846153846153847,0.09911806911165644,0.9126774624495788
3,104,12,119,0.028037383177570093,0.8991596638655462,0.09488165132383677,0.9009671179344144
9,37,1,47,0.1956521739130435,0.9787234042553191,0.11772992106651646,0.9296736360026344
15,84,1,100,0.15151515151515152,0.99,0.13476664778066252,0.9318389549604061
3,21,4,28,0.125,0.8571428571428571,0.13538241132746057,0.9277884798085135
7,60,11,78,0.1044776119402985,0.8589743589743589,0.11134674550074995,0.9355165241219235
18,32,1,51,0.36,0.9803921568627451,0.14674033150658086,0.9355725465308872
0,1,59,60,0.0,0.016666666666666666,0.13781176007800944,0.7972941582524989
6,161,13,180,0.03592814371257485,0.9277777777777778,0.1389390115830101,0.8013824602399605
18,165,15,198,0.09836065573770492,0.9242424242424242,0.12504022327224745,0.7935994630952613
32,91,13,136,0.2601626016260163,0.9044117647058824,0.14056128757379957,0.7813725723389587
6,50,7,63,0.10714285714285714,0.8888888888888888,0.1380102671656363,0.785907719731249
27,173,6,206,0.135,0.970873786407767,0.14237060831702222,0.8018933522217359
0,12,53,65,0.0,0.18461538461538463,0.09094203688845082,0.6882109561863986
4,8,2,14,0.3333333333333333,0.8571428571428571,0.13856108450749843,0.808278983397283
18,45,5,68,0.2857142857142857,0.9264705882352942,0.17424481907917141,0.808092242034071
1,59,3,63,0.016666666666666666,0.9523809523809523,0.1625742492118802,0.8121120317681465
29,81,32,142,0.2636363636363636,0.7746478873239436,0.16307050092764414,0.7935743349992981
105,349,30,484,0.23127753303964757,0.9380165289256198,0.18080402605575704,0.8005925692902596
1,43,9,53,0.022727272727272728,0.8301886792452831,0.164765065016796,0.7804946968384764
17,57,20,94,0.22972972972972974,0.7872340425531915,0.19758359783532883,0.8665830765438772
1,1,0,2,0.5,1.0,0.22139312164485261,0.8869912398091834
1,15,1,17,0.0625,0.9411764705882353,0.18950536654281183,0.8890920801453178
11,81,2,94,0.11956521739130435,0.9787234042553191,0.20420515950347434,0.8928552875559416
12,106,23,141,0.1016949152542373,0.8368794326241135,0.18107066687745627,0.9017455083131088
12,43,4,59,0.21818181818181817,0.9322033898305084,0.17919985046919495,0.9009150598709501
3,24,2,29,0.1111111111111111,0.9310344827586207,0.19182611309545758,0.9153216032299981
0,21,1,22,0.0,0.9545454545454546,0.2267722086770683,0.9431427781278688
27,66,14,107,0.2903225806451613,0.8691588785046729,0.12538972019780562,0.924451189342822
18,71,2,91,0.20224719101123595,0.978021978021978,0.1453536046279822,0.9297148332619282
27,74,3,104,0.26732673267326734,0.9711538461538461,0.16689958724288725,0.9283150425764232
74,267,40,381,0.21700879765395895,0.89501312335958,0.18339191547916708,0.9342692982944584
6,69,20,95,0.08,0.7894736842105263,0.16576479683509926,0.9132644051091141
0,29,4,33,0.0,0.8787878787878788,0.15098647171194654,0.9051649776548479
0,12,2,14,0.0,0.8571428571428571,0.15098647171194654,0.8912503208830483
1,7,2,10,0.125,0.8,0.12736896019120922,0.8813704810966666
4,166,58,228,0.023529411764705882,0.7456140350877193,0.10183784887027636,0.8481693463917724
28,102,24,154,0.2153846153846154,0.8441558441558441,0.09441754640046895,0.8300267746777721
2,18,4,24,0.1,0.8333333333333334,0.07770200387847481,0.821215376102594
2,23,97,122,0.08,0.20491803278688525,0.07770200387847481,0.7377074258992167
3,35,10,48,0.07894736842105263,0.7916666666666666,0.08898019936719662,0.7252615384533294
7,159,24,190,0.04216867469879518,0.8736842105263158,0.09500429575273879,0.7276245889366805
10,120,3,133,0.07692307692307693,0.9774436090225563,0.08813616388460692,0.7529736759399028
13,120,8,141,0.09774436090225563,0.9432624113475178,0.09873829947568545,0.7812091582627312
3,98,2,103,0.0297029702970297,0.9805825242718447,0.07221235017745893,0.8006986839935885
41,176,6,223,0.1889400921658986,0.9730941704035875,0.08491807762973015,0.8206645178607676
6,72,1,79,0.07692307692307693,0.9873417721518988,0.08447851719016973,0.9324393377700552
2,51,1,54,0.03773584905660377,0.9814814814814815,0.07859115728096275,0.9595557398864575
1,27,8,36,0.03571428571428571,0.7777777777777778,0.07766910171174711,0.9458548209223805
4,151,4,159,0.025806451612903226,0.9748427672955975,0.07036672666743657,0.9454832721042435
14,102,15,131,0.1206896551724138,0.8854961832061069,0.07364462584888774,0.9372309537983277
27,71,25,123,0.2755102040816326,0.7967479674796748,0.10875994496097387,0.9109688742565891
11,87,2,100,0.11224489795918367,0.98,0.09780348864572888,0.9119554213417909
5,59,1,65,0.078125,0.9846153846153847,0.09797519194243218,0.9115659374080032
4,103,12,119,0.037383177570093455,0.8991596638655462,0.09792481030150213,0.8998056777485839
9,37,1,47,0.1956521739130435,0.9787234042553191,0.12077308004418182,0.9285121958168041
15,84,1,100,0.15151515151515152,0.99,0.13873146574450299,0.9306775147745758
4,20,4,28,0.16666666666666666,0.8571428571428571,0.14529961024368201,0.926627039622683
7,60,11,78,0.1044776119402985,0.8589743589743589,0.12086638279491997,0.9355165241219235
18,32,1,51,0.36,0.9803921568627451,0.15625996880075085,0.9355725465308872
0,1,59,60,0.0,0.016666666666666666,0.14509925451503655,0.7972941582524989
5,162,13,180,0.029940119760479042,0.9277777777777778,0.14403596054223453,0.8013824602399605
17,168,13,198,0.0918918918918919,0.9343434343434344,0.12921306311064143,0.7950424645382628
30,95,12,137,0.24,0.9124087591240876,0.14185375575133405,0.7839580015559895
6,50,7,63,0.10714285714285714,0.8888888888888888,0.13335035439078985,0.7884931489482797
30,171,6,207,0.14925373134328357,0.9710144927536232,0.1397469428769306,0.8044988823453175
0,15,50,65,0.0,0.23076923076923078,0.08831837144835916,0.697409892903387
4,8,2,14,0.3333333333333333,0.8571428571428571,0.13593741906740678,0.8174779201142712
18,45,5,68,0.2857142857142857,0.9264705882352942,0.1724765856322363,0.8172911787510593
1,59,3,63,0.016666666666666666,0.9523809523809523,0.16173012488577557,0.8198679670421333
28,82,32,142,0.2545454545454545,0.7746478873239436,0.16380804696369763,0.8001878424992556
104,349,31,484,0.22958057395143489,0.9359504132231405,0.181299149364923,0.8069109174041487
1,43,9,53,0.022727272727272728,0.8301886792452831,0.16322394099120716,0.7867929440458143
17,57,20,94,0.22972972972972974,0.7872340425531915,0.19604247380974,0.8662879171578088
2,0,0,2,1.0,1.0,0.2912805690478352,0.886696080423115
1,15,1,17,0.0625,0.9411764705882353,0.25939281394579444,0.8887969207592493
8,84,2,94,0.08695652173913043,0.9787234042553191,0.26943422181328924,0.8925601281698732
12,109,21,142,0.09917355371900827,0.852112676056338,0.24723823598093977,0.9036265265602152
12,43,4,59,0.21818181818181817,0.9322033898305084,0.24560984229956598,0.9030912375041249
3,24,2,29,0.1111111111111111,0.9310344827586207,0.2582361049258286,0.9174977808631731
1,21,1,23,0.045454545454545456,0.9565217391304348,0.23009977491210518,0.9443774854495326
28,76,13,117,0.2692307692307692,0.8888888888888888,0.12570417051650076,0.9285044695765167
20,88,2,110,0.18518518518518517,0.9818181818181818,0.14323062554295582,0.9343104283236521
28,94,3,125,0.22950819672131148,0.976,0.16353484782075758,0.9336029453304547
75,304,36,415,0.19788918205804748,0.9132530120481928,0.17630085500291498,0.9412105184801965
7,79,20,106,0.08139534883720931,0.8113207547169812,0.15887307190701994,0.9233266353672028
0,36,4,40,0.0,0.9,0.14409474678386722,0.9182575109432397
0,13,1,14,0.0,0.9285714285714286,0.13760124029036072,0.9142646094348102
1,13,2,16,0.07142857142857142,0.875,0.10934378346147532,0.9122804824506835
6,204,59,269,0.02857142857142857,0.7806691449814126,0.0869703896595101,0.8835449057597163
27,119,23,169,0.18493150684931506,0.863905325443787,0.08060229110636775,0.8675313808231143
1,21,4,26,0.045454545454545456,0.8461538461538461,0.058825914448724606,0.8579457856953506
0,21,105,126,0.0,0.16666666666666666,0.04719800747198043,0.7658523445453057
4,39,10,53,0.09302325581395349,0.8113207547169812,0.06048704401683092,0.7531838809334459
10,172,25,207,0.054945054945054944,0.8792270531400966,0.0683363375804102,0.7461346844432557
13,151,3,167,0.07926829268292683,0.9820359281437125,0.06945629775960382,0.7614255313209288
12,130,8,150,0.08450704225352113,0.9466666666666667,0.07744709971418848,0.7851394629902508
4,110,2,116,0.03508771929824561,0.9827586206896551,0.056040844349749985,0.802118505168232
41,176,6,223,0.1889400921658986,0.9730941704035875,0.07653877959422901,0.8202528372039094
9,91,1,101,0.09,0.9900990099009901,0.08939592245137186,0.9378860290945271
4,55,1,60,0.06779661016949153,0.9833333333333333,0.08579211593073444,0.9624592546111488
1,29,9,39,0.03333333333333333,0.7692307692307693,0.08270472712905994,0.9467454997669591
6,154,4,164,0.0375,0.975609756097561,0.07673782817435608,0.9458274751889375
13,103,24,140,0.11206896551724138,0.8285714285714286,0.08067524578345898,0.9289567268896176
25,90,25,140,0.21739130434782608,0.8214285714285714,0.1067186150762562,0.9059095769951772
12,94,2,108,0.11320754716981132,0.9814814814814815,0.09589968007681515,0.9071077642920191
5,60,2,67,0.07692307692307693,0.9701492537313433,0.0940315482086833,0.9042577991249267
4,116,12,132,0.03333333333333333,0.9090909090909091,0.08910822294637498,0.8936517385188661
11,38,1,50,0.22448979591836735,0.98,0.11641628902995126,0.9237616286287562
15,85,1,101,0.15,0.9900990099009901,0.13248771760137984,0.9258315220292461
3,23,4,30,0.11538461538461539,0.8666666666666667,0.13296138186814754,0.9312736988999945
8,76,12,96,0.09523809523809523,0.875,0.11551092342390028,0.9389267601244843
17,37,2,56,0.3148148148148148,0.9642857142857143,0.14431196165890078,0.9364702219536604
0,4,59,63,0.0,0.06349206349206349,0.1333229506698898,0.8069477662051917
5,191,13,209,0.025510204081632654,0.937799043062201,0.1322053607767897,0.8110489282010906
19,203,13,235,0.08558558558558559,0.9446808510638298,0.1123619021578209,0.8060033354959234
30,106,14,150,0.22058823529411764,0.9066666666666666,0.12244593577126626,0.7940844293195916
5,52,7,64,0.08771929824561403,0.890625,0.11849374760855177,0.7975070483672108
29,193,6,228,0.13063063063063063,0.9736842105263158,0.12354982409319969,0.8116047927281128
0,11,54,65,0.0,0.16923076923076924,0.0785762791196547,0.6980255148631207
3,11,1,15,0.21428571428571427,0.9333333333333333,0.10918852401761389,0.8222885534118737
19,63,5,87,0.23170731707317074,0.9425287356321839,0.13864525444497647,0.822964223779014
0,62,3,65,0.0,0.9538461538461539,0.12641874221846425,0.8242735527479175
28,83,32,143,0.25225225225225223,0.7762237762237763,0.13094217321248347,0.8056388541132187
113,437,43,593,0.20545454545454545,0.927487352445194,0.14776149424233084,0.8109049044625322
1,50,9,60,0.0196078431372549,0.85,0.13190109602899144,0.7932357315302013
17,69,20,106,0.19767441860465115,0.8113207547169812,0.16014029868679874,0.884962872313946
2,0,0,2,1.0,1.0,0.27238519664598243,0.8944866818377555
1,15,1,17,0.0625,0.9411764705882353,0.2482127227783866,0.8942935011171914
12,91,2,105,0.11650485436893204,0.9809523809523809,0.26485627340251977,0.8981658192752239
13,115,22,150,0.1015625,0.8533333333333334,0.2433291659379123,0.9091814702908749
12,47,4,63,0.2033898305084746,0.9365079365079365,0.2430342066599022,0.9104701251569809
3,26,2,31,0.10344827586206896,0.9354838709677419,0.25501141133487565,0.9226821067238011
1,21,1,23,0.045454545454545456,0.9565217391304348,0.22660179353395896,0.9434251044971518
27,77,13,117,0.25961538461538464,0.8888888888888888,0.12083256276472817,0.9275520886241359
16,92,2,110,0.14814814814814814,0.9818181818181818,0.1330680125001779,0.9333580473712709
28,94,3,125,0.22950819672131148,0.976,0.1547591973299908,0.9326505643780738
74,307,35,416,0.1942257217847769,0.9158653846153846,0.1691128718706732,0.9415837145612239
6,80,20,106,0.06976744186046512,0.8113207547169812,0.15002395920667186,0.9236998314482303
0,36,4,40,0.0,0.9,0.13524563408351914,0.9186307070242672
0,12,2,14,0.0,0.8571428571428571,0.12875212759001262,0.9044337238831847
1,13,2,16,0.07142857142857142,0.875,0.10186829713475362,0.9024495968990577
6,203,59,268,0.028708133971291867,0.7798507462686567,0.08480543796663129,0.8735971061062683
26,120,23,169,0.1780821917808219,0.863905325443787,0.07745886583227564,0.8575835811696665
1,21,4,26,0.045454545454545456,0.8461538461538461,0.056205840642242565,0.8476247899608753
0,22,104,126,0.0,0.1746031746031746,0.046239063233604695,0.7566651356589029
4,39,10,53,0.09302325581395349,0.8113207547169812,0.05952809977845519,0.7439966720470431
10,172,25,207,0.054945054945054944,0.8792270531400966,0.06737739334203448,0.747151557189506
13,151,3,167,0.07926829268292683,0.9820359281437125,0.0684973535212281,0.7624424040671791
13,130,7,150,0.09090909090909091,0.9533333333333334,0.07738320451234225,0.7872256307907044
3,111,2,116,0.02631578947368421,0.9827586206896551,0.055702289897036864,0.8042046729686856
41,176,6,223,0.1889400921658986,0.9730941704035875,0.07620022514151589,0.8223390050043629
9,91,1,101,0.09,0.9900990099009901,0.08905736799865874,0.938838410046908
4,51,5,60,0.07272727272727272,0.9166666666666666,0.08615794184341863,0.9538878260397201
1,29,9,39,0.03333333333333333,0.7692307692307693,0.08307055304174413,0.9381740711955304
6,154,4,164,0.0375,0.975609756097561,0.07710365408704027,0.9372560466175088
14,111,15,140,0.112,0.8928571428571429,0.0801166411000273,0.9286165908351959
27,88,25,140,0.23478260869565218,0.8214285714285714,0.10989761527459416,0.9055694409407554
12,94,2,108,0.11320754716981132,0.9814814814814815,0.0990786802751531,0.9067676282375974
5,60,2,67,0.07692307692307693,0.9701492537313433,0.09721054840702124,0.903917663070505
4,116,12,132,0.03333333333333333,0.9090909090909091,0.09158284277931561,0.9028354119882539
10,39,1,50,0.20408163265306123,0.98,0.11597545696784817,0.9329453020981441
16,84,1,101,0.16,0.9900990099009901,0.13347545696784818,0.935015195498634
4,22,4,30,0.15384615384615385,0.8666666666666667,0.13945347894587015,0.9312736988999945
8,75,13,96,0.0963855421686747,0.8645833333333334,0.11968246944201623,0.937438664886389
17,37,2,56,0.3148148148148148,0.9642857142857143,0.14848350767701674,0.9349821267155651
0,4,59,63,0.0,0.06349206349206349,0.13749449668800573,0.8054596709670966
5,191,13,209,0.025510204081632654,0.937799043062201,0.13637690679490563,0.8095608329629955
20,201,14,235,0.09049773755656108,0.9404255319148936,0.12015063606683418,0.803907337522266
28,106,16,150,0.208955223880597,0.8933333333333333,0.12714423947834802,0.7900836694411721
4,53,7,64,0.07017543859649122,0.890625,0.11519128015696767,0.7935062884887911
30,192,6,228,0.13513513513513514,0.9736842105263158,0.12072693629503344,0.8090921280877886
0,9,56,65,0.0,0.13846153846153847,0.07575339132148848,0.691117245827192
3,11,1,15,0.21428571428571427,0.9333333333333333,0.10636563621944765,0.815380284375945
19,63,5,87,0.23170731707317074,0.9425287356321839,0.13582236664681024,0.8160559547430853
0,62,3,65,0.0,0.9538461538461539,0.12289411842444438,0.8179731864475511
28,83,32,143,0.25225225225225223,0.7762237762237763,0.1290794081918237,0.8012432497176143
118,435,40,593,0.21338155515370705,0.9325463743676222,0.1495374248428545,0.8072320174844176
1,50,9,60,0.0196078431372549,0.85,0.1330335259860145,0.7895628445520868
18,68,20,106,0.20930232558139536,0.8113207547169812,0.16293385821192813,0.8856855897314357
2,0,0,2,1.0,1.0,0.2751787561711118,0.8952093992552452
1,15,1,17,0.0625,0.9411764705882353,0.251006282303516,0.895016218534681
9,94,2,105,0.08737864077669903,0.9809523809523809,0.26348894527161587,0.8988885366927135
14,115,21,150,0.10852713178294573,0.86,0.24295678520457206,0.9108565686607456
12,47,4,63,0.2033898305084746,0.9365079365079365,0.24152939596953885,0.9114225061093618
3,26,2,31,0.10344827586206896,0.9354838709677419,0.2535066006445123,0.9236344876761822
1,21,1,23,0.045454545454545456,0.9565217391304348,0.2266017935339589,0.9434251044971517
28,77,12,117,0.26666666666666666,0.8974358974358975,0.12183988877205414,0.9287730898451371
19,89,2,110,0.17592592592592593,0.9818181818181818,0.13804359247575784,0.9345790485922721
27,95,3,125,0.22131147540983606,0.976,0.1585638171182171,0.9338715655990749
73,307,36,416,0.19210526315789472,0.9134615384615384,0.17261456899791636,0.9424613091888185
9,77,20,106,0.10465116279069768,0.8113207547169812,0.1585090450382339,0.9245774260758249
4,35,1,40,0.10256410256410256,0.975,0.15838273456709584,0.9302225873661475
0,13,1,14,0.0,0.9285714285714286,0.15188922807358934,0.9262296858577181
1,13,2,16,0.07142857142857142,0.875,0.12399807161100433,0.9230245576525898
6,204,58,268,0.02857142857142857,0.7835820895522388,0.10294742913179043,0.8947051159003123
27,118,24,169,0.18620689655172415,0.8579881656804734,0.0979324892949173,0.8778462824260942
3,19,4,26,0.13636363636363635,0.8461538461538461,0.0899693997528804,0.8682308978107097
2,24,100,126,0.07692307692307693,0.20634920634920634,0.08600824462893455,0.7818063909010274
4,39,10,53,0.09302325581395349,0.8113207547169812,0.08464526652177042,0.758423641574882
9,173,25,207,0.04945054945054945,0.8792270531400966,0.09170963072899176,0.7513744450846918
13,151,3,167,0.07926829268292683,0.9820359281437125,0.0928295909081854,0.7666652919623649
14,128,8,150,0.09859154929577464,0.9466666666666667,0.10283246529737769,0.7899630886929975
4,110,2,116,0.03508771929824561,0.9827586206896551,0.08124401140402361,0.8077874394085949
41,176,6,223,0.1889400921658986,0.9730941704035875,0.08875493366148965,0.8259217714442721
10,90,1,101,0.1,0.9900990099009901,0.09205163695819295,0.9378860290945271
2,57,1,60,0.03389830508474576,0.9833333333333333,0.08360521542544898,0.9624592546111488
1,29,9,39,0.03333333333333333,0.7692307692307693,0.0813027559801324,0.9467454997669591
5,155,4,164,0.03125,0.975609756097561,0.07444299988257141,0.9458274751889375
15,110,15,140,0.12,0.8928571428571429,0.07750134998317504,0.9381404003590054
26,89,25,140,0.22608695652173913,0.8214285714285714,0.10478695530081697,0.915093250464565
12,94,2,108,0.11320754716981132,0.9814814814814815,0.09396802030137594,0.9162914377614069
5,61,1,67,0.07575757575757576,0.9850746268656716,0.09050481683817248,0.9155736687563615
3,117,12,132,0.025,0.9090909090909091,0.08923363039749452,0.9049676081503008
9,40,1,50,0.1836734693877551,0.98,0.11071079269098334,0.9350774982601909
15,85,1,101,0.15,0.9900990099009901,0.12767507840526907,0.9371473916606808
4,22,4,30,0.15384615384615385,0.8666666666666667,0.1325102432404339,0.9334058950620413
8,76,12,96,0.09523809523809523,0.875,0.1138175487713419,0.941058956286531
19,36,1,56,0.34545454545454546,0.9821428571428571,0.14699569138344679,0.9411534385238706
0,4,59,63,0.0,0.06349206349206349,0.13617318056093594,0.8094987866133552
5,191,13,209,0.025510204081632654,0.937799043062201,0.13624606685831203,0.813599948609254
20,202,13,235,0.09009009009009009,0.9446808510638298,0.12287701267293134,0.8085543559040868
31,104,15,150,0.22962962962962963,0.9,0.1342526740485927,0.7956830687753739
4,53,7,64,0.07017543859649122,0.890625,0.12229971472721234,0.799105687822993
32,190,6,228,0.14414414414414414,0.9736842105263158,0.12928629314236217,0.8132034321838952
0,13,52,65,0.0,0.2,0.07993564379171282,0.7014687383063442
5,9,1,15,0.35714285714285715,0.9333333333333333,0.13095605195497811,0.825731776855097
19,63,5,87,0.23170731707317074,0.9425287356321839,0.16041278238234072,0.8264074472222375
1,61,3,65,0.016129032258064516,0.9538461538461539,0.14984691697776564,0.8277167761911409
29,82,32,143,0.26126126126126126,0.7762237762237763,0.15436572149657016,0.8100344585088232
123,432,38,593,0.22162162162162163,0.9359190556492412,0.1760008905001602,0.8165050378872862
1,50,9,60,0.0196078431372549,0.85,0.15820999035631886,0.7988358649549554
17,69,20,106,0.19767441860465115,0.8113207547169812,0.18644919301412619,0.8861674013430955
2,0,0,2,1.0,1.0,0.27828592770800376,0.895691210866905
1,15,1,17,0.0625,0.9411764705882353,0.25411345384040795,0.895498030146341
8,95,2,105,0.07766990291262135,0.9809523809523809,0.26290500679105894,0.8993703483043733
12,116,22,150,0.09375,0.8533333333333334,0.23897482661087874,0.9103859993200245
12,47,4,63,0.2033898305084746,0.9365079365079365,0.2363702850232863,0.910470125156981
3,26,2,31,0.10344827586206896,0.9354838709677419,0.24834748969825976,0.9226821067238011
1,21,1,23,0.045454545454545456,0.9565217391304348,0.23153453248709807,0.943278809419981
29,77,11,117,0.27358490566037735,0.905982905982906,0.1277609475814377,0.9298477959889676
16,92,2,110,0.14814814814814814,0.9818181818181818,0.13999639731688743,0.9356537547361029
28,94,3,125,0.22950819672131148,0.976,0.1561397319386559,0.9349462717429056
74,306,36,416,0.19473684210526315,0.9134615384615384,0.17168249509655062,0.9435360153326491
9,77,20,106,0.10465116279069768,0.8113207547169812,0.15707601096320203,0.9257984272968262
4,35,1,40,0.10256410256410256,0.975,0.15694970049206397,0.9314435885871487
0,13,1,14,0.0,0.9285714285714286,0.1504561939985575,0.9274506870787194
1,13,2,16,0.07142857142857142,0.875,0.12157671767972807,0.9230245576525898
7,202,59,268,0.03349282296650718,0.7798507462686567,0.10519738551092221,0.8941720668598006
28,117,24,169,0.19310344827586207,0.8579881656804734,0.09999670716157229,0.8773132333855825
2,20,4,26,0.09090909090909091,0.8461538461538461,0.08516417127640484,0.867697848770198
2,24,100,126,0.07692307692307693,0.20634920634920634,0.08120301615245902,0.7812733418605157
4,39,10,53,0.09302325581395349,0.8113207547169812,0.07984003804529485,0.7578905925343703
10,171,25,206,0.055248618784530384,0.8786407766990292,0.08773269787165634,0.7507576422668846
15,149,3,167,0.09146341463414634,0.9820359281437125,0.09059481832959561,0.7660484891445577
12,130,8,150,0.08450704225352113,0.9466666666666667,0.09788256394202617,0.7898793349157022
4,110,2,116,0.03508771929824561,0.9827586206896551,0.07530888837379525,0.8077036856312995
41,176,6,223,0.1889400921658986,0.9730941704035875,0.08931331712476778,0.825838017666977
10,90,1,101,0.1,0.9900990099009901,0.09261002042147108,0.9378022753172317
2,56,1,59,0.034482758620689655,0.9830508474576272,0.08424709225100481,0.9623351457087524
1,29,9,39,0.03333333333333333,0.7692307692307693,0.0811163371865481,0.9467051446418582
5,155,4,164,0.03125,0.975609756097561,0.07251442081024148,0.9457871200638366
14,111,15,140,0.112,0.8928571428571429,0.0764419862025956,0.9381000452339044
29,85,26,140,0.2543859649122807,0.8142857142857143,0.10777030700460062,0.9140324871761988
12,94,2,108,0.11320754716981132,0.9814814814814815,0.09695137200515958,0.9152306744730406
5,61,1,67,0.07575757575757576,0.9850746268656716,0.0934881685419561,0.9145129054679951
3,117,12,132,0.025,0.9090909090909091,0.09213348873900044,0.9039471999870354
10,39,1,50,0.20408163265306123,0.98,0.116526102927533,0.9340570900969256
15,85,1,101,0.15,0.9900990099009901,0.1334903886418187,0.9361269834974155
4,22,4,30,0.15384615384615385,0.8666666666666667,0.1394684106198407,0.9323854868987761
8,77,11,96,0.09411764705882353,0.8854166666666666,0.11657293664077538,0.9425470515246264
16,39,1,56,0.2909090909090909,0.9821428571428571,0.1419588714606725,0.9426415337619657
0,4,59,63,0.0,0.06349206349206349,0.13113636063816164,0.8109868818514504
5,191,13,209,0.025510204081632654,0.937799043062201,0.13120924693553773,0.8150880438473492
21,201,13,235,0.0945945945945946,0.9446808510638298,0.11556824149861392,0.8100424511421819
31,107,12,150,0.2246376811594203,0.92,0.12623076737853114,0.800028306870612
2,55,7,64,0.03508771929824561,0.890625,0.10926527672882992,0.803450925918231
30,192,6,228,0.13513513513513514,0.9736842105263158,0.11512491788258875,0.816060575041038
0,12,53,65,0.0,0.18461538461538463,0.07356647632414719,0.7021280789656849
5,8,2,15,0.38461538461538464,0.8666666666666667,0.12851153126920214,0.8168673079906281
19,63,5,87,0.23170731707317074,0.9425287356321839,0.15796826169656472,0.8175429783577686
1,61,3,65,0.016129032258064516,0.9538461538461539,0.146758895648489,0.818852307326672
29,82,32,143,0.26126126126126126,0.7762237762237763,0.1519908356630377,0.7983128467872115
122,435,37,594,0.21903052064631956,0.9377104377104377,0.17826837871276258,0.8050393378887026
1,50,9,60,0.0196078431372549,0.85,0.16176447985592254,0.7873701649563717
17,69,20,106,0.19767441860465115,0.8113207547169812,0.19000368251372984,0.8768995035423142
2,0,0,2,1.0,1.0,0.2779157704258177,0.8959471225899331
1,15,1,17,0.0625,0.9411764705882353,0.2537432965582219,0.8957539418693691
8,95,2,105,0.07766990291262135,0.9809523809523809,0.2625348495088729,0.8996262600274016
12,116,22,150,0.09375,0.8533333333333334,0.2386046693286927,0.9106419110430525
12,47,4,63,0.2033898305084746,0.9365079365079365,0.2363702850232863,0.9104701251569809
3,26,2,31,0.10344827586206896,0.9354838709677419,0.24834748969825973,0.9226821067238012
1,21,1,23,0.045454545454545456,0.9565217391304348,0.23130764163372888,0.9415147507925097
28,77,12,117,0.26666666666666666,0.8974358974358975,0.1265457368718241,0.926862736140495
21,86,2,109,0.19626168224299065,0.981651376146789,0.14565454862082278,0.9326448655060027
27,94,3,124,0.2231404958677686,0.9758064516129032,0.16510940206777108,0.9322281579856576
75,305,35,415,0.19736842105263158,0.9156626506024096,0.18031787780256261,0.9413067257779535
9,77,20,106,0.10465116279069768,0.8113207547169812,0.16352201216948767,0.9242047646291479
4,35,1,40,0.10256410256410256,0.975,0.16230101094848645,0.9304855528064878
0,13,1,14,0.0,0.9285714285714286,0.15580750445497998,0.9264926512980584
1,14,1,16,0.06666666666666667,0.9375,0.1272360758835514,0.9322160945215014
6,203,59,268,0.028708133971291867,0.7798507462686567,0.10329985470188015,0.9033874331103399
29,114,24,167,0.20279720279720279,0.8562874251497006,0.1003936699775136,0.8863132864727393
2,24,0,26,0.07692307692307693,1.0,0.08318719224472007,0.8983614792438237
1,53,72,126,0.018518518518518517,0.42857142857142855,0.0708825287772659,0.8436830040801734
4,45,3,52,0.08163265306122448,0.9423076923076923,0.06789232170542618,0.8390126744098436
10,170,25,205,0.05555555555555555,0.8780487804878049,0.07582882964193412,0.8317951532550404
12,152,3,167,0.07317073170731707,0.9820359281437125,0.07675798179059846,0.8381574287041421
13,129,8,150,0.09154929577464789,0.9466666666666667,0.08573529061964932,0.8619882744752864
5,109,2,116,0.043859649122807015,0.9827586206896551,0.06302992580902135,0.8800555881238513
41,176,6,223,0.1889400921658986,0.9730941704035875,0.07903235655799588,0.8762118981815067
10,90,1,101,0.1,0.9900990099009901,0.09067256819820753,0.9564301240857297
2,56,1,59,0.034482758620689655,0.9830508474576272,0.08393686899241683,0.9622505748214347
1,29,9,39,0.03333333333333333,0.7692307692307693,0.08076226581781365,0.9467051446418582
6,154,4,164,0.0375,0.975609756097561,0.07566644700248264,0.9457871200638366
13,103,24,140,0.11206896551724138,0.8285714285714286,0.07859782839428171,0.9289163717645168
29,86,25,140,0.25217391304347825,0.8214285714285714,0.1083570089543776,0.9058692218700762
13,93,2,108,0.12264150943396226,0.9814814814814815,0.09888578284981528,0.9070674091669183
4,62,1,67,0.06060606060606061,0.9850746268656716,0.09325807722210964,0.9063496401618727
4,116,12,132,0.03333333333333333,0.9090909090909091,0.09309387360963016,0.895783934680913
11,38,1,50,0.22448979591836735,0.98,0.12040193969320645,0.9258938247908032
15,85,1,101,0.15,0.9900990099009901,0.13647336826463502,0.9279637181912931
4,22,4,30,0.15384615384615385,0.8666666666666667,0.14244153802590825,0.9334058950620413
8,83,5,96,0.08791208791208792,0.9479166666666666,0.11897556300713819,0.9514756229531978
16,39,1,56,0.2909090909090909,0.9821428571428571,0.14301378893215655,0.9515701051905372
0,4,59,63,0.0,0.06349206349206349,0.1343557802741479,0.8199154532800217
5,195,9,209,0.025,0.9569377990430622,0.13316530408367172,0.8267507232731865
20,203,12,235,0.08968609865470852,0.948936170212766,0.11390763304600617,0.8223130333035815
31,109,10,150,0.22142857142857142,0.9333333333333333,0.12411171467865922,0.8142036509367735
2,53,7,62,0.03636363636363636,0.8870967741935484,0.10732849789544244,0.8171222377263281
28,194,6,228,0.12612612612612611,0.9736842105263158,0.11278764621173362,0.8208033154205635
6,58,1,65,0.09375,0.9846153846153847,0.0846220617961492,0.8211565336309248
5,8,2,15,0.38461538461538464,0.8666666666666667,0.13956711674120417,0.935895762655868
18,64,5,87,0.21951219512195122,0.9425287356321839,0.16735457318719718,0.9338373250257426
1,61,3,65,0.016129032258064516,0.9538461538461539,0.15684642084481945,0.9345387512590838
29,87,28,144,0.25,0.8055555555555556,0.16092805349788072,0.9162847830051154
120,443,31,594,0.21314387211367672,0.9478114478114478,0.18618237289074363,0.9249583078076725
1,50,9,60,0.0196078431372549,0.85,0.17096547532090486,0.9072891348753416
17,69,20,106,0.19767441860465115,0.8113207547169812,0.185811820835855,0.8825327591755697
2,0,0,2,1.0,1.0,0.27372390874794295,0.9015803782231888
1,15,1,17,0.0625,0.9411764705882353,0.2512935951590928,0.9013871975026246
12,91,2,105,0.11650485436893204,0.9809523809523809,0.26563299831778814,0.9052595156606571
11,117,22,150,0.0859375,0.8533333333333334,0.24219549831778808,0.912084912486054
12,46,4,62,0.20689655172413793,0.9354838709677419,0.2413030239764254,0.9103238300798102
3,26,2,31,0.10344827586206896,0.9354838709677419,0.2532802286513988,0.9225358116466306
1,20,1,22,0.047619047619047616,0.9545454545454546,0.23218744019346899,0.9392203519886192
27,62,18,107,0.30337078651685395,0.8317757009345794,0.1326689811244481,0.9151883092649876
14,74,2,90,0.1590909090909091,0.9777777777777777,0.14646768242314942,0.9204170674349222
28,70,3,101,0.2857142857142857,0.9702970297029703,0.17330885367425855,0.9192132996417295
75,263,37,375,0.22189349112426035,0.9013333333333333,0.19300312191409888,0.9282568945444795
5,71,20,96,0.06578947368421052,0.7916666666666666,0.1706555864086686,0.908347206531343
4,28,1,33,0.125,0.9696969696969697,0.17263971339279557,0.9138704189511072
0,13,1,14,0.0,0.9285714285714286,0.16583699230436025,0.9101598438119607
0,8,2,10,0.0,0.8,0.12249830851623825,0.9056204579641636
4,166,58,228,0.023529411764705882,0.7456140350877193,0.10313238032678064,0.872454209008441
27,102,24,153,0.20930232558139536,0.8431372549019608,0.09221638602208203,0.8542885268940111
2,18,4,24,0.1,0.8333333333333334,0.07480303014718769,0.8445742411797253
0,29,93,122,0.0,0.23770491803278687,0.06540453390658618,0.7654368485177426
3,35,10,48,0.07894736842105263,0.7916666666666666,0.05882558653816512,0.7400039480848422
10,152,24,186,0.06172839506172839,0.8709677419354839,0.06764392868984061,0.7317748499939929
10,120,3,133,0.07692307692307693,0.9774436090225563,0.07863293967885158,0.7571239369972153
11,122,8,141,0.08270676691729323,0.9432624113475178,0.08708684755779264,0.7853594193200436
4,97,2,103,0.039603960396039604,0.9805825242718447,0.06284422395988468,0.8049944578014555
41,176,6,223,0.1889400921658986,0.9730941704035875,0.07554995141215591,0.8249602916686347
6,72,1,79,0.07692307692307693,0.9873417721518988,0.0865389624011669,0.9320512708285077
3,48,1,52,0.058823529411764705,0.9807692307692307,0.08366412825698291,0.9590659228431598
1,27,8,36,0.03571428571428571,0.7777777777777778,0.07994782692163396,0.9457530708206303
5,150,4,159,0.03225806451612903,0.9748427672955975,0.07356711086349854,0.9453815220024933
14,102,15,131,0.1206896551724138,0.8854961832061069,0.0789932377570872,0.9371292036965775
28,70,25,123,0.2857142857142857,0.7967479674796748,0.11415185565969378,0.910867124154839
11,87,2,100,0.11224489795918367,0.98,0.10319539934444878,0.9118536712400409
5,59,1,65,0.078125,0.9846153846153847,0.10336710264115208,0.9114641873062531
4,103,12,119,0.037383177570093455,0.8991596638655462,0.10030419523519905,0.8998056777485839
10,36,1,47,0.21739130434782608,0.9787234042553191,0.12625805503999055,0.9285121958168041
15,84,1,100,0.15151515151515152,0.99,0.1432947817541366,0.9306775147745759
2,22,4,28,0.08333333333333333,0.8571428571428571,0.13795816434855365,0.926627039622683
7,59,12,78,0.10606060606060606,0.8461538461538461,0.11229335296945657,0.9336850222904217
16,34,1,51,0.32,0.9803921568627451,0.14197265326100178,0.9337410446993852
0,1,59,60,0.0,0.016666666666666666,0.1308119389752875,0.795462656420997
5,162,13,180,0.029940119760479042,0.9277777777777778,0.12974864500248545,0.7995509584084587
19,167,13,199,0.10215053763440861,0.9346733668341709,0.11328567832914009,0.7932580959197233
31,91,13,135,0.2540983606557377,0.9037037037037037,0.12794042249208096,0.7809300535916809
1,53,7,61,0.018518518518518517,0.8852459016393442,0.11868116323282171,0.7849447742340363
28,172,6,206,0.14,0.970873786407767,0.12352964808130655,0.802761908556025
0,13,52,65,0.0,0.2,0.07781536236702083,0.69127731471849
5,7,2,14,0.4166666666666667,0.8571428571428571,0.13733917189083036,0.8113453419293742
18,45,5,68,0.2857142857142857,0.9264705882352942,0.1738783384556599,0.8111586005661623
1,59,3,63,0.016666666666666666,0.9523809523809523,0.16166635688883962,0.8136882556442739
29,82,32,143,0.26126126126126126,0.7762237762237763,0.1626896284039144,0.7954768374328557
118,401,67,586,0.22736030828516376,0.8856655290102389,0.1925241697991494,0.7955367842001265
1,43,9,53,0.022727272727272728,0.8301886792452831,0.17577092304590267,0.775438911748343
17,57,20,94,0.22972972972972974,0.7872340425531915,0.2085894558644355,0.8593294892559417
2,0,0,2,1.0,1.0,0.2919227891977688,0.8797376525212479
1,15,1,17,0.0625,0.9411764705882353,0.26003503409572803,0.8818384928573824
8,84,2,94,0.08695652173913043,0.9787234042553191,0.27007644196322284,0.8856017002680062
11,110,21,142,0.09090909090909091,0.852112676056338,0.2457404176271985,0.896442971672658
12,42,4,58,0.2222222222222222,0.9310344827586207,0.24500640533249257,0.9029242507795695
3,24,2,29,0.1111111111111111,0.9310344827586207,0.2576326679587552,0.9173307941386177
1,20,1,22,0.047619047619047616,0.9545454545454546,0.22419161345027508,0.9428558630443062
28,62,17,107,0.3111111111111111,0.8411214953271028,0.1257789150375767,0.920158933805321
18,70,2,90,0.20454545454545456,0.9777777777777777,0.1460711228297845,0.9253876919752556
28,71,3,102,0.2828282828282828,0.9705882352941176,0.17399250026572505,0.9239070997383608
75,263,37,375,0.22189349112426035,0.9013333333333333,0.19444297650057438,0.9309048626018955
6,70,20,96,0.07894736842105263,0.7916666666666666,0.17862757593018289,0.910359547701742
4,28,1,33,0.125,0.9696969696969697,0.18170639366417302,0.9152471332344888
0,12,2,14,0.0,0.8571428571428571,0.17490367257573766,0.9013324764626891
0,8,2,10,0.0,0.8,0.13045922813129324,0.8954579771302458
5,165,58,228,0.029411764705882353,0.7456140350877193,0.1054401295827829,0.8622917281745232
27,100,24,151,0.2125984251968504,0.8410596026490066,0.09540729277829255,0.8437876377966502
3,17,4,24,0.15,0.8333333333333334,0.08513679404625536,0.8340733520823645
1,26,95,122,0.037037037037037035,0.22131147540983606,0.07914960384853884,0.7525940390456745
3,36,10,49,0.07692307692307693,0.7959183673469388,0.07228147198040698,0.7277685244242414
9,155,22,186,0.054878048780487805,0.8817204301075269,0.08012119323476238,0.7312796062763373
11,121,3,135,0.08333333333333333,0.9777777777777777,0.09202595513952429,0.7566764316731626
11,123,7,141,0.08208955223880597,0.950354609929078,0.09955135335851337,0.7859250852219282
4,97,2,103,0.039603960396039604,0.9805825242718447,0.07483785838696898,0.8058569311680479
41,176,6,223,0.1889400921658986,0.9730941704035875,0.08040072869638305,0.8258227650352269
6,72,1,79,0.07692307692307693,0.9873417721518988,0.08609873439438875,0.9352556645698072
3,48,1,52,0.058823529411764705,0.9807692307692307,0.08351308474991558,0.9616629307729918
1,27,8,36,0.03571428571428571,0.7777777777777778,0.0807754043118867,0.9468139804401706
6,149,4,159,0.03870967741935484,0.9748427672955975,0.07440059632417549,0.9463946932284306
14,102,15,131,0.1206896551724138,0.8854961832061069,0.07991489674326233,0.9371292036965775
26,71,26,123,0.26804123711340205,0.7886178861788617,0.11254879341717125,0.9097056839690085
10,88,2,100,0.10204081632653061,0.98,0.10013461115440439,0.9106922310542104
5,59,1,65,0.078125,0.9846153846153847,0.1003063144511077,0.9103027471204227
4,103,12,119,0.037383177570093455,0.8991596638655462,0.09724340704515466,0.8986442375627535
1,22,1,24,0.043478260869565216,0.9583333333333334,0.09835254635305173,0.9244378883564043
14,85,1,100,0.1414141414141414,0.99,0.11302461263802124,0.926603207314176
3,21,4,28,0.125,0.8571428571428571,0.11364037618481927,0.9225527321622832
8,58,12,78,0.12121212121212122,0.8461538461538461,0.092664788198922,0.9307721550158524
16,34,1,51,0.32,0.9803921568627451,0.12380181443798907,0.930828177424816
0,1,59,60,0.0,0.016666666666666666,0.11264110015227478,0.7925497891464277
5,166,9,180,0.029239766081871343,0.95,0.11147775565395733,0.7998126943084924
19,167,13,199,0.10215053763440861,0.9346733668341709,0.11985950947750638,0.7964326990943265
30,95,12,137,0.24,0.9124087591240876,0.13394320356120046,0.7853482361120533
2,52,7,61,0.037037037037037035,0.8852459016393442,0.12137706599506291,0.7893629567544086
29,172,6,207,0.14427860696517414,0.9710144927536232,0.12467227824549905,0.807200191982948
0,13,52,65,0.0,0.2,0.07895799253121331,0.6957155981454131
5,8,1,14,0.38461538461538464,0.9285714285714286,0.13390304747626827,0.8259877069889505
18,45,5,68,0.2857142857142857,0.9264705882352942,0.1705422645666132,0.8226263624511354
1,59,3,63,0.016666666666666666,0.9523809523809523,0.15833028299979293,0.825156017529247
29,82,32,143,0.26126126126126126,0.7762237762237763,0.16136760603711592,0.8057010199720597
119,398,69,586,0.23017408123791103,0.8822525597269625,0.18895861235152653,0.8052733996988622
1,43,9,53,0.022727272727272728,0.8301886792452831,0.1715941360318263,0.785155426340528
17,57,20,94,0.22972972972972974,0.7872340425531915,0.2044126688503591,0.8690460038481268
2,0,0,2,1.0,1.0,0.29232475676244707,0.8792500854807798
1,15,1,17,0.0625,0.9411764705882353,0.26043700166040623,0.8813509258169143
9,83,2,94,0.09782608695652174,0.9787234042553191,0.2720312045589569,0.8851141332275382
10,109,23,142,0.08403361344537816,0.8380281690140845,0.2467129691566879,0.8939433321975822
12,42,4,58,0.2222222222222222,0.9310344827586207,0.24557698929730382,0.900912178344962
3,24,2,29,0.1111111111111111,0.9310344827586207,0.25820325192356647,0.9153187217040101
1,22,1,24,0.043478260869565216,0.9583333333333334,0.22386576665245506,0.9430897689233735
28,72,17,117,0.28,0.8547008547008547,0.1210086237953122,0.9223327481663527
16,91,2,109,0.14953271028037382,0.981651376146789,0.1334418681210799,0.9281148775318604
26,96,3,125,0.21311475409836064,0.976,0.1527911325761855,0.9274073945386633
73,307,35,415,0.19210526315789472,0.9156626506024096,0.16786128828040667,0.9364522027263515
6,80,20,106,0.06976744186046512,0.8113207547169812,0.15073446962993126,0.9187146146905285
4,35,1,40,0.10256410256410256,0.975,0.1500803618329663,0.9246669956429096
0,12,2,14,0.0,0.8571428571428571,0.14386918170874272,0.9102112133299843
1,13,2,16,0.07142857142857142,0.875,0.11407326334139578,0.9131110912298623
6,203,59,268,0.028708133971291867,0.7798507462686567,0.0968126095829555,0.8842824298187004
28,117,24,169,0.19310344827586207,0.8579881656804734,0.09395385160831284,0.8674235963444824
1,21,4,26,0.045454545454545456,0.8461538461538461,0.07300374907926295,0.8574937671375448
0,26,100,126,0.0,0.20634920634920634,0.06303697167062507,0.7710692602278628
4,39,10,53,0.09302325581395349,0.8113207547169812,0.06167399356346092,0.7476865109017171
12,168,25,205,0.06666666666666667,0.8780487804878049,0.07119780308727044,0.7506730713795668
9,155,3,167,0.054878048780487805,0.9820359281437125,0.06883344270897278,0.7659639182572401
12,131,7,150,0.08391608391608392,0.9533333333333334,0.07672029270108593,0.7907471449807654
4,109,2,115,0.035398230088495575,0.9826086956521739,0.05419097581717643,0.8085500778338653
41,176,6,223,0.1889400921658986,0.9730941704035875,0.07468891106165544,0.8266844098695427
10,90,1,101,0.1,0.9900990099009901,0.08897462534736975,0.9386486675197975
2,53,5,60,0.03636363636363636,0.9166666666666666,0.08088039399732445,0.9536980835126097
1,29,9,39,0.03333333333333333,0.7692307692307693,0.07611848923541967,0.9381526533330332
6,154,4,164,0.0375,0.975609756097561,0.07363591083820713,0.9372346287550115
15,110,15,140,0.12,0.8928571428571429,0.07879075599305228,0.9285951729726987
27,89,24,140,0.23275862068965517,0.8285714285714286,0.10698509750750365,0.9065898491040206
10,96,2,108,0.09433962264150944,0.9814814814814815,0.09347074471830519,0.9077880364008627
6,59,2,67,0.09230769230769231,0.9701492537313433,0.09237184361940409,0.9049380712337703
4,116,12,132,0.03333333333333333,0.9090909090909091,0.09193894318650365,0.9038558201515193
1,22,1,24,0.043478260869565216,0.9583333333333334,0.09338821854882251,0.9308704721661714
13,87,1,101,0.13,0.9900990099009901,0.10660250426310822,0.9329403655666612
3,23,4,30,0.11538461538461539,0.8666666666666667,0.10594316360376756,0.9291988689680216
8,77,11,96,0.09411764705882353,0.8854166666666666,0.08613731022793447,0.9373196172673415
14,40,2,56,0.25925925925925924,0.9642857142857143,0.10969725831618446,0.9348630790965176
0,4,59,63,0.0,0.06349206349206349,0.09651044512937126,0.8053406233480489
5,195,9,209,0.025,0.9569377990430622,0.09531996893889508,0.8121758933412137
20,202,13,235,0.09009009009009009,0.9446808510638298,0.10197880168468433,0.8102255387312846
32,106,13,151,0.2318840579710145,0.9139072847682119,0.11653366710911497,0.7993410065694592
3,53,7,63,0.05357142857142857,0.8888888888888888,0.10770321185008828,0.8025156097440623
32,190,6,228,0.14414414414414414,0.9736842105263158,0.11484985429084839,0.8151252588668694
0,9,56,65,0.0,0.13846153846153847,0.07781281725381135,0.6971503766062728
5,9,1,15,0.35714285714285715,0.9333333333333333,0.12883322541707665,0.8214134151550256
19,63,5,87,0.23170731707317074,0.9425287356321839,0.1583628421418153,0.8193549775249002
0,62,3,65,0.0,0.9538461538461539,0.14549282927180246,0.8206643064938036
29,83,32,144,0.25892857142857145,0.7777777777777778,0.1493563311943106,0.8012172340665987
120,413,66,599,0.225140712945591,0.8898163606010017,0.1738662289620481,0.801349730025472
1,50,9,60,0.0196078431372549,0.85,0.15607532881820677,0.7836805570931411
18,68,20,106,0.20930232558139536,0.8113207547169812,0.1859756610441204,0.8798033022724903
2,0,0,2,1.0,1.0,0.27781239573799793,0.8893271117962998
1,15,1,17,0.0625,0.9411764705882353,0.25363992187040213,0.8891339310757356
9,94,2,105,0.08737864077669903,0.9809523809523809,0.266122584838502,0.8930062492337679
10,117,22,149,0.07874015748031496,0.8523489932885906,0.24038138284589392,0.903659280021027
11,47,4,62,0.1896551724137931,0.9354838709677419,0.2353120199127799,0.9101832100734184
3,26,2,31,0.10344827586206896,0.9354838709677419,0.24728922458775338,0.9223951916402388
1,22,1,24,0.043478260869565216,0.9583333333333334,0.23048970849568048,0.9430897689233735
28,72,17,117,0.28,0.8547008547008547,0.12763256563853762,0.9223327481663527
15,92,2,109,0.14018691588785046,0.981651376146789,0.1387306964796591,0.9281148775318604
26,96,3,125,0.21311475409836064,0.976,0.15391907327873144,0.9274073945386633
72,307,36,415,0.18997361477572558,0.9132530120481928,0.16868470778549988,0.9361079686471777
8,78,20,106,0.09302325581395349,0.8113207547169812,0.15241709408404497,0.9183703806113547
4,35,1,40,0.10256410256410256,0.975,0.15176298628708002,0.9243227615637357
0,12,2,14,0.0,0.8571428571428571,0.14555180616285643,0.9098669792508105
1,13,2,16,0.07142857142857142,0.875,0.1157558877955095,0.9127668571506885
8,201,59,268,0.03827751196172249,0.7798507462686567,0.10119740152034835,0.8839381957395266
28,117,24,169,0.19310344827586207,0.8579881656804734,0.09833864354570568,0.8670793622653086
1,21,4,26,0.045454545454545456,0.8461538461538461,0.07769306221410853,0.8574937671375448
0,24,102,126,0.0,0.19047619047619047,0.06440402566925804,0.7688016865317175
4,39,10,53,0.09302325581395349,0.8113207547169812,0.06304104756209387,0.745418937205572
12,168,25,205,0.06666666666666667,0.8780487804878049,0.0725648570859034,0.7484054976834217
10,153,4,167,0.06134969325153374,0.9760479041916168,0.07112501734632659,0.7628409125679384
12,131,7,150,0.08391608391608392,0.9533333333333334,0.07764481333980679,0.7876241392914637
5,108,2,115,0.04424778761061947,0.9826086956521739,0.05637971895905785,0.8054270721445638
41,176,6,223,0.1889400921658986,0.9730941704035875,0.07687765420353687,0.823561404180241
10,90,1,101,0.1,0.9900990099009901,0.09116336848925115,0.937793235526641
3,57,1,61,0.05,0.9836065573770492,0.08501718908725782,0.9624054930495077
1,29,9,39,0.03333333333333333,0.7692307692307693,0.08025528432535305,0.9468600628699313
6,154,4,164,0.0375,0.975609756097561,0.07684818528941964,0.9467974702850661
13,112,15,140,0.104,0.8928571428571429,0.07971731615855052,0.9381580145027533
28,87,25,140,0.24347826086956523,0.8214285714285714,0.1081788123383999,0.91513228247081
10,96,2,108,0.09433962264150944,0.9814814814814815,0.09466445954920145,0.916330469767652
6,59,2,67,0.09230769230769231,0.9701492537313433,0.09356555845030036,0.9134805046005595
4,116,12,132,0.03333333333333333,0.9090909090909091,0.09118460606934797,0.9028354119882539
0,22,1,23,0.0,0.9565217391304348,0.08642270130744321,0.9295912648310634
14,86,1,101,0.14,0.9900990099009901,0.10106555845030037,0.9316611582315533
3,23,4,30,0.11538461538461539,0.8666666666666667,0.102691932076674,0.9279196616329137
8,76,12,96,0.09523809523809523,0.875,0.08151476555789257,0.9355727228574036
16,38,2,56,0.2962962962962963,0.9642857142857143,0.11036571893714783,0.9331161846865796
0,4,59,63,0.0,0.06349206349206349,0.09717890575033464,0.803593728938111
5,195,9,209,0.025,0.9569377990430622,0.09598842955985845,0.810428998931276
20,202,13,235,0.09009009009009009,0.9446808510638298,0.10885844242987132,0.8087374434931893
31,107,13,151,0.2246376811594203,0.9139072847682119,0.12094953973835994,0.7978529113313639
4,53,7,64,0.07017543859649122,0.890625,0.11449108591148505,0.801275530378983
30,192,6,228,0.13513513513513514,0.9736842105263158,0.12019066303963359,0.8153732747398852
0,8,57,65,0.0,0.12307692307692308,0.07786262071159127,0.6952005902814865
5,8,2,15,0.38461538461538464,0.8666666666666667,0.13280767565664622,0.8099398193064299
19,63,5,87,0.23170731707317074,0.9425287356321839,0.1623372923813849,0.8078813816763043
0,62,3,65,0.0,0.9538461538461539,0.14946727951137204,0.8091907106452078
29,83,32,144,0.25892857142857145,0.7777777777777778,0.15436597812125077,0.7897436382180028
118,413,68,599,0.2222222222222222,0.8864774624373957,0.17608694721064092,0.7891511328519165
1,50,9,60,0.0196078431372549,0.85,0.1595830483538009,0.7714819599195858
18,68,20,106,0.20930232558139536,0.8113207547169812,0.1894833805797145,0.8698025072967369
2,0,0,2,1.0,1.0,0.2773954684918024,0.8888501263443559
1,15,1,17,0.0625,0.9411764705882353,0.2532229946242066,0.8886569456237918
8,95,2,105,0.07766990291262135,0.9809523809523809,0.26431869504029537,0.8925292637818243
11,116,22,149,0.08661417322834646,0.8523489932885906,0.2397023524402632,0.9031822945690832
11,47,4,62,0.1896551724137931,0.9354838709677419,0.23504991675334477,0.9101832100734184
3,25,2,30,0.10714285714285714,0.9333333333333333,0.2475549187541451,0.9220879719781804
1,22,1,24,0.043478260869565216,0.9583333333333334,0.22375287098871838,0.9411722233816668
28,71,18,117,0.2828282828282828,0.8461538461538461,0.1212997685356159,0.9191942014036449
23,84,2,109,0.21495327102803738,0.981651376146789,0.14307880725390695,0.9249763307691525
27,95,3,125,0.22131147540983606,0.976,0.1663729570003884,0.9242688477759554
73,305,37,415,0.1931216931216931,0.9108433734939759,0.18139034173205884,0.9345427333470028
7,79,20,106,0.08139534883720931,0.8113207547169812,0.1634615984624976,0.9168051453111797
4,35,1,40,0.10256410256410256,0.975,0.16280749066553266,0.9227575262635607
0,12,2,14,0.0,0.8571428571428571,0.15659631054130907,0.9083017439506355
1,13,2,16,0.07142857142857142,0.875,0.12639635176992173,0.9124226230715146
7,203,58,268,0.03333333333333333,0.7835820895522388,0.10045064638496401,0.8841270107008646
28,117,24,169,0.19310344827586207,0.8579881656804734,0.0964209282229677,0.8672681772266465
2,20,4,26,0.09090909090909091,0.8461538461538461,0.08181912790688169,0.8580268161780565
1,32,93,126,0.030303030303030304,0.2619047619047619,0.07452022525914183,0.7795388172048824
4,39,10,53,0.09302325581395349,0.8113207547169812,0.07315724715197769,0.7561560678787368
12,170,23,205,0.06593406593406594,0.8878048780487805,0.08257639942827281,0.760536356579583
9,155,3,167,0.054878048780487805,0.9820359281437125,0.08021203904997516,0.7758272034572562
13,130,7,150,0.09090909090909091,0.9533333333333334,0.08843714727508337,0.8000773811402697
4,109,2,115,0.035398230088495575,0.9826086956521739,0.06590783039117389,0.8178803139933698
41,176,6,223,0.1889400921658986,0.9730941704035875,0.0799122591421464,0.8360146460290471
10,90,1,101,0.1,0.9900990099009901,0.08986896909885636,0.940042395742794
3,53,5,61,0.05357142857142857,0.9180327868852459,0.08423299377849566,0.9552869717668319
1,29,9,39,0.03333333333333333,0.7692307692307693,0.07957574626410528,0.9383478133642589
6,154,4,164,0.0375,0.975609756097561,0.07709316786689273,0.9374297887862372
14,111,15,140,0.112,0.8928571428571429,0.08010615487987975,0.9287903330039242
29,86,25,140,0.25217391304347825,0.8214285714285714,0.11107410958773442,0.9057646009719811
11,95,2,108,0.10377358490566038,0.9814814814814815,0.09890746569341467,0.9069627882688229
6,60,1,67,0.09090909090909091,0.9850746268656716,0.09760876439471337,0.9062450192637775
4,116,12,132,0.03333333333333333,0.9090909090909091,0.09471760793212834,0.9049676081503009
1,20,1,22,0.047619047619047616,0.9545454545454546,0.09675842425865896,0.9314411346238273
15,85,1,101,0.15,0.9900990099009901,0.11282985283008752,0.9335110280243172
2,24,4,30,0.07692307692307693,0.8666666666666667,0.10781886381909853,0.9297695314256779
8,76,12,96,0.09523809523809523,0.875,0.08539946127547238,0.9374225926501675
18,37,1,56,0.32727272727272727,0.9821428571428571,0.11732791018505337,0.9375170748875069
0,4,59,63,0.0,0.06349206349206349,0.10434089719804038,0.8058624229769914
5,195,9,209,0.025,0.9569377990430622,0.10315042100756419,0.8126976929701561
18,204,13,235,0.08108108108108109,0.9446808510638298,0.10793071150214038,0.8112884639013526
32,106,13,151,0.2318840579710145,0.9139072847682119,0.11962843406942818,0.8004039317395273
4,53,7,64,0.07017543859649122,0.890625,0.11866448573705879,0.8038265507871463
32,190,6,228,0.14414414414414414,0.9736842105263158,0.12565106415220864,0.8179242951480484
0,10,55,65,0.0,0.15384615384615385,0.07889781739896187,0.6995961946770909
5,8,1,14,0.38461538461538464,0.9285714285714286,0.13384287234401684,0.8231789611170003
19,63,5,87,0.23170731707317074,0.9425287356321839,0.1633724890687555,0.8211205234868747
1,61,3,65,0.016129032258064516,0.9538461538461539,0.1540936249511817,0.8224298524557783
29,82,33,144,0.26126126126126126,0.7708333333333334,0.15829036827835982,0.8019907165365098
115,419,65,599,0.2153558052434457,0.8914858096828047,0.17903042065649616,0.802113689348339
1,50,9,60,0.0196078431372549,0.85,0.16123952051265486,0.7844445164160082
18,68,20,106,0.20930232558139536,0.8113207547169812,0.19113985273856846,0.878369459397555
2,0,0,2,1.0,1.0,0.27905194065065636,0.888573541030208
1,15,1,17,0.0625,0.9411764705882353,0.25487946678306056,0.888380360309644
11,92,2,105,0.10679611650485436,0.9809523809523809,0.2678319073897448,0.8922526784676764
11,116,22,149,0.08661417322834646,0.8523489932885906,0.24288232338504273,0.9038977727469988
12,46,4,62,0.20689655172413793,0.9354838709677419,0.24167385859657017,0.9101832100734184
3,25,2,30,0.10714285714285714,0.9333333333333333,0.2541788605973705,0.9220879719781804
1,22,1,24,0.043478260869565216,0.9583333333333334,0.22873518721618022,0.9440485416942268
28,72,17,117,0.28,0.8547008547008547,0.12587804435903735,0.9232915209372061
19,88,2,109,0.17757009345794392,0.981651376146789,0.14231662913874363,0.9290736503027137
29,93,3,125,0.23770491803278687,0.976,0.16379181160389905,0.9283661673095164
75,301,40,416,0.19946808510638298,0.9038461538461539,0.17889439519052516,0.9347641317611722
8,78,20,106,0.09302325581395349,0.8113207547169812,0.16262678148907028,0.9170265437253492
4,35,1,40,0.10256410256410256,0.975,0.1619726736921053,0.9229789246777302
0,12,2,14,0.0,0.8571428571428571,0.15576149356788171,0.908523142364805
1,13,2,16,0.07142857142857142,0.875,0.12596557520053478,0.9114230202646828
7,204,57,268,0.03317535545023697,0.7873134328358209,0.10533775548514808,0.8836604569345445
30,115,24,169,0.20689655172413793,0.8579881656804734,0.10093656029819822,0.8668016234603265
2,20,4,26,0.09090909090909091,0.8461538461538461,0.08542813255572793,0.8585598652185682
1,30,95,126,0.03225806451612903,0.24603174603174602,0.07674739094175301,0.7778042925492489
4,39,10,53,0.09302325581395349,0.8113207547169812,0.07538441283458885,0.7544215432231034
9,171,25,205,0.05,0.8780487804878049,0.082527269977446,0.7574081037009531
11,153,3,167,0.06707317073170732,0.9820359281437125,0.08190506987789399,0.7726989505786264
11,132,7,150,0.07692307692307693,0.9533333333333334,0.08815474437401398,0.7964160792211281
4,109,2,115,0.035398230088495575,0.9826086956521739,0.06365498414035078,0.8142190120742282
41,176,6,223,0.1889400921658986,0.9730941704035875,0.0776594128913233,0.8323533441099055
10,90,1,101,0.1,0.9900990099009901,0.08733683224616204,0.9386486675197975
3,53,5,61,0.05357142857142857,0.9180327868852459,0.08170085692580131,0.9538932435438353
1,29,9,39,0.03333333333333333,0.7692307692307693,0.07931990454484894,0.9383478133642588
6,154,4,164,0.0375,0.975609756097561,0.07509516586889076,0.9374297887862372
13,102,25,140,0.11304347826086956,0.8214285714285714,0.08025522320286113,0.9185862513712711
30,84,26,140,0.2631578947368421,0.8142857142857143,0.11279231815262492,0.8945401111760626
12,94,2,108,0.11320754716981132,0.9814814814814815,0.10197338315318387,0.8957382984729046
5,61,1,67,0.07575757575757576,0.9850746268656716,0.09851017968998041,0.8950205294678591
4,116,12,132,0.03333333333333333,0.9090909090909091,0.09561902322739536,0.8937431183543826
1,22,1,24,0.043478260869565216,0.9583333333333334,0.09706829858971422,0.9207577703690345
15,85,1,101,0.15,0.9900990099009901,0.1131397271611428,0.9228276637695244
3,23,4,30,0.11538461538461539,0.8666666666666667,0.1134741753216779,0.9292902488035379
8,77,11,96,0.09411764705882353,0.8854166666666666,0.08932556851053239,0.9394518134293882
16,39,1,56,0.2909090909090909,0.9821428571428571,0.11471150333042947,0.9395462956667276
0,4,59,63,0.0,0.06349206349206349,0.10388899250791865,0.8078916437562123
4,196,9,209,0.02,0.9569377990430622,0.10198423060315676,0.8147269137493769
17,205,13,235,0.07657657657657657,0.9446808510638298,0.10671256141844408,0.8127765591394479
30,107,14,151,0.21897810218978103,0.9072847682119205,0.11656657601698421,0.8009459531838665
2,55,7,64,0.03508771929824561,0.890625,0.10509559086178855,0.8043685722314855
32,190,6,228,0.14414414414414414,0.9736842105263158,0.11224223330254865,0.8169782213542927
0,11,54,65,0.0,0.16923076923076924,0.07068379174410709,0.7008479230811372
4,9,2,15,0.3076923076923077,0.8666666666666667,0.11463983570015104,0.8155871521060805
19,63,5,87,0.23170731707317074,0.9425287356321839,0.14488373813917543,0.813528714475955
1,61,3,65,0.016129032258064516,0.9538461538461539,0.13624837466510228,0.8148380434448584
29,83,32,144,0.25892857142857145,0.7777777777777778,0.14195558455635807,0.7963370448114094
121,470,8,599,0.20473773265651438,0.986644407345576,0.16619130075039643,0.8100541030036347
1,50,9,60,0.0196078431372549,0.85,0.14840040060655516,0.7923849300713037
16,70,20,106,0.18604651162790697,0.8113207547169812,0.17497847369625613,0.8841120708550483
2,0,0,2,1.0,1.0,0.273879572597355,0.9031596899026674
1,15,1,17,0.0625,0.9411764705882353,0.2497070987297592,0.9029665091821034
6,97,2,105,0.05825242718446602,0.9809523809523809,0.255724726576388,0.9068388273401357
11,114,24,149,0.088,0.8389261744966443,0.23130635922944925,0.9155743125856881
12,46,4,62,0.20689655172413793,0.9354838709677419,0.23161476195339545,0.9082656645317118
3,25,2,30,0.10714285714285714,0.9333333333333333,0.2441197639541958,0.9201704264364737
1,22,1,24,0.043478260869565216,0.9583333333333334,0.2289625842425296,0.9394416075266793
28,75,14,117,0.27184466019417475,0.8803418803418803,0.12494039284169746,0.9223475904326621
16,91,2,109,0.14953271028037382,0.981651376146789,0.13737363716746515,0.9281297197981697
27,95,3,125,0.22131147540983606,0.976,0.1551646774333864,0.9277086671665907
71,303,42,416,0.18983957219251338,0.8990384615384616,0.16787885401310923,0.9364244232415018
7,79,20,106,0.08139534883720931,0.8113207547169812,0.14776072924382166,0.9193224620926962
4,35,1,40,0.10256410256410256,0.975,0.15142373290682534,0.9259551151539206
0,13,1,14,0.0,0.9285714285714286,0.14521255278260176,0.9217034144736485
1,14,1,16,0.06666666666666667,0.9375,0.11590141085010057,0.9298688601390942
8,201,59,268,0.03827751196172249,0.7798507462686567,0.10000781109029323,0.9010401987279323
29,116,24,169,0.2,0.8579881656804734,0.0969633146031738,0.8841813652537143
2,24,0,26,0.07692307692307693,1.0,0.08083238670754003,0.8986044421767913
1,55,70,126,0.017857142857142856,0.4444444444444444,0.07175550013895911,0.846193540709286
4,46,3,53,0.08,0.9433962264150944,0.06853205691551588,0.8416787159114424
9,174,22,205,0.04918032786885246,0.8926829268292683,0.07555781803963765,0.8365517870911338
9,154,3,166,0.05521472392638037,0.9819277108433735,0.07392182621959675,0.8428986029259014
11,131,8,150,0.07746478873239436,0.9466666666666667,0.07952000861540702,0.8667294486970457
4,109,2,115,0.035398230088495575,0.9826086956521739,0.056005470056620675,0.8845323815501457
41,176,6,223,0.1889400921658986,0.9730941704035875,0.0720079008055952,0.8806886916078012
10,90,1,101,0.1,0.9900990099009901,0.08374259468314624,0.958639343815879
3,57,1,61,0.05,0.9836065573770492,0.07945688039743193,0.964383676810444
1,29,9,39,0.03333333333333333,0.7692307692307693,0.07719302403521491,0.9467476542963728
6,154,4,164,0.0375,0.975609756097561,0.07466234918858916,0.9458450893326853
15,111,14,140,0.11904761904761904,0.9,0.08060275351933553,0.9391784226660186
28,89,23,140,0.23931623931623933,0.8357142857142857,0.10973389769472751,0.9181935069606061
12,94,2,108,0.11320754716981132,0.9814814814814815,0.09891496269528645,0.9193916942574479
4,62,1,67,0.06060606060606061,0.9850746268656716,0.09328725706758083,0.9186739252524025
3,117,12,132,0.025,0.9090909090909091,0.08971582849615227,0.9080288326400968
1,22,1,24,0.043478260869565216,0.9583333333333334,0.09116510385847111,0.9350434846547487
15,85,1,101,0.15,0.9900990099009901,0.10723653242989968,0.9371133780552386
4,22,4,30,0.15384615384615385,0.8666666666666667,0.11220775168683324,0.932351473293334
6,84,6,96,0.06666666666666667,0.9375,0.08754352702260856,0.9468922896198644
16,39,1,56,0.2909090909090909,0.9821428571428571,0.11292946184250563,0.9469867718572039
0,4,59,63,0.0,0.06349206349206349,0.10427145318449697,0.8153321199466884
5,195,9,209,0.025,0.9569377990430622,0.10427145318449696,0.8221673899398532
16,207,12,235,0.07174887892376682,0.948936170212766,0.10831011290652579,0.8208249380654864
34,107,10,151,0.24113475177304963,0.9337748344370861,0.12132936315981858,0.8127786272849287
4,53,7,64,0.07017543859649122,0.890625,0.10937640383843819,0.8162012463325478
34,188,6,228,0.15315315315315314,0.9736842105263158,0.12173161619365055,0.8213704192648786
6,58,1,65,0.09375,0.9846153846153847,0.09356603177806615,0.8217236374752396
4,9,2,15,0.3076923076923077,0.8666666666666667,0.1375220757341101,0.936462866500183
19,63,5,87,0.23170731707317074,0.9425287356321839,0.1670516924588488,0.9344044288700574
1,61,3,65,0.016129032258064516,0.9538461538461539,0.1591060000780342,0.9351058551033986
29,86,29,144,0.25217391304347825,0.7986111111111112,0.16068302311666685,0.9157967517711165
121,464,11,596,0.20683760683760682,0.9815436241610739,0.18020619000825477,0.9287851266512698
1,50,9,60,0.0196078431372549,0.85,0.16112828857741215,0.911115953718939
17,69,20,106,0.19767441860465115,0.8113207547169812,0.17597463409236233,0.8863595780191671
2,0,0,2,1.0,1.0,0.27487573299346124,0.9054071970667862
1,15,1,17,0.0625,0.9411764705882353,0.25070325912586544,0.9052140163462221
9,94,2,105,0.08737864077669903,0.9809523809523809,0.2608817746285275,0.9090863345042546
12,116,21,149,0.09375,0.8590604026845637,0.23824978705088773,0.9177219475861762
12,46,4,62,0.20689655172413793,0.9354838709677419,0.2382582077489636,0.9111419828442717
3,25,2,30,0.10714285714285714,0.9333333333333333,0.25076320974976396,0.9230467447490336
1,20,1,22,0.047619047619047616,0.9545454545454546,0.22601617671493482,0.9408805595393421
27,63,17,107,0.3,0.8411214953271028,0.12601617671493479,0.9181836303003568
19,69,2,90,0.2159090909090909,0.9777777777777777,0.14793176113051923,0.9234123884702915
28,71,3,102,0.2828282828282828,0.9705882352941176,0.18212462141033603,0.9222502214758341
68,265,47,380,0.2042042042042042,0.8763157894736842,0.1983096375953522,0.9257078091068837
5,70,20,95,0.06666666666666667,0.7894736842105263,0.17608741537312997,0.9054848378857273
4,28,1,33,0.125,0.9696969696969697,0.17746104174675634,0.9113599151893761
0,12,2,14,0.0,0.8571428571428571,0.17065832065832096,0.8974452584175764
1,7,2,10,0.125,0.8,0.145658320658321,0.8915707590851332
6,162,59,227,0.03571428571428571,0.7400881057268722,0.11991620563049166,0.8576150916492896
27,105,24,156,0.20454545454545456,0.8461538461538461,0.10873294444723047,0.8398387503435364
1,19,4,24,0.05,0.8333333333333334,0.08670377241805845,0.8336983994663434
1,28,93,122,0.034482758620689655,0.23770491803278687,0.08210607126863316,0.7548742900123806
3,35,10,48,0.07894736842105263,0.7916666666666666,0.07552712390021211,0.7294413895794801
9,155,22,186,0.054878048780487805,0.8817204301075269,0.0833668451545675,0.7329524714315758
8,125,3,136,0.06015037593984962,0.9779411764705882,0.07410261314597459,0.7583726394988027
11,122,8,141,0.08270676691729323,0.9432624113475178,0.08081582474640425,0.7873975403017521
4,97,2,103,0.039603960396039604,0.9805825242718447,0.05725275415363068,0.806601637175752
41,176,6,223,0.1889400921658986,0.9730941704035875,0.07710133874875905,0.826567471042931
6,72,1,79,0.07692307692307693,0.9873417721518988,0.08316424136338582,0.9336584502028041
3,46,4,53,0.061224489795918366,0.9245283018867925,0.0806324015597952,0.9526386838056793
1,27,8,36,0.03571428571428571,0.7777777777777778,0.07789472112176632,0.937789733472858
6,149,4,159,0.03870967741935484,0.9748427672955975,0.07483176419026706,0.9373471035907165
14,102,15,131,0.1206896551724138,0.8854961832061069,0.08025789108385573,0.9290947852848006
26,72,26,124,0.2653061224489796,0.7903225806451613,0.11250105709141858,0.9019147933381316
13,85,2,100,0.1326530612244898,0.98,0.10446005267121734,0.9029013404233334
5,59,1,65,0.078125,0.9846153846153847,0.10463175596792063,0.9025118564895457
3,104,12,119,0.028037383177570093,0.8991596638655462,0.09989074073672802,0.8988877653436534
8,38,1,47,0.17391304347826086,0.9787234042553191,0.1196334204172959,0.9275942834118736
15,84,1,100,0.15151515151515152,0.99,0.13574848814526685,0.9297596023696454
4,20,4,28,0.16666666666666666,0.8571428571428571,0.14231663264444583,0.9257091272177524
7,59,12,78,0.10606060606060606,0.8461538461538461,0.11956727316039246,0.9336850222904217
17,33,1,51,0.34,0.9803921568627451,0.14918826441403676,0.9337410446993853
0,1,59,60,0.0,0.016666666666666666,0.1380275501283225,0.7954626564209971
4,167,9,180,0.023391812865497075,0.95,0.13736389722659778,0.8027255615830619
16,171,13,200,0.0855614973262032,0.935,0.12474224777630381,0.7964793609751591
32,92,12,136,0.25806451612903225,0.9117647058823529,0.13996358557828678,0.7853028903869239
3,52,7,62,0.05454545454545454,0.8870967741935484,0.12394626956097077,0.7895820213941656
27,174,6,207,0.13432835820895522,0.9710144927536232,0.1279845198678778,0.807419256622705
0,12,53,65,0.0,0.18461538461538463,0.07941309129644922,0.6937368605873678
4,8,2,14,0.3333333333333333,0.8571428571428571,0.12703213891549683,0.8138048877982521
18,45,5,68,0.2857142857142857,0.9264705882352942,0.1645067778938952,0.810443543260437
1,59,3,63,0.016666666666666666,0.9523809523809523,0.15466465922824715,0.812926536457716
29,82,32,143,0.26126126126126126,0.7762237762237763,0.15512133710427986,0.7935635465064906
123,449,17,589,0.21503496503496503,0.9711375212224108,0.17804841003135277,0.8055693675106139
1,43,9,53,0.022727272727272728,0.8301886792452831,0.16210539781968383,0.7854513941522797
17,57,20,94,0.22972972972972974,0.7872340425531915,0.19492393063821667,0.8715397738576806
2,0,0,2,1.0,1.0,0.2901620258763119,0.8919479371229867
1,15,1,17,0.0625,0.9411764705882353,0.2582742707742711,0.8940487774591211
9,84,2,95,0.0967741935483871,0.9789473684210527,0.2697182031859454,0.8978439797505641
12,107,23,142,0.10084033613445378,0.8380281690140845,0.24680092816783006,0.9066731787206083
12,42,4,58,0.2222222222222222,0.9310344827586207,0.2478276791945811,0.900944173225781
2,24,2,28,0.07692307692307693,0.9285714285714286,0.2555699369368388,0.9149988517009445
1,21,0,22,0.045454545454545456,1.0,0.22752673043544536,0.9501351508345273
28,63,16,107,0.3076923076923077,0.8504672897196262,0.12862563153434647,0.9287733350801881
15,73,2,90,0.17045454545454544,0.9777777777777777,0.1440477094564244,0.9340020932501227
27,73,3,103,0.27,0.970873786407767,0.1715234376117642,0.9325622940294636
68,273,41,382,0.19941348973607037,0.8926701570680629,0.1867220424577809,0.9372294593249011
7,75,13,95,0.08536585365853659,0.8631578947368421,0.16936051416269501,0.9268971770062012
4,28,1,33,0.125,0.9696969696969697,0.17191153457085825,0.9320919822010064
0,12,2,14,0.0,0.8571428571428571,0.1654180280773518,0.9116838189357003
1,7,2,10,0.125,0.8,0.13931912697845067,0.9044742061186108
30,183,14,227,0.14084507042253522,0.9383259911894273,0.13508920197387778,0.8988382366059893
31,110,15,156,0.2198581560283688,0.9038461538461539,0.12792608140650188,0.8892628605257589
2,18,4,24,0.1,0.8333333333333334,0.11372415430134898,0.8807861714207975
1,29,92,122,0.03333333333333333,0.2459016393442623,0.10629093711203422,0.7926067063647146
3,37,8,48,0.075,0.8333333333333334,0.09914807996917707,0.7731261868841951
8,155,24,187,0.049079754601226995,0.8716577540106952,0.10615947348363808,0.7751997435796006
7,126,2,135,0.05263157894736842,0.9851851851851852,0.09582112761897643,0.8016547700346272
14,123,4,141,0.10218978102189781,0.9716312056737588,0.09029894341888536,0.8064126578181031
4,97,2,103,0.039603960396039604,0.9805825242718447,0.06454834404283834,0.8173749964503446
41,176,6,223,0.1889400921658986,0.9730941704035875,0.07725407149510957,0.8373408303175236
6,72,1,79,0.07692307692307693,0.9873417721518988,0.08348117772221579,0.9432608492900432
5,48,1,54,0.09433962264150944,0.9814814814814815,0.08624398095671713,0.9644248704540644
1,27,8,36,0.03571428571428571,0.7777777777777778,0.08433462825858269,0.9510134452779333
5,150,4,159,0.03225806451612903,0.9748427672955975,0.08142412619697705,0.9495359570079922
15,101,15,131,0.12931034482758622,0.8854961832061069,0.08529849245493253,0.9372309537983277
25,78,20,123,0.24271844660194175,0.8373983739837398,0.11431484762720427,0.9167760751857413
12,86,2,100,0.12244897959183673,0.98,0.10481611725948115,0.9177626222709431
5,59,1,65,0.078125,0.9846153846153847,0.10498782055618446,0.9173731383371554
6,109,4,119,0.05217391304347826,0.9663865546218487,0.09896414775646568,0.9152167202143506
8,38,1,47,0.17391304347826086,0.9787234042553191,0.11870682743703356,0.943923238282571
14,85,1,100,0.1414141414141414,0.99,0.1343005527081782,0.9460885572403426
5,22,1,28,0.18518518518518517,0.9642857142857143,0.1422826727592638,0.9573442045374294
6,60,12,78,0.09090909090909091,0.8461538461538461,0.12059562194599938,0.958594986276016
17,33,1,51,0.34,0.9803921568627451,0.15167433914716555,0.9586510086849795
0,1,59,60,0.0,0.016666666666666666,0.14051362486145128,0.8203726204065912
5,167,9,181,0.029069767441860465,0.9502762430939227,0.13721303263264875,0.8180711473311734
17,169,13,199,0.0913978494623656,0.9346733668341709,0.1254251477732351,0.8117782848424377
30,95,12,137,0.24,0.9124087591240876,0.1395088418569292,0.8006938218601647
1,55,7,63,0.017857142857142856,0.8888888888888888,0.115604835810066,0.7899228468034752
31,170,6,207,0.15422885572139303,0.9710144927536232,0.12465051649753774,0.8077600820320148
0,14,51,65,0.0,0.2153846153846154,0.07607908792610917,0.698473290392282
4,8,2,14,0.3333333333333333,0.8571428571428571,0.12369813554515677,0.8185413176031665
18,48,2,68,0.2727272727272727,0.9705882352941176,0.15850635058592993,0.8214430307746229
1,59,3,63,0.016666666666666666,0.9523809523809523,0.14783046732940155,0.8239726858527344
28,82,32,142,0.2545454545454545,0.7746478873239436,0.14990838940732362,0.8042925613098567
126,452,11,589,0.2179930795847751,0.9813242784380306,0.17849923751127109,0.8174976169597342
1,51,1,53,0.019230769230769232,0.9811320754716981,0.15921379658403909,0.818942985919459
24,61,9,94,0.2823529411764706,0.9042553191489362,0.19954993103782062,0.9173530864572194
2,0,0,2,1.0,1.0,0.2947880262759159,0.9377612497225254
1,15,1,17,0.0625,0.9411764705882353,0.26475555874344836,0.9335595690502564
4,88,2,94,0.043478260869565216,0.9787234042553191,0.26858578648671955,0.9373227764608804
11,110,21,142,0.09090909090909091,0.852112676056338,0.24520916311009616,0.9483891748512223
12,42,4,58,0.2222222222222222,0.9310344827586207,0.2458133263440172,0.9412049183255924
3,23,2,28,0.11538461538461539,0.9285714285714286,0.25954959008028095,0.9336962544826967
1,23,0,24,0.041666666666666664,1.0,0.2284763880443376,0.9491827698821462
29,73,15,117,0.28431372549019607,0.8717948717948718,0.12623549168579415,0.930867751567128
19,89,2,110,0.17592592592592593,0.9818181818181818,0.14243919538949784,0.9366737103142632
26,97,3,126,0.21138211382113822,0.9761904761904762,0.16015397725298916,0.9359934382054197
69,303,42,414,0.18548387096774194,0.8985507246376812,0.1732588159626666,0.9424530655346122
10,83,13,106,0.10752688172043011,0.8773584905660378,0.15906314881927977,0.9341494397629402
4,35,1,40,0.10256410256410256,0.975,0.15840904102231482,0.9401018207153211
0,12,2,14,0.0,0.8571428571428571,0.15245666006993383,0.919693657450015
1,13,2,16,0.07142857142857142,0.875,0.1220444952039875,0.9201515329078903
31,223,15,269,0.1220472440944882,0.9442379182156134,0.11434754065663924,0.9147829238218093
31,124,14,169,0.2,0.9171597633136095,0.11272152439647663,0.9063499648393998
1,21,4,26,0.045454545454545456,0.8461538461538461,0.09271733503744857,0.8988646964845662
2,25,99,126,0.07407407407407407,0.21428571428571427,0.08793836251654055,0.8041400141588058
4,41,8,53,0.08888888888888889,0.8490566037735849,0.0859847605629386,0.786148100412175
11,169,25,205,0.06111111111111111,0.8780487804878049,0.09471491929309735,0.7891346608900246
9,156,2,167,0.05454545454545454,0.9880239520958084,0.09230304545265207,0.8052809397608545
15,132,3,150,0.10204081632653061,0.98,0.08944498434294383,0.8103898085871952
3,112,2,117,0.02608695652173913,0.9829059829059829,0.06460026384604943,0.8197821256718202
41,176,6,223,0.1889400921658986,0.9730941704035875,0.08509819909052845,0.8379164577074975
10,90,1,101,0.1,0.9900990099009901,0.08880190279423215,0.9487469285096797
2,54,5,61,0.03571428571428571,0.9180327868852459,0.08120553091214598,0.9586006689542027
1,29,9,39,0.03333333333333333,0.7692307692307693,0.07723727694389201,0.9430552387746262
6,154,4,164,0.0375,0.975609756097561,0.07480221200882708,0.9412817822034479
14,111,15,140,0.112,0.8928571428571429,0.07622495253360842,0.9288328026116112
25,94,21,140,0.21008403361344538,0.85,0.10251024926099504,0.9098462336250422
11,95,2,108,0.10377358490566038,0.9814814814814815,0.09034360536667528,0.9110444209218842
5,60,2,67,0.07692307692307693,0.9701492537313433,0.087046902069972,0.9081944557547919
6,121,6,133,0.047244094488188976,0.9548872180451128,0.08869401760910102,0.9134593744919156
9,40,1,50,0.1836734693877551,0.98,0.11017117990258986,0.9435692646018057
14,86,1,101,0.14,0.9900990099009901,0.12481403704544701,0.9456391580022956
4,25,1,30,0.13793103448275862,0.9666666666666667,0.12851847054298396,0.9561833756893705
7,77,12,96,0.08333333333333333,0.875,0.11041122764582509,0.959754804260799
12,42,2,56,0.2222222222222222,0.9642857142857143,0.12733246154819106,0.9572982660899753
0,4,59,63,0.0,0.06349206349206349,0.11634345055918006,0.8277758103415066
5,195,9,209,0.025,0.9569377990430622,0.11316572277515306,0.8280687504840708
19,202,13,234,0.08597285067873303,0.9444444444444444,0.09920849153100707,0.8229893854047058
30,108,13,151,0.21739130434782608,0.9139072847682119,0.11026439215212507,0.8121048532428804
3,54,7,64,0.05263157894736842,0.890625,0.09807875564706933,0.8012417580047851
29,194,6,229,0.13004484304932734,0.9737991266375546,0.10475182846363991,0.8153559189530072
0,9,56,65,0.0,0.13846153846153847,0.07300579671760817,0.6973810366924107
5,9,1,15,0.35714285714285715,0.9333333333333333,0.12402620488087346,0.8216440752411636
19,66,2,87,0.2235294117647059,0.9770114942528736,0.1523875494186886,0.8245117459854222
0,62,3,65,0.0,0.9538461538461539,0.140105713607441,0.8258548473285237
28,83,32,143,0.25225225225225223,0.7762237762237763,0.14508584902235902,0.8061857746793184
124,461,11,596,0.21196581196581196,0.9815436241610739,0.1678478823107081,0.8191741495594719
1,58,1,60,0.01694915254237288,0.9833333333333333,0.15169135509542891,0.8205361790874404
26,71,9,106,0.26804123711340205,0.9150943396226415,0.1899829603973435,0.9314837221104549
2,0,0,2,1.0,1.0,0.281819695091221,0.9410075316342645
1,15,1,17,0.0625,0.9411764705882353,0.25881549341054877,0.9358882425393161
8,95,2,105,0.07766990291262135,0.9809523809523809,0.26991119382663753,0.9397605606973486
12,117,21,150,0.09302325581395349,0.86,0.24716419433545198,0.9517285926653807
12,46,4,62,0.20689655172413793,0.9354838709677419,0.24644001430092713,0.9451486279234759
3,25,2,30,0.10714285714285714,0.9333333333333333,0.2593248292438534,0.9380057707806188
1,23,0,24,0.041666666666666664,1.0,0.22016859765332344,0.9494899895442047
29,73,15,117,0.28431372549019607,0.8717948717948718,0.11792770129478003,0.9311749712291862
16,92,2,110,0.14814814814814814,0.9818181818181818,0.13016315103022977,0.9369809299763217
27,96,3,126,0.21951219512195122,0.9761904761904762,0.15458722328759592,0.9363006578674781
71,301,42,414,0.19086021505376344,0.8985507246376812,0.1706922540095621,0.9427602851966705
11,82,13,106,0.11827956989247312,0.8773584905660378,0.15803268517646712,0.9344566594249984
4,35,1,40,0.10256410256410256,0.975,0.1579063747053291,0.940101820715321
0,12,2,14,0.0,0.8571428571428571,0.1519539937529481,0.919693657450015
1,13,2,16,0.07142857142857142,0.875,0.12154182888700173,0.9201515329078905
29,225,15,269,0.1141732283464567,0.9442379182156134,0.11668826891533153,0.9147829238218091
30,124,14,168,0.19480519480519481,0.9166666666666666,0.11315869744150918,0.9062795224612651
1,21,4,26,0.045454545454545456,0.8461538461538461,0.09238645892733519,0.8987942541064314
3,27,96,126,0.1,0.23809523809523808,0.08977509179983902,0.8074709323248886
4,41,8,53,0.08888888888888889,0.8490566037735849,0.08782148984623707,0.789479018578258
10,172,23,205,0.054945054945054944,0.8878048780487805,0.09567078340981636,0.793859307279104
11,155,2,168,0.06626506024096386,0.9880952380952381,0.09493313895444384,0.810015769864138
15,132,3,150,0.10204081632653061,0.98,0.09319993723731154,0.8151246386904791
4,111,2,117,0.034782608695652174,0.9829059829059829,0.07033956779309117,0.8245873981532386
41,176,6,223,0.1889400921658986,0.9730941704035875,0.0908375030375702,0.8427217301889158
10,90,1,101,0.1,0.9900990099009901,0.0908375030375702,0.9501508404468805
2,58,1,61,0.03333333333333333,0.9836065573770492,0.08290099510106226,0.9693722623902324
1,29,9,39,0.03333333333333333,0.7692307692307693,0.07981360629938773,0.9524331039876595
6,154,4,164,0.0375,0.975609756097561,0.07570431197925005,0.950649463702277
13,112,15,140,0.104,0.8928571428571429,0.07598419536117425,0.9382004841104402
25,94,21,140,0.21008403361344538,0.85,0.10102725606371613,0.9192139151238712
11,95,2,108,0.10377358490566038,0.9814814814814815,0.08886061216939636,0.9204121024207134
4,61,2,67,0.06153846153846154,0.9701492537313433,0.08336610667489087,0.917562137253621
6,121,6,133,0.047244094488188976,0.9548872180451128,0.08535335826844169,0.9134593744919156
9,40,1,50,0.1836734693877551,0.98,0.10683052056193051,0.9435692646018058
14,86,2,102,0.14,0.9803921568627451,0.12147337770478765,0.9442524647111179
6,23,1,30,0.20689655172413793,0.9666666666666667,0.13617288509395023,0.9547966823981927
7,77,12,96,0.08333333333333333,0.875,0.11806564219679136,0.9583681109696213
14,40,2,56,0.25925925925925924,0.9642857142857143,0.14027788139016262,0.9559115727987972
0,4,59,63,0.0,0.06349206349206349,0.13148667259895383,0.8263891170503289
5,195,9,209,0.025,0.9569377990430622,0.12830894481492683,0.826682057192893
18,204,13,235,0.08108108108108109,0.9446808510638298,0.11365288934254483,0.8216364644877258
31,106,14,151,0.22627737226277372,0.9072847682119205,0.1259782282372268,0.8111925518233223
4,53,7,64,0.07017543859649122,0.890625,0.10644664064756297,0.800329456585227
27,196,6,229,0.1210762331838565,0.9737991266375546,0.111838483483352,0.8144436175334491
0,9,56,65,0.0,0.13846153846153847,0.07480144644631495,0.6964687352728527
5,9,1,15,0.35714285714285715,0.9333333333333333,0.12582185460958026,0.8207317738216054
19,66,2,87,0.2235294117647059,0.9770114942528736,0.1541831991473954,0.8235994445658642
0,62,3,65,0.0,0.9538461538461539,0.1426001875643838,0.8249087735347677
28,84,32,144,0.25,0.7777777777777778,0.14598913438398758,0.8064077749013187
122,463,11,596,0.20854700854700856,0.9815436241610739,0.16575650151977575,0.819396149781472
1,58,1,60,0.01694915254237288,0.9833333333333333,0.15088120428527807,0.8207581793094405
26,71,9,106,0.26804123711340205,0.9150943396226415,0.18917280958719268,0.9317057223324552
2,0,0,2,1.0,1.0,0.2810095442810702,0.9412295318562648
1,15,1,17,0.0625,0.9411764705882353,0.258005342600398,0.9361102427613164
9,94,2,105,0.08737864077669903,0.9809523809523809,0.27048800556849784,0.9399825609193488
12,116,22,150,0.09375,0.8533333333333334,0.24816657699706926,0.9507762117129995
12,46,4,62,0.20689655172413793,0.9354838709677419,0.24793079745094487,0.944196246971095
3,25,2,30,0.10714285714285714,0.9333333333333333,0.26081561239387124,0.9370533898282379
1,23,0,24,0.041666666666666664,1.0,0.22104966889913405,0.9505625012618777
28,75,14,117,0.27184466019417475,0.8803418803418803,0.11702747749830188,0.9334684841678605
16,92,2,110,0.14814814814814814,0.9818181818181818,0.1292629272337516,0.9392744429149957
26,96,3,125,0.21311475409836064,0.976,0.15130453076040817,0.938593124233677
68,304,42,414,0.1827956989247312,0.8985507246376812,0.166344004914661,0.9441003706104887
10,83,13,106,0.10752688172043011,0.8773584905660378,0.1526492979449404,0.9356504497616459
4,35,1,40,0.10256410256410256,0.975,0.15252298747380233,0.9412956110519686
0,12,2,14,0.0,0.8571428571428571,0.1465706065214214,0.9208874477866624
1,13,2,16,0.07142857142857142,0.875,0.11793973669776377,0.9201243220235368
32,222,15,269,0.12598425196850394,0.9442379182156134,0.11477346581495744,0.9147557129374554
31,122,15,168,0.20261437908496732,0.9107142857142857,0.11327341224161554,0.9054291823252106
1,21,4,26,0.045454545454545456,0.8461538461538461,0.09365324746016043,0.8979439139703771
2,34,90,126,0.05555555555555555,0.2857142857142857,0.08622877229374978,0.8134233132772696
4,41,8,53,0.08888888888888889,0.8490566037735849,0.08427517034014784,0.7954313995306388
9,173,23,205,0.04945054945054945,0.8878048780487805,0.09133953454736919,0.7998116882314851
10,156,2,168,0.060240963855421686,0.9880952380952381,0.08974130489406207,0.8159681508165191
16,131,3,150,0.10884353741496598,0.98,0.08729263138641379,0.82107701964286
4,111,2,117,0.034782608695652174,0.9829059829059829,0.0633166641879402,0.8313901192416739
41,176,6,223,0.1889400921658986,0.9730941704035875,0.08381459943241922,0.8495244512773512
10,90,1,101,0.1,0.9900990099009901,0.09016380578162557,0.9501508404468805
2,58,1,61,0.03333333333333333,0.9836065573770492,0.08222729784511765,0.9693722623902324
1,29,9,39,0.03333333333333333,0.7692307692307693,0.07992483839980105,0.9524331039876595
5,155,4,164,0.03125,0.975609756097561,0.0757832721347408,0.950649463702277
13,102,25,140,0.11304347826086956,0.8214285714285714,0.0763832636841556,0.9279964024777871
25,95,20,140,0.20833333333333334,0.8571428571428571,0.10117622434668148,0.9100302416544835
13,93,2,108,0.12264150943396226,0.9814814814814815,0.09170499824211917,0.9112284289513255
6,60,1,67,0.09090909090909091,0.9850746268656716,0.09040629694341784,0.9105106599462801
5,124,4,133,0.03875968992248062,0.9699248120300752,0.09118149074186746,0.9085561248967123
11,38,1,50,0.22448979591836735,0.98,0.11848955682544375,0.9386660150066024
14,86,2,102,0.14,0.9803921568627451,0.13402527111115803,0.9393492151159144
6,23,1,30,0.20689655172413793,0.9666666666666667,0.1474328530344821,0.9600975144356424
7,78,11,96,0.08235294117647059,0.8854166666666666,0.12943565415493027,0.9641366300819009
18,37,1,56,0.32727272727272727,0.9821428571428571,0.15866868527475386,0.9642311123192402
0,4,59,63,0.0,0.06349206349206349,0.14568167228774084,0.8325764604087247
5,195,9,209,0.025,0.9569377990430622,0.14371600229881507,0.8307211728391515
19,203,13,235,0.08558558558558559,0.9446808510638298,0.12387254367984622,0.8256755801339845
32,106,13,151,0.2318840579710145,0.9139072847682119,0.13699883767570545,0.8161777412633368
4,53,7,64,0.07017543859649122,0.890625,0.11746725008604163,0.8053146460252415
28,195,6,229,0.12556053811659193,0.9737991266375546,0.1236397639346304,0.8179407117353683
0,13,52,65,0.0,0.2,0.07688651718138363,0.7062060178578173
5,9,1,15,0.35714285714285715,0.9333333333333333,0.12790692534464893,0.8304690564065702
19,66,2,87,0.2235294117647059,0.9770114942528736,0.15626826988246406,0.8333367271508288
1,61,3,65,0.016129032258064516,0.9538461538461539,0.14634590512138962,0.8346460561197324
29,83,32,144,0.25892857142857145,0.7777777777777778,0.15020940704389776,0.8151989836925274
122,462,11,595,0.2089041095890411,0.9815126050420168,0.17002778861426204,0.8281829272699585
1,58,1,60,0.01694915254237288,0.9833333333333333,0.1545118763893736,0.8295449567979268
25,72,9,106,0.25773195876288657,0.9150943396226415,0.19133072764121456,0.9317012910297328
2,0,0,2,1.0,1.0,0.2831674623350921,0.9412251005535422
1,15,1,17,0.0625,0.9411764705882353,0.2601632606544198,0.936105811458594
5,98,2,105,0.04854368932038835,0.9809523809523809,0.2647939259490375,0.9399781296166264
10,118,22,150,0.078125,0.8533333333333334,0.23896484431638446,0.9507717804102772
12,46,4,62,0.20689655172413793,0.9354838709677419,0.23867805033568398,0.944196246971095
3,26,2,31,0.10344827586206896,0.9354838709677419,0.2510350679527834,0.9373606094902963
1,23,0,24,0.041666666666666664,1.0,0.22253674628822923,0.9496101203094968
29,77,11,117,0.27358490566037735,0.905982905982906,0.11876316138256884,0.9361791068784833
19,89,2,110,0.17592592592592593,0.9818181818181818,0.13496686508627256,0.9419850656256186
27,95,3,125,0.22131147540983606,0.976,0.1567788685761931,0.9413037469442999
69,300,45,414,0.18699186991869918,0.8913043478260869,0.17233127856457872,0.9467281775861218
11,82,13,106,0.11827956989247312,0.8773584905660378,0.16017266990514992,0.938278256737279
4,35,1,40,0.10256410256410256,0.975,0.16004635943401185,0.9439234180276016
0,12,2,14,0.0,0.8571428571428571,0.15409397848163092,0.9235152547622955
1,13,2,16,0.07142857142857142,0.875,0.1252145021628015,0.9190891253361662
32,226,11,269,0.12403100775193798,0.9591078066914498,0.11780094242366036,0.9158447860323472
33,120,15,168,0.21568627450980393,0.9107142857142857,0.11699734229508434,0.9065182554201022
2,20,4,26,0.09090909090909091,0.8461538461538461,0.10327123100799747,0.9000681837526393
1,33,92,126,0.029411764705882353,0.2698412698412698,0.09057583026705593,0.8132800093633868
4,41,8,53,0.08888888888888889,0.8490566037735849,0.08862222831345397,0.7952880956167562
11,169,25,205,0.06111111111111111,0.8780487804878049,0.09735238704361268,0.7982746560946058
11,155,2,168,0.06626506024096386,0.9880952380952381,0.09661474258824018,0.8144311186796397
17,129,4,150,0.11643835616438356,0.9733333333333334,0.09553007807573241,0.8164633367713375
5,110,2,117,0.043478260869565216,0.9829059829059829,0.07092893326998402,0.8267764363701513
41,176,6,223,0.1889400921658986,0.9730941704035875,0.08493336202095654,0.8449107684058286
10,90,1,101,0.1,0.9900990099009901,0.09501739563440191,0.9478047312715029
3,53,5,61,0.05357142857142857,0.9180327868852459,0.08997204416047902,0.9576584717160259
1,29,9,39,0.03333333333333333,0.7692307692307693,0.08600379019222505,0.9421130415364495
4,156,4,164,0.025,0.975609756097561,0.08010878158637307,0.940329401251067
15,110,15,140,0.12,0.8928571428571429,0.08061758784860398,0.9288328026116112
26,95,19,140,0.21487603305785125,0.8642857142857143,0.10510298387550199,0.9118870499515729
11,95,2,108,0.10377358490566038,0.9814814814814815,0.09293633998118225,0.913085237248415
5,61,1,67,0.07575757575757576,0.9850746268656716,0.08947313651797877,0.9123674682433693
5,124,4,133,0.03875968992248062,0.9699248120300752,0.08735717385384337,0.9197806146926306
10,39,1,50,0.20408163265306123,0.98,0.11174978804237592,0.9498905048025208
15,85,2,102,0.15,0.9803921568627451,0.12960693089951877,0.9505737049118329
5,24,1,30,0.1724137931034483,0.9666666666666667,0.13709461562858283,0.9611179225989076
7,78,11,96,0.08235294117647059,0.8854166666666666,0.11816274535981416,0.9641366300819009
15,40,1,56,0.2727272727272727,0.9821428571428571,0.14229898647718733,0.9642311123192402
0,4,59,63,0.0,0.06349206349206349,0.13147647565467652,0.8325764604087248
5,195,9,209,0.025,0.9569377990430622,0.1295108056657507,0.8307211728391515
18,203,13,234,0.08144796380090498,0.9444444444444444,0.11199171011544269,0.8256418077597864
31,109,11,151,0.22142857142857142,0.9271523178807947,0.12219579174809574,0.8180361164766506
4,53,7,64,0.07017543859649122,0.890625,0.10759031253281615,0.8071730212385554
33,190,6,229,0.14798206278026907,0.9737991266375546,0.11696590133335881,0.8197990869486823
0,10,55,65,0.0,0.15384615384615385,0.07800486237231985,0.7014709864777247
5,9,1,15,0.35714285714285715,0.9333333333333333,0.12902527053558516,0.8257340250264774
18,67,2,87,0.21176470588235294,0.9770114942528736,0.1557059428044927,0.8286016957707363
1,61,3,65,0.016129032258064516,0.9538461538461539,0.14637466686980122,0.8299447971138376
29,83,32,144,0.25892857142857145,0.7777777777777778,0.15173180972694406,0.8086055770991208
126,458,11,595,0.21575342465753425,0.9815126050420168,0.17252866487852164,0.8215895206765518
1,58,1,60,0.01694915254237288,0.9833333333333333,0.15380967770167933,0.8229515502045202
25,72,9,106,0.25773195876288657,0.9150943396226415,0.19062852895352028,0.9317012910297328
2,0,0,2,1.0,1.0,0.2824652636473978,0.9412251005535424
1,15,1,17,0.0625,0.9411764705882353,0.26114173423563314,0.936105811458594
6,96,2,104,0.058823529411764705,0.9807692307692307,0.26724094811473315,0.9399519653047479
10,119,21,150,0.07751937984496124,0.86,0.24132534931707456,0.9516979970507794
12,47,4,63,0.2033898305084746,0.9365079365079365,0.2395591215814946,0.9452687586887681
3,26,2,31,0.10344827586206896,0.9354838709677419,0.251916139198594,0.9384331212079694
2,22,0,24,0.08333333333333333,1.0,0.23424967889253634,0.9480388067421749
29,77,11,117,0.27358490566037735,0.905982905982906,0.13047609398687596,0.9346077933111615
20,88,2,110,0.18518518518518517,0.9818181818181818,0.148002549013331,0.9404137520582967
28,93,3,124,0.23140495867768596,0.9758064516129032,0.17007138926398943,0.9400297274807237
69,305,39,413,0.18449197860962566,0.9055690072639225,0.18333214811298354,0.947816181405965
11,82,13,106,0.11827956989247312,0.8773584905660378,0.16906039835736286,0.9399811957967549
4,35,1,40,0.10256410256410256,0.975,0.16840629056039788,0.9459335767491357
0,13,1,14,0.0,0.9285714285714286,0.15650152865563602,0.9357294951164826
1,14,1,16,0.06666666666666667,0.9375,0.12694178022796304,0.9402319371189246
25,229,15,269,0.0984251968503937,0.9442379182156134,0.1145474961801357,0.9348633280328436
30,122,15,167,0.19736842105263158,0.9101796407185628,0.1096851336622708,0.9254880693336521
2,24,0,26,0.07692307692307693,1.0,0.09431814770704953,0.9389782111530918
0,58,68,126,0.0,0.4603174603174603,0.07742106629383909,0.8794009211175806
6,46,1,53,0.11538461538461539,0.9811320754716981,0.07925256812534094,0.8802769318992519
13,167,24,204,0.07222222222222222,0.8823529411764706,0.08957002844280125,0.8736742908428292
8,158,2,168,0.04819277108433735,0.9880952380952381,0.08693090050246847,0.8809021819992918
14,132,4,150,0.0958904109589041,0.9733333333333334,0.08656878823225568,0.8850586698732518
5,110,2,117,0.043478260869565216,0.9829059829059829,0.06458447963467477,0.8954481473285976
41,176,6,223,0.1889400921658986,0.9730941704035875,0.0805869103836493,0.8916044573862528
10,90,1,101,0.1,0.9900990099009901,0.0948726246693636,0.9672875358981857
3,56,1,60,0.05084745762711865,0.9833333333333333,0.08565303070400691,0.9676020013069906
1,29,9,39,0.03333333333333333,0.7692307692307693,0.08009747514845135,0.9514416910290333
4,156,4,164,0.025,0.975609756097561,0.07678422213640317,0.9496580507436508
13,113,14,140,0.10317460317460317,0.9,0.07782482102436017,0.9391818602674604
27,93,20,140,0.225,0.8571428571428571,0.10375649804299372,0.9212156994441567
12,94,2,108,0.11320754716981132,0.9814814814814815,0.09293756304355269,0.9224138867409988
5,61,1,67,0.07575757575757576,0.9850746268656716,0.0894743595803492,0.9216961177359533
5,124,4,133,0.03875968992248062,0.9699248120300752,0.08774753562254378,0.9197806146926306
11,38,1,50,0.22448979591836735,0.98,0.11505560170612007,0.9498905048025208
15,85,2,102,0.15,0.9803921568627451,0.1329127445632629,0.9505737049118329
4,25,1,30,0.13793103448275862,0.9666666666666667,0.13787794903585657,0.9600975144356424
8,82,6,96,0.08888888888888889,0.9375,0.11843350459141211,0.9715771062723771
15,40,1,56,0.2727272727272727,0.9821428571428571,0.14122203681390658,0.9716715885097164
0,4,59,63,0.0,0.06349206349206349,0.13039952599139576,0.840016936599201
5,195,9,209,0.025,0.9569377990430622,0.12843385600246995,0.8381616490296278
17,205,12,234,0.07657657657657657,0.9487179487179487,0.10730339609649986,0.8336927845607631
32,106,12,150,0.2318840579710145,0.92,0.11900111866378764,0.825065333580371
5,52,7,64,0.08771929824561403,0.890625,0.1118280134870527,0.8142022383422758
32,191,6,229,0.14349775784753363,0.9737991266375546,0.11962928048114481,0.8193878278619264
6,58,1,65,0.09375,0.9846153846153847,0.09406109866296299,0.8197410460722876
5,9,1,15,0.35714285714285715,0.9333333333333333,0.14508150682622828,0.9440040846210405
19,66,2,87,0.2235294117647059,0.9770114942528736,0.17344285136404342,0.9468717553652991
1,61,3,65,0.016129032258064516,0.9538461538461539,0.16480748788997027,0.9476043560979
30,86,28,144,0.25862068965517243,0.8055555555555556,0.16862700670199285,0.9312551497486936
127,463,5,595,0.21525423728813559,0.9915966386554622,0.18684628370806733,0.9456796695566168
4,55,1,60,0.06779661016949153,0.9833333333333333,0.1760318340397756,0.9470416990845851
23,74,9,106,0.23711340206185566,0.9150943396226415,0.19651232004861213,0.937110121228479
2,0,0,2,1.0,1.0,0.28834905474248973,0.9466339307522885
1,15,1,17,0.0625,0.9411764705882353,0.26534485306181743,0.9415146416573401
7,95,2,104,0.06862745098039216,0.9807692307692307,0.27284462716500707,0.945360795503494
10,118,22,150,0.078125,0.8533333333333334,0.24705952864283962,0.9521861923288908
12,47,4,63,0.2033898305084746,0.9365079365079365,0.24536461338860233,0.9443163777363871
3,26,2,31,0.10344827586206896,0.9354838709677419,0.25045770848754195,0.9374807402555884
2,20,0,22,0.09090909090909091,1.0,0.2309033498968567,0.949051977968112
28,66,13,107,0.2978723404255319,0.8785046728971962,0.13059939852907557,0.9316955026677115
18,70,2,90,0.20454545454545456,0.9777777777777777,0.15089160632128334,0.9369242608376461
28,70,3,101,0.2857142857142857,0.9702970297029703,0.1838586392883163,0.9357531759872256
71,266,44,381,0.21068249258160238,0.884514435695538,0.20214976278580615,0.939518662748189
7,75,13,95,0.08536585365853659,0.8631578947368421,0.18317605356819447,0.9296550205919509
4,28,1,33,0.125,0.9696969696969697,0.18572707397635776,0.9348498257867561
0,12,2,14,0.0,0.8571428571428571,0.17274006098934475,0.9144416625214501
1,8,2,11,0.1111111111111111,0.8181818181818182,0.1460598853729989,0.9058241118478246
24,191,15,230,0.11162790697674418,0.9347826086956522,0.1327859500060403,0.8996819448360923
33,107,15,155,0.2357142857142857,0.9032258064516129,0.12564309286318318,0.8901003415144698
2,18,4,24,0.1,0.8333333333333334,0.10983130820866856,0.8827887554627265
1,30,91,122,0.03225806451612903,0.2540983606557377,0.10224448118832462,0.7957802505939972
5,36,8,49,0.12195121951219512,0.8367346938775511,0.10180894111863818,0.7767856397626518
12,152,22,186,0.07317073170731707,0.8817204301075269,0.11226190279111206,0.7802967216147473
8,127,2,137,0.05925925925925926,0.9854014598540146,0.10485449538370466,0.8041852418536325
13,125,3,141,0.09420289855072464,0.9787234042553191,0.10236520846570187,0.8104624983621564
4,97,2,103,0.039603960396039604,0.9805825242718447,0.07434944770595242,0.821513458050761
41,176,6,223,0.1889400921658986,0.9730941704035875,0.08705517515822365,0.84147929191794
6,72,1,79,0.07692307692307693,0.9873417721518988,0.09343589121635908,0.9462283507031061
3,49,1,53,0.057692307692307696,0.9811320754716981,0.08425604667066088,0.9668565480736985
1,27,8,36,0.03571428571428571,0.7777777777777778,0.07890512581451352,0.9520075977408772
4,151,4,159,0.025806451612903226,0.9748427672955975,0.07412615329360552,0.9504992130896747
15,101,15,131,0.12931034482758622,0.8854961832061069,0.0791415027617286,0.9371810386540729
24,79,20,123,0.23300970873786409,0.8373983739837398,0.10677089538198924,0.9167261600414864
10,88,2,100,0.10204081632653061,0.98,0.09435671311922238,0.9177127071266884
5,59,1,65,0.078125,0.9846153846153847,0.09452841641592569,0.9173232231929005
4,111,4,119,0.034782608695652174,0.9663865546218487,0.09125560227354633,0.9152167202143506
9,37,1,47,0.1956521739130435,0.9787234042553191,0.114103872016226,0.9439232382825707
14,85,2,101,0.1414141414141414,0.9801980198019802,0.13061925627354573,0.9446882743549112
4,23,1,28,0.14814814814814814,0.9642857142857143,0.13331037103362603,0.9559439216519979
7,60,11,78,0.1044776119402985,0.8589743589743589,0.11494864291968808,0.9590262052220864
18,33,1,52,0.35294117647058826,0.9807692307692307,0.1507915515116963,0.9591360953319764
0,1,59,60,0.0,0.016666666666666666,0.13963083722598202,0.8208577070535882
4,167,9,180,0.023391812865497075,0.95,0.138003580678817,0.8185167706790384
17,171,13,201,0.09042553191489362,0.9353233830845771,0.12297120325050989,0.8123167676546468
32,92,12,136,0.25806451612903225,0.9117647058823529,0.13963554249549429,0.8025405799518428
2,54,7,63,0.03571428571428571,0.8888888888888888,0.12357356214779966,0.7917696048951536
31,169,6,206,0.155,0.970873786407767,0.13079104615632844,0.8077552373856403
0,12,53,65,0.0,0.18461538461538463,0.08037087808910155,0.6940189736493767
5,8,1,14,0.38461538461538464,0.9285714285714286,0.13531593303415648,0.8242910824929142
18,49,2,69,0.26865671641791045,0.9710144927536232,0.170353776398787,0.8272931528862888
1,59,3,63,0.016666666666666666,0.9523809523809523,0.15981679564904025,0.8297299485000568
29,82,32,143,0.26126126126126126,0.7762237762237763,0.16027347352507298,0.8103669585488315
126,453,11,590,0.21761658031088082,0.9813559322033898,0.18625951561030085,0.8235765361651887
4,49,1,54,0.07547169811320754,0.9814814814814815,0.1748983296264734,0.8250919211757194
22,63,9,94,0.25882352941176473,0.9042553191489362,0.21187311954243976,0.9278976261090838
2,0,0,2,1.0,1.0,0.2997852074545277,0.9381017077417368
1,15,1,17,0.0625,0.9411764705882353,0.27033424796625477,0.9338391331466814
7,84,2,93,0.07692307692307693,0.978494623655914,0.27894230657431335,0.9375696576145331
11,109,21,141,0.09166666666666666,0.851063829787234,0.25471450734651413,0.9482610938378843
12,43,4,59,0.21818181818181817,0.9322033898305084,0.25479525561379085,0.9412393020703298
3,25,2,30,0.10714285714285714,0.9333333333333333,0.25931970690374084,0.9343609951920229
3,19,0,22,0.13636363636363635,1.0,0.23615276445641276,0.949469500303105
28,65,14,107,0.3010752688172043,0.8691588785046729,0.13630637428744194,0.9307779115180581
19,71,2,92,0.2111111111111111,0.9782608695652174,0.15753653301760065,0.9360756828004841
28,70,3,101,0.2857142857142857,0.9702970297029703,0.18854893797958547,0.9345796540767326
71,267,43,381,0.21005917159763313,0.8871391076115486,0.20730879713920233,0.9395496704085838
6,76,13,95,0.07317073170731707,0.8631578947368421,0.18870606873903698,0.9290710930127132
4,29,1,34,0.12121212121212122,0.9705882352941176,0.1912437609319016,0.9340860022021954
0,12,2,14,0.0,0.8571428571428571,0.1717632414513821,0.9136778389368894
1,8,2,11,0.1111111111111111,0.8181818181818182,0.14462550463622595,0.9063954017479101
23,191,15,229,0.10747663551401869,0.9344978165938864,0.12982057955092702,0.90014353703772
31,108,15,154,0.22302158273381295,0.9025974025974026,0.1208644791251452,0.8904721617369246
2,18,4,24,0.1,0.8333333333333334,0.10514174032548332,0.8827856225543224
1,28,93,122,0.034482758620689655,0.23770491803278687,0.0996148870273937,0.7934351973108859
5,36,8,49,0.12195121951219512,0.8367346938775511,0.09972047249883283,0.7743132628228049
12,153,22,187,0.07272727272727272,0.8823529411764706,0.11011008288844319,0.7779147033990353
11,123,2,136,0.08208955223880597,0.9852941176470589,0.10596414590668533,0.801787889036927
13,124,4,141,0.0948905109489051,0.9716312056737588,0.1041661281116691,0.8070926589054801
4,98,2,104,0.0392156862745098,0.9807692307692307,0.07790814290319724,0.818260062930027
41,176,6,223,0.1889400921658986,0.9730941704035875,0.09061387035546846,0.8382258967972062
6,72,1,79,0.07692307692307693,0.9873417721518988,0.0966767729700952,0.9453168759570794
3,45,5,53,0.0625,0.9056603773584906,0.08818374161121019,0.9551634021686422
1,27,8,36,0.03571428571428571,0.7777777777777778,0.08289617203792633,0.9402240931116861
4,151,4,159,0.025806451612903226,0.9748427672955975,0.07485572909136881,0.9387310430614774
14,101,16,131,0.12173913043478261,0.8778625954198473,0.07869124616077987,0.9253355273109184
25,79,20,124,0.2403846153846154,0.8387096774193549,0.10742966460508067,0.9050413054037935
10,88,2,100,0.10204081632653061,0.98,0.09501548234231381,0.9060278524889951
4,60,1,65,0.0625,0.9846153846153847,0.09295504278187426,0.9056383685552074
7,108,4,119,0.06086956521739131,0.9663865546218487,0.09272212352721587,0.9143135367356872
9,37,1,47,0.1956521739130435,0.9787234042553191,0.11557039326989556,0.9430200548039073
15,84,1,100,0.15151515151515152,0.99,0.13352877897021673,0.9451853737616791
3,24,1,28,0.1111111111111111,0.9642857142857143,0.13201049049540653,0.95753153359966
7,60,11,78,0.1044776119402985,0.8589743589743589,0.11259520428907553,0.9604264881075179
16,35,1,52,0.3137254901960784,0.9807692307692307,0.14283587198472522,0.960536378217408
0,2,59,61,0.0,0.03278688524590164,0.1339073005561538,0.8245608783074818
5,163,13,181,0.02976190476190476,0.9281767955801105,0.12946334906251286,0.8191023413015193
18,169,13,200,0.0962566844919786,0.935,0.11526399343093216,0.8128561406936164
30,93,13,136,0.24390243902439024,0.9044117647058824,0.1284621773608234,0.800629249937314
2,54,7,63,0.03571428571428571,0.8888888888888888,0.11769120230413407,0.7898582748806247
32,167,6,205,0.16080402010050251,0.9707317073170731,0.12573783204130606,0.8058236103581552
0,16,49,65,0.0,0.24615384615384617,0.08091990487043772,0.7008785554131002
4,9,1,14,0.3076923076923077,0.9285714285714286,0.12487594882648168,0.8288477758881755
18,49,2,69,0.26865671641791045,0.9710144927536232,0.1590037790630539,0.8349674469129631
0,60,3,63,0.0,0.9523809523809523,0.1452528241356284,0.837450440110242
29,81,32,142,0.2636363636363636,0.7746478873239436,0.1480719562230532,0.8189127433413936
123,456,11,590,0.21243523316062177,0.9813559322033898,0.17331780585824402,0.8321223209577508
4,49,1,54,0.07547169811320754,0.9814814814814815,0.16112747414577333,0.8336580029812378
22,63,9,94,0.25882352941176473,0.9042553191489362,0.19810226406173975,0.9276724991233934
2,0,0,2,1.0,1.0,0.29700336296283864,0.9378765807560464
1,15,1,17,0.0625,0.9411764705882353,0.2675524034745657,0.9336140061609911
5,86,2,93,0.054945054945054944,0.978494623655914,0.275401697038145,0.9373445306288428
10,111,20,141,0.08264462809917356,0.8581560283687943,0.2495457348185464,0.9492742650638214
12,43,4,59,0.21818181818181817,0.9322033898305084,0.2503666755358602,0.9422524732962669
3,25,2,30,0.10714285714285714,0.9333333333333333,0.2548911268258101,0.93537416641796
3,21,0,24,0.125,1.0,0.16552212391051796,0.949469500303105
28,75,14,117,0.27184466019417475,0.8803418803418803,0.13292850393825723,0.9323754832090877
17,91,2,110,0.1574074074074074,0.9818181818181818,0.14648670499645827,0.938181441956223
26,95,3,124,0.21487603305785125,0.9758064516129032,0.16737935957895242,0.9374724735053191
69,307,40,416,0.18351063829787234,0.9038461538461539,0.18234657112431776,0.9448292107278281
6,87,13,106,0.06451612903225806,0.8773584905660378,0.16008616340737644,0.9363792898789854
4,35,1,40,0.10256410256410256,0.975,0.1599598529362384,0.9420244511693081
0,12,2,14,0.0,0.8571428571428571,0.1421027100790955,0.921616287904002
1,13,2,16,0.07142857142857142,0.875,0.1134718402554379,0.9208531621408761
25,229,15,269,0.0984251968503937,0.9442379182156134,0.10504581017586449,0.9154845530547949
31,122,15,168,0.20261437908496732,0.9107142857142857,0.10329414532259538,0.9061856722121353
2,20,4,26,0.09090909090909091,0.8461538461538461,0.09006535283848374,0.8979439139703771
0,28,98,126,0.0,0.2222222222222222,0.0808487629767326,0.8043530184926891
6,39,8,53,0.13333333333333333,0.8490566037735849,0.085244367372337,0.7863611047460584
11,170,23,204,0.06077348066298342,0.8872549019607843,0.09392629318133462,0.7906628254343336
13,152,2,167,0.07878787878787878,0.9880239520958084,0.09497762280409282,0.8068091043051634
13,133,4,150,0.08904109589041095,0.9733333333333334,0.0936370369526667,0.8109655921791233
5,109,2,116,0.043859649122807015,0.9827586206896551,0.07095778981521524,0.8212576400327476
41,176,6,223,0.1889400921658986,0.9730941704035875,0.08496221856618777,0.839391972068425
10,91,1,102,0.09900990099009901,0.9901960784313726,0.0991064901362019,0.9491025229554465
3,57,1,61,0.05,0.9836065573770492,0.08720172823144,0.9683239448987985
1,29,9,39,0.03333333333333333,0.7692307692307693,0.08328170718434713,0.9514633545087964
13,147,4,164,0.08125,0.975609756097561,0.08363343878607873,0.9496898979376182
13,102,25,140,0.11304347826086956,0.8214285714285714,0.08706235055328711,0.9279892176655092
28,93,19,140,0.23140495867768596,0.8642857142857143,0.11385453763255551,0.9110645167506607
12,94,2,108,0.11320754716981132,0.9814814814814815,0.1030356026331145,0.9122627040475025
5,60,2,67,0.07692307692307693,0.9701492537313433,0.09988034205211134,0.9093988719474985
6,123,4,133,0.046511627906976744,0.9699248120300752,0.09938200318167945,0.9074443368979307
9,40,1,50,0.1836734693877551,0.98,0.12085916547516827,0.9375542270078209
16,84,1,101,0.16,0.9900990099009901,0.13210916547516827,0.9396241204083108
3,26,1,30,0.10344827586206896,0.9666666666666667,0.13073842227533963,0.9603724197280386
8,76,12,96,0.09523809523809523,0.875,0.11128601321254095,0.9619030319729366
14,40,2,56,0.25925925925925924,0.9642857142857143,0.13215054351103347,0.9594464938021127
0,4,59,63,0.0,0.06349206349206349,0.12116153252202251,0.8299240380536441
5,190,13,208,0.02564102564102564,0.9375,0.11818001791260092,0.8252919220493478
17,204,13,234,0.07692307692307693,0.9444444444444444,0.1029299618462183,0.8202125569699825
31,106,13,150,0.22627737226277372,0.9133333333333333,0.11239815788375743,0.8092460317460316
3,55,7,65,0.05172413793103448,0.8923076923076924,0.10500899532218107,0.798623321123321
30,193,6,229,0.13452914798206278,0.9737991266375546,0.11062200285703357,0.8127374820715431
0,10,55,65,0.0,0.15384615384615385,0.07358496581999653,0.6969604020087488
5,9,1,15,0.35714285714285715,0.9333333333333333,0.12460537398326185,0.8212234405575015
19,66,2,87,0.2235294117647059,0.9770114942528736,0.1528751434295019,0.8268679397364834
0,62,3,65,0.0,0.9538461538461539,0.1418861324404909,0.8282110410795849
28,83,32,143,0.25225225225225223,0.7762237762237763,0.14559682958184497,0.8086239614925053
126,458,11,595,0.21575342465753425,0.9815126050420168,0.1690295848284878,0.8213675204545517
4,55,1,60,0.06779661016949153,0.9833333333333333,0.1594963651409776,0.8227295499825199
23,74,9,106,0.23711340206185566,0.9150943396226415,0.19336970829267128,0.9314792908077326
2,0,0,2,1.0,1.0,0.2852064429865488,0.9410031003315421
1,15,1,17,0.0625,0.9411764705882353,0.26220224130587655,0.9358838112365938
7,95,2,104,0.06862745098039216,0.9807692307692307,0.27200616287450397,0.9397299650827476
10,117,22,149,0.07874015748031496,0.8523489932885906,0.24721872076422727,0.9506049960920067
12,47,4,63,0.2033898305084746,0.9365079365079365,0.24545249302864727,0.9441757577299954
3,26,2,31,0.10344827586206896,0.9354838709677419,0.2505455881275869,0.9373401202491966
2,22,0,24,0.08333333333333333,1.0,0.2299850116113076,0.9504282730739583
28,75,14,117,0.27184466019417475,0.8803418803418803,0.12596282021047542,0.933334255979941
17,91,2,110,0.1574074074074074,0.9818181818181818,0.1395210212686765,0.9391402147270763
26,95,3,124,0.21487603305785125,0.9758064516129032,0.15761255540299138,0.9384312462761724
69,306,41,416,0.184,0.9014423076923077,0.17162148397441992,0.9444858041344215
6,87,13,106,0.06451612903225806,0.8773584905660378,0.15420369126958516,0.9360358832855787
4,35,1,40,0.10256410256410256,0.975,0.15407738079844707,0.9416810445759014
0,12,2,14,0.0,0.8571428571428571,0.14217261889368518,0.9212728813105953
1,13,2,16,0.07142857142857142,0.875,0.11354174907002756,0.9205097555474696
25,230,14,269,0.09803921568627451,0.9479553903345725,0.10506057882415143,0.9156722139069539
32,121,15,168,0.20915032679738563,0.9107142857142857,0.10424262078694205,0.9063733330642941
2,20,4,26,0.09090909090909091,0.8461538461538461,0.09094391948824075,0.8984749814159426
0,30,96,126,0.0,0.23809523809523808,0.08172732962648961,0.8071516596343998
6,39,8,53,0.13333333333333333,0.8490566037735849,0.086122934022094,0.789159745887769
12,169,23,204,0.06629834254143646,0.8872549019607843,0.09559412581372777,0.7934614665760443
12,153,2,167,0.07272727272727272,0.9880239520958084,0.09577965457068512,0.8096077454468741
12,134,4,150,0.0821917808219178,0.9733333333333334,0.09351573530434844,0.8132331658752686
4,110,2,116,0.03508771929824561,0.9827586206896551,0.068649648518757,0.8235252137288926
41,176,6,223,0.1889400921658986,0.9730941704035875,0.08265407726972954,0.8416595457645701
10,91,1,102,0.09900990099009901,0.9901960784313726,0.09679834883974368,0.9491025229554465
3,53,5,61,0.05357142857142857,0.9180327868852459,0.08540379101661442,0.9589562633999694
1,29,9,39,0.03333333333333333,0.7692307692307693,0.08069450398688541,0.9420956730099673
12,148,4,164,0.075,0.975609756097561,0.08101917931156075,0.9403222164387891
13,112,15,140,0.104,0.8928571428571429,0.0841346391941439,0.9288256177993333
29,92,19,140,0.2396694214876033,0.8642857142857143,0.11336059664976643,0.9119009168844847
11,95,2,108,0.10377358490566038,0.9814814814814815,0.1011939527554467,0.9130991041813267
3,62,2,67,0.046153846153846156,0.9701492537313433,0.09364308777883913,0.9102352720813224
6,123,4,133,0.046511627906976744,0.9699248120300752,0.09263454482677459,0.9176484185305837
11,38,1,50,0.22448979591836735,0.98,0.11994261091035087,0.9477583086404738
16,84,1,101,0.16,0.9900990099009901,0.13208546805320803,0.9498282020409637
2,27,1,30,0.06896551724137931,0.9666666666666667,0.12708054194483362,0.9603724197280386
8,77,11,96,0.09411764705882353,0.8854166666666666,0.1062874313121508,0.9633911272110317
16,38,2,56,0.2962962962962963,0.9642857142857143,0.13379067579652734,0.9609345890402078
0,4,59,63,0.0,0.06349206349206349,0.12719726920312077,0.8314121332917395
5,190,13,208,0.02564102564102564,0.9375,0.12421575459369918,0.826780017287443
18,203,13,234,0.08144796380090498,0.9444444444444444,0.10378120714834742,0.8217006522080778
30,106,14,150,0.22058823529411764,0.9066666666666666,0.11243666933322137,0.8097817460317459
2,56,7,65,0.034482758620689655,0.8923076923076924,0.10751056095883714,0.7991590354090352
31,191,7,229,0.13963963963963963,0.9694323144104804,0.11401370275609658,0.8111612708010087
0,9,56,65,0.0,0.13846153846153847,0.07168566042805424,0.6931863885404121
5,9,1,15,0.35714285714285715,0.9333333333333333,0.12270606859131956,0.8174494270891649
19,66,2,87,0.2235294117647059,0.9770114942528736,0.1509758380375596,0.8230939262681468
0,62,3,65,0.0,0.9538461538461539,0.13934041463743033,0.8244370276112483
30,82,32,144,0.26785714285714285,0.7777777777777778,0.1460931157178625,0.8060243291985498
124,460,11,595,0.21232876712328766,0.9815126050420168,0.17149968836109078,0.8187678881605962
4,55,1,60,0.06779661016949153,0.9833333333333333,0.1612363984367839,0.820753748006718
24,73,9,106,0.24742268041237114,0.9150943396226415,0.1965824956385512,0.9317012910297329
1,1,0,2,0.5,1.0,0.21699065890385733,0.9412251005535424
1,15,1,17,0.0625,0.9411764705882353,0.19398645722318505,0.936105811458594
7,95,2,104,0.06862745098039216,0.9807692307692307,0.2037903787918125,0.9399519653047478
10,117,22,149,0.07874015748031496,0.8523489932885906,0.1767736665951228,0.9506049960920068
13,46,4,63,0.22033898305084745,0.9365079365079365,0.17791798315620277,0.9441757577299954
3,26,2,31,0.10344827586206896,0.9354838709677419,0.1830110782551424,0.9373401202491964
2,22,0,24,0.08333333333333333,1.0,0.23278613205948687,0.950428273073958
28,75,14,117,0.27184466019417475,0.8803418803418803,0.1287639406586547,0.933334255979941
18,90,2,110,0.16666666666666666,0.9818181818181818,0.1436448930396071,0.9391402147270763
28,93,3,124,0.23140495867768596,0.9758064516129032,0.1612965818142905,0.9384312462761724
72,303,41,416,0.192,0.9014423076923077,0.1764483675285762,0.9444858041344215
9,84,13,106,0.0967741935483871,0.8773584905660378,0.163638869754617,0.936035883285579
4,35,1,40,0.10256410256410256,0.975,0.16351255928347894,0.9416810445759014
0,12,2,14,0.0,0.8571428571428571,0.15160779737871705,0.9212728813105954
1,13,2,16,0.07142857142857142,0.875,0.12297692755505941,0.9205097555474696
26,228,15,269,0.10236220472440945,0.9442379182156134,0.11379057584902268,0.9151411464613883
31,122,15,168,0.20261437908496732,0.9107142857142857,0.10967763590720572,0.9058422656187287
2,20,4,26,0.09090909090909091,0.8461538461538461,0.09523607746564729,0.897943913970377
0,31,95,126,0.0,0.24603174603174602,0.08141119267302055,0.8077543790369067
6,39,8,53,0.13333333333333333,0.8490566037735849,0.08580679706862494,0.789762465290276
10,172,23,205,0.054945054945054944,0.8878048780487805,0.09365609063220423,0.7941427539911222
12,153,2,167,0.07272727272727272,0.9880239520958084,0.09384161938916155,0.810289032861952
13,133,4,150,0.08904109589041095,0.9733333333333334,0.09193860384144747,0.814445520735912
4,110,2,116,0.03508771929824561,0.9827586206896551,0.06800622387191581,0.8247375685895363
41,176,6,223,0.1889400921658986,0.9730941704035875,0.08201065262288834,0.8428719006252136
10,91,1,102,0.09900990099009901,0.9901960784313726,0.09615492419290249,0.9491810909680174
2,58,1,61,0.03333333333333333,0.9836065573770492,0.0818692099071882,0.9684025129113695
1,29,9,39,0.03333333333333333,0.7692307692307693,0.07878182110551368,0.9514633545087964
4,156,4,164,0.025,0.975609756097561,0.07196363928733186,0.9496898979376182
13,112,15,140,0.104,0.8928571428571429,0.07410062558870172,0.9381932992981624
27,93,20,140,0.225,0.8571428571428571,0.10123095140323805,0.9202481902200484
13,93,2,108,0.12264150943396226,0.9814814814814815,0.09175972529867574,0.9214463775168904
4,62,1,67,0.06060606060606061,0.9850746268656716,0.08627346238667025,0.9207147415789331
5,124,4,133,0.03875968992248062,0.9699248120300752,0.08704865618511988,0.9187602065293653
11,38,1,50,0.22448979591836735,0.98,0.11435672226869616,0.9488700966392555
16,84,2,102,0.16,0.9803921568627451,0.13364243655441044,0.9495532967485675
3,26,1,30,0.10344827586206896,0.9666666666666667,0.13356361882042028,0.9600975144356422
8,76,12,96,0.09523809523809523,0.875,0.11502620385443389,0.9626485348438055
15,40,1,56,0.2727272727272727,0.9821428571428571,0.13646702718204967,0.962743017081145
0,4,59,63,0.0,0.06349206349206349,0.12780901852404103,0.8310883651706295
5,194,9,208,0.02512562814070352,0.9567307692307693,0.12586129541235858,0.8292035019135858
15,206,13,234,0.06787330316742081,0.9444444444444444,0.10348751073365192,0.8241241368342207
33,105,12,150,0.2391304347826087,0.92,0.11479185855973888,0.8154966858538286
4,54,7,65,0.06896551724137931,0.8923076923076924,0.10986575018535465,0.804873975231118
32,191,6,229,0.14349775784753363,0.9737991266375546,0.11675998770098871,0.8189881361793401
0,15,50,65,0.0,0.23076923076923078,0.07779894873994975,0.7116490466973934
4,9,2,15,0.3076923076923077,0.8666666666666667,0.1217549926959937,0.8263882757223369
19,66,2,87,0.2235294117647059,0.9770114942528736,0.15009839035656544,0.829285522154066
0,62,3,65,0.0,0.9538461538461539,0.14040220418979105,0.8306286234971674
30,82,32,144,0.26785714285714285,0.7777777777777778,0.14450601962901022,0.810311163179707
131,453,11,595,0.2243150684931507,0.9815126050420168,0.16669881266497757,0.8230547221417533
4,55,1,60,0.06779661016949153,0.9833333333333333,0.15588436299668587,0.8244167516697216
23,74,9,106,0.23711340206185566,0.9150943396226415,0.1897577061483795,0.9221774815059233
2,0,0,2,1.0,1.0,0.2886588050494784,0.9412251005535422
1,15,1,17,0.0625,0.9411764705882353,0.26565460336880614,0.936105811458594
9,93,2,104,0.08823529411764706,0.9807692307692307,0.2782596453856128,0.9399519653047478
11,117,21,149,0.0859375,0.8590604026845637,0.2522711249774496,0.95156376886286
11,48,4,63,0.1864406779661017,0.9365079365079365,0.24686049775929972,0.9451345305008486
3,26,2,31,0.10344827586206896,0.9354838709677419,0.2519535928582394,0.9382988930200499
2,22,0,24,0.08333333333333333,1.0,0.22755625959869155,0.949469500303105
30,75,12,117,0.2857142857142857,0.8974358974358975,0.12551544327216094,0.9348174856510901
18,90,2,110,0.16666666666666666,0.9818181818181818,0.1403963956531133,0.9406234443982254
27,93,3,123,0.225,0.975609756097561,0.16133477100325336,0.9398863765879869
71,305,40,416,0.18882978723404256,0.9038461538461539,0.1770618609680716,0.9472431138104959
7,86,13,106,0.07526881720430108,0.8773584905660378,0.16118016657352863,0.9387931929616532
4,35,1,40,0.10256410256410256,0.975,0.1610538561023906,0.9444383542519759
0,12,2,14,0.0,0.8571428571428571,0.1491490941976287,0.9240301909866696
1,13,2,16,0.07142857142857142,0.875,0.1185368492996695,0.9208250627815415
26,227,15,268,0.10276679841897234,0.9440298507462687,0.10940829669285602,0.9154267297712682
32,121,15,168,0.20915032679738563,0.9107142857142857,0.10714405766391112,0.9061559482879431
2,20,4,26,0.09090909090909091,0.8461538461538461,0.0931553867603466,0.897914190046185
0,39,87,126,0.0,0.30952380952380953,0.0824026985883036,0.8167949498972952
6,38,8,52,0.13636363636363635,0.8461538461538461,0.08723120341680841,0.7983883564907017
12,168,25,205,0.06666666666666667,0.8780487804878049,0.09675501294061793,0.8013749169685516
12,153,2,167,0.07272727272727272,0.9880239520958084,0.09694054169757527,0.8175211958393812
15,131,4,150,0.10273972602739725,0.9733333333333334,0.09693667421306452,0.8217074076375334
3,111,2,116,0.02631578947368421,0.9827586206896551,0.0708174545953929,0.8319994554911576
41,176,6,223,0.1889400921658986,0.9730941704035875,0.08482188334636542,0.8501337875268348
10,91,1,102,0.09900990099009901,0.9901960784313726,0.09896615491637958,0.9473726830850582
2,58,1,61,0.03333333333333333,0.9836065573770492,0.08424754019776486,0.9670087846883729
1,29,9,39,0.03333333333333333,0.7692307692307693,0.0794856354358601,0.9514633545087964
12,148,4,164,0.075,0.975609756097561,0.07981031076053544,0.9496898979376182
13,112,15,140,0.104,0.8928571428571429,0.07999034989947866,0.9381932992981624
27,93,20,140,0.225,0.8571428571428571,0.10837380854609521,0.9202481902200484
12,94,2,108,0.11320754716981132,0.9814814814814815,0.09755487354665418,0.9214463775168904
4,62,1,67,0.06060606060606061,0.9850746268656716,0.09206861063464868,0.9207147415789331
4,125,4,133,0.031007751937984496,0.9699248120300752,0.09173638472102742,0.9187602065293653
9,40,1,50,0.1836734693877551,0.98,0.11321354701451625,0.9488700966392555
16,84,2,102,0.16,0.9803921568627451,0.1253564041573734,0.9495532967485675
5,24,1,30,0.1724137931034483,0.9666666666666667,0.13512980317215173,0.9600975144356422
7,78,11,96,0.08235294117647059,0.8854166666666666,0.1147516519116475,0.9641366300819009
16,39,1,56,0.2909090909090909,0.9821428571428571,0.1401375867315446,0.9642311123192401
0,4,59,63,0.0,0.06349206349206349,0.13147957807353597,0.8325764604087248
6,193,9,208,0.03015075376884422,0.9567307692307693,0.13135714976365875,0.8306915971516811
16,206,12,234,0.07207207207207207,0.9487179487179487,0.11541409300427548,0.8262227326828165
32,105,13,150,0.23357664233576642,0.9133333333333333,0.12592504190938494,0.8166429007500434
3,55,7,65,0.05172413793103448,0.8923076923076924,0.10868366259904014,0.8060201901273328
30,193,6,229,0.13452914798206278,0.9737991266375546,0.11613740642841044,0.8186462558374598
0,13,52,65,0.0,0.2,0.07457896486996887,0.7069115619599088
4,9,2,15,0.3076923076923077,0.8666666666666667,0.11853500882601284,0.8216507909848519
19,66,2,87,0.2235294117647059,0.9770114942528736,0.14616053139685023,0.8245480374165811
0,62,3,65,0.0,0.9538461538461539,0.13586452110083994,0.8252806381491818
29,83,32,144,0.25892857142857145,0.7777777777777778,0.13948622525695495,0.8059155587841025
129,455,11,595,0.2208904109589041,0.9815126050420168,0.16365283568950773,0.818659117746149
4,55,1,60,0.06779661016949153,0.9833333333333333,0.15411961600199756,0.8200211472741172
22,75,9,106,0.2268041237113402,0.9150943396226415,0.1865202051036176,0.9221774815059233
2,0,0,2,1.0,1.0,0.2854213040047165,0.9412251005535424
1,15,1,17,0.0625,0.9411764705882353,0.2624171023240442,0.936105811458594
11,91,2,104,0.10784313725490197,0.9807692307692307,0.27782326478903024,0.9399519653047478
11,117,21,149,0.0859375,0.8590604026845637,0.25311025458494857,0.9515637688628601
11,48,4,63,0.1864406779661017,0.9365079365079365,0.2481888641574054,0.9451345305008486
3,26,2,31,0.10344827586206896,0.9354838709677419,0.253281959256345,0.9382988930200498
2,22,0,24,0.08333333333333333,1.0,0.23137028315599778,0.9470156189816163
29,77,11,117,0.27358490566037735,0.905982905982906,0.12759669825033737,0.933584605550603
17,90,2,109,0.1588785046728972,0.981651376146789,0.14136505606075125,0.9393667349161106
25,95,3,123,0.20833333333333334,0.975609756097561,0.15856809112092915,0.938954610979203
73,302,41,416,0.19466666666666665,0.9014423076923077,0.17566332921616729,0.9470077374302166
8,85,13,106,0.08602150537634409,0.8773584905660378,0.15885158659797302,0.939339738545562
4,35,1,40,0.10256410256410256,0.975,0.1581974788010081,0.945292119497943
0,13,1,14,0.0,0.9285714285714286,0.1462927168962462,0.9350880378652898
1,14,1,16,0.06666666666666667,0.9375,0.11673296846857324,0.9395904798677319
27,226,15,268,0.1067193675889328,0.9440298507462687,0.10928166317086406,0.934215976239086
33,121,14,168,0.21428571428571427,0.9166666666666666,0.11013200330691848,0.9257955348918154
2,24,0,26,0.07692307692307693,1.0,0.09331149048640565,0.9398752052214858
1,64,61,126,0.015384615384615385,0.5158730158730159,0.08322050620187296,0.8882344231224827
6,45,1,52,0.11764705882352941,0.9807692307692307,0.08537521423893395,0.8890585989466585
13,169,23,205,0.07142857142857142,0.8878048780487805,0.09557929587158702,0.8832348060148517
11,154,2,167,0.06666666666666667,0.9880239520958084,0.09557929587158702,0.8904525134571101
14,132,4,150,0.0958904109589041,0.9733333333333334,0.0940323020672972,0.8946387252552622
4,110,2,116,0.03508771929824561,0.9827586206896551,0.06843258849765882,0.9040804329728319
41,176,6,223,0.1889400921658986,0.9730941704035875,0.08443501924663334,0.9002367430304873
10,91,1,102,0.09900990099009901,0.9901960784313726,0.09638148861884531,0.967997180538824
3,57,1,61,0.05,0.9836065573770492,0.0867176230726268,0.9684025129113694
1,29,9,39,0.03333333333333333,0.7692307692307693,0.0812754462018785,0.9514633545087964
12,148,4,164,0.075,0.975609756097561,0.0824659223923547,0.9496898979376182
13,113,14,140,0.10317460317460317,0.9,0.0835065212803117,0.9392137074614276
25,96,19,140,0.2066115702479339,0.8642857142857143,0.1080099285588386,0.9222890065465791
12,94,2,108,0.11320754716981132,0.9814814814814815,0.09719099355939756,0.9234871938434209
4,62,1,67,0.06060606060606061,0.9850746268656716,0.09170473064739207,0.9227555579054637
4,125,4,133,0.031007751937984496,0.9699248120300752,0.08899155235281844,0.9208010228558959
11,38,1,50,0.22448979591836735,0.98,0.11629961843639472,0.950910912965786
16,84,2,102,0.16,0.9803921568627451,0.12844247557925187,0.951594113075098
5,24,1,30,0.1724137931034483,0.9666666666666667,0.13833378842622973,0.9611179225989076
7,84,5,96,0.07692307692307693,0.9479166666666666,0.11980686080839302,0.9730652015104723
17,38,1,56,0.3090909090909091,0.9821428571428571,0.1477901982256927,0.9731596837478117
0,4,59,63,0.0,0.06349206349206349,0.13913218956768406,0.8415050318372961
6,193,9,208,0.03015075376884422,0.9567307692307693,0.13900976125780687,0.8396201685802526
17,205,12,234,0.07657657657657657,0.9487179487179487,0.11787930135183676,0.835151304111388
33,105,12,150,0.2391304347826087,0.92,0.12918364917792372,0.8265238531309959
4,54,7,65,0.06896551724137931,0.8923076923076924,0.11440532405477101,0.8159011425082853
31,192,6,229,0.13901345291479822,0.9737991266375546,0.12327537776787405,0.8195986367898406
6,57,2,65,0.09523809523809523,0.9692307692307692,0.09272497578890064,0.8177540528023995
4,10,1,15,0.2857142857142857,0.9333333333333333,0.13354130231951286,0.9420170913511524
19,66,2,87,0.2235294117647059,0.9770114942528736,0.16116682489035025,0.9449143377828816
1,61,3,65,0.016129032258064516,0.9538461538461539,0.1525314614162771,0.9456469385154823
28,88,28,144,0.2413793103448276,0.8055555555555556,0.15285272935373695,0.929297732166276
134,456,5,595,0.2271186440677966,0.9915966386554622,0.1754460331860823,0.9434818673588145
4,55,1,60,0.06779661016949153,0.9833333333333333,0.16527219850818134,0.9448438968867829
23,74,9,106,0.23711340206185566,0.9150943396226415,0.18554009948300426,0.937110121228479
2,0,0,2,1.0,1.0,0.2875809158095349,0.9466339307522885
1,15,1,17,0.0625,0.9411764705882353,0.2645767141288626,0.9415146416573402
8,94,2,104,0.0784313725490196,0.9807692307692307,0.2734770484561419,0.9453607955034941
10,117,22,149,0.07874015748031496,0.8523489932885906,0.2502428837612115,0.952045572322499
11,48,4,63,0.1864406779661017,0.9365079365079365,0.24443174574668367,0.9441757577299954
3,26,2,31,0.10344827586206896,0.9354838709677419,0.2495248408456233,0.9373401202491966
2,20,0,22,0.09090909090909091,1.0,0.23148316199558466,0.9480543381416923
28,64,15,107,0.30434782608695654,0.8598130841121495,0.13210428000800703,0.9280276358719994
15,73,2,90,0.17045454545454544,0.9777777777777777,0.14752635793008495,0.933256394041934
26,71,3,100,0.26804123711340205,0.97,0.1765011930456641,0.9320101934340312
74,260,42,376,0.2215568862275449,0.8882978723404256,0.19516516380544324,0.9371795071889009
6,77,13,96,0.07228915662650602,0.8645833333333334,0.1763916570801293,0.9276864858424311
4,28,1,33,0.125,0.9696969696969697,0.17894267748829257,0.9328812910372364
0,12,2,14,0.0,0.8571428571428571,0.16595566450127958,0.9124731277719303
1,7,2,10,0.125,0.8,0.1403345464888572,0.9039284014701946
23,191,15,229,0.10747663551401869,0.9344978165938864,0.13133770221163912,0.8977455498724959
32,109,14,155,0.22695035460992907,0.9096774193548387,0.1254675761397144,0.8891280383517586
1,19,4,24,0.05,0.8333333333333334,0.10095944953577941,0.8812759613507454
0,36,86,122,0.0,0.29508196721311475,0.09063242716056427,0.7999186233335713
5,35,8,48,0.125,0.8333333333333334,0.09063242716056427,0.7804381038530519
13,151,24,188,0.07926829268292683,0.8723404255319149,0.10195646897241095,0.7826091850514887
9,124,2,135,0.06766917293233082,0.9851851851851852,0.0937663508198868,0.8090642115065151
13,124,4,141,0.0948905109489051,0.9716312056737588,0.09196833302487058,0.8143689813750683
4,97,2,103,0.039603960396039604,0.9805825242718447,0.06520456242288634,0.8244982820774976
41,176,6,223,0.1889400921658986,0.9730941704035875,0.08505314701801472,0.844464115944677
6,72,1,79,0.07692307692307693,0.9873417721518988,0.09604215800702572,0.9433583737930746
3,49,1,53,0.057692307692307696,0.9811320754716981,0.08642677339164109,0.9644724798128409
2,26,8,36,0.07142857142857142,0.7777777777777778,0.08530681321244747,0.9509635301336784
12,144,4,160,0.07692307692307693,0.975,0.08662879949683977,0.9495085036786521
14,103,14,131,0.11965811965811966,0.8931297709923665,0.09016702931244185,0.9382940130098818
25,79,20,124,0.2403846153846154,0.8387096774193549,0.11884998002509553,0.9180264634595261
12,86,2,100,0.12244897959183673,0.98,0.1093512496573724,0.919013010544728
5,59,1,65,0.078125,0.9846153846153847,0.1095229529540757,0.9186235266109402
4,111,4,119,0.034782608695652174,0.9663865546218487,0.10625013881169634,0.9165170236323903
10,36,1,47,0.21739130434782608,0.9787234042553191,0.12710195780016129,0.9452235417006104
15,84,2,101,0.15151515151515152,0.9801980198019802,0.13775796845617197,0.9459661159580361
3,24,1,28,0.1111111111111111,0.9642857142857143,0.13653696723517073,0.9561312507142288
6,61,11,78,0.08955223880597014,0.8589743589743589,0.11498948486679285,0.9590262052220864
16,35,1,52,0.3137254901960784,0.9807692307692307,0.1423147006673988,0.9591360953319764
0,1,59,60,0.0,0.016666666666666666,0.1311539863816845,0.8208577070535882
5,161,13,179,0.030120481927710843,0.9273743016759777,0.1304879682719786,0.8152845280613209
17,169,12,198,0.0913978494623656,0.9393939393939394,0.1124889032883414,0.8096660330811238
32,92,12,136,0.25806451612903225,0.9117647058823529,0.12771024109032436,0.79988984537832
2,54,7,63,0.03571428571428571,0.8888888888888888,0.11693926603363501,0.7891188703216306
31,173,6,210,0.15196078431372548,0.9714285714285714,0.12585477253474292,0.8051837578150894
0,12,53,65,0.0,0.18461538461538463,0.08103684536387457,0.6914474940788259
4,9,1,14,0.3076923076923077,0.9285714285714286,0.12499288931991852,0.8217196029223633
18,49,2,69,0.26865671641791045,0.9710144927536232,0.1590694942470899,0.8279539159334555
1,59,3,63,0.016666666666666666,0.9523809523809523,0.1483936109905615,0.8298092035030288
31,79,32,142,0.2818181818181818,0.7746478873239436,0.1517869918032971,0.810221086566113
129,450,11,590,0.22279792746113988,0.9813559322033898,0.178513226338562,0.8234306641824704
4,49,1,54,0.07547169811320754,0.9814814814814815,0.16758621402420232,0.8248667941900291
21,64,9,94,0.24705882352941178,0.9042553191489362,0.20288033167126113,0.9276724991233934
2,0,0,2,1.0,1.0,0.30178143057236007,0.9378765807560464
1,15,1,17,0.0625,0.9411764705882353,0.27233047108408714,0.9336140061609911
8,83,2,93,0.08791208791208792,0.978494623655914,0.28250838840486153,0.9373445306288427
9,111,22,142,0.075,0.8450704225352113,0.25296293385940705,0.947404892801881
11,43,4,58,0.2037037037037037,0.9310344827586207,0.25023518760834473,0.9402161143097711
3,25,2,30,0.10714285714285714,0.9333333333333333,0.25475963889829467,0.9333378074314643
2,20,0,22,0.09090909090909091,1.0,0.2297878497010092,0.9502819779967876
27,66,14,107,0.2903225806451613,0.8691588785046729,0.12840536122174656,0.9315903892117409
17,72,2,91,0.19101123595505617,0.978021978021978,0.146764109215326,0.9368540331308469
24,73,3,100,0.24742268041237114,0.97,0.1737068450725555,0.9353155715923853
71,262,42,375,0.2132132132132132,0.888,0.19188908981730024,0.9394497997803049
7,77,13,97,0.08333333333333333,0.865979381443299,0.17423720147575672,0.9295205869910986
4,28,1,33,0.125,0.9696969696969697,0.17731601920974688,0.9344081725238456
0,12,2,14,0.0,0.8571428571428571,0.1643290062227339,0.9140000092585394
1,7,2,10,0.125,0.8,0.14071149470199654,0.9041201694721576
25,190,15,230,0.11627906976744186,0.9347826086956522,0.13003547096090878,0.8979431167112538
31,109,14,154,0.22142857142857142,0.9090909090909091,0.12632202682036597,0.8892418180099552
1,19,4,24,0.05,0.8333333333333334,0.10300585350419267,0.8814322942004313
1,29,92,122,0.03333333333333333,0.2459016393442623,0.09586299636133552,0.7928497596148547
5,35,8,48,0.125,0.8333333333333334,0.09586299636133552,0.7733692401343353
10,156,22,188,0.060240963855421686,0.8829787234042553,0.10446884834068147,0.7770600781716778
9,124,2,135,0.06766917293233082,0.9851851851851852,0.09627873018815729,0.8035151046267043
13,124,4,141,0.0948905109489051,0.9716312056737588,0.0932232217855092,0.808779189909291
6,95,2,103,0.0594059405940594,0.9805825242718447,0.07007713166629319,0.8189922777922817
41,176,6,223,0.1889400921658986,0.9730941704035875,0.08992571626142157,0.838958111659461
6,72,1,79,0.07692307692307693,0.9873417721518988,0.09615282248852779,0.9448781306319803
4,44,5,53,0.08333333333333333,0.9056603773584906,0.09020044153614684,0.9552105654927171
1,27,8,36,0.03571428571428571,0.7777777777777778,0.0866966303731274,0.9401818589746489
13,143,4,160,0.08333333333333333,0.975,0.08893436757327064,0.9387268325196224
13,104,14,131,0.1111111111111111,0.8931297709923665,0.09125159616787148,0.9275123418508521
24,81,19,124,0.22857142857142856,0.8467741935483871,0.1154180944503528,0.9083968660332153
12,86,2,100,0.12244897959183673,0.98,0.10591936408262967,0.9093834131184172
5,59,1,65,0.078125,0.9846153846153847,0.10609106737933297,0.9089939291846293
4,111,4,119,0.034782608695652174,0.9663865546218487,0.09915524957394994,0.917669097365109
10,36,1,47,0.21739130434782608,0.9787234042553191,0.12510910937874142,0.9463756154333293
14,85,2,101,0.1414141414141414,0.9801980198019802,0.13340636767599973,0.9471181896907551
3,24,1,28,0.1111111111111111,0.9642857142857143,0.13340636767599973,0.9572833244469476
6,61,11,78,0.08955223880597014,0.8589743589743589,0.11354648342379137,0.9590262052220864
16,35,1,52,0.3137254901960784,0.9807692307692307,0.14087169922439732,0.9591360953319764
0,1,59,60,0.0,0.016666666666666666,0.12971098493868305,0.8208577070535883
5,162,13,180,0.029940119760479042,0.9277777777777778,0.1290192008050869,0.8153421675044353
17,169,13,199,0.0913978494623656,0.9346733668341709,0.11102013582144968,0.8090493050156998
32,91,13,136,0.2601626016260163,0.9044117647058824,0.12798420156600324,0.7982226971448287
2,54,7,63,0.03571428571428571,0.8888888888888888,0.11721322650931387,0.7874517220881393
32,173,6,211,0.15609756097560976,0.9715639810426541,0.12671970110497668,0.8035359538121816
0,14,51,65,0.0,0.2153846153846154,0.08190177393410834,0.6941952944715222
4,9,1,14,0.3076923076923077,0.9285714285714286,0.1258578178901523,0.8244674033150596
18,49,2,69,0.26865671641791045,0.9710144927536232,0.1599601888412139,0.8306440768830374
0,60,3,63,0.0,0.9523809523809523,0.14690335320373313,0.8331737319611491
31,78,32,141,0.28440366972477066,0.7730496453900709,0.1503663629321266,0.8144077149160331
126,453,11,590,0.21761658031088082,0.9813559322033898,0.17635240501735447,0.8276172925323905
4,49,1,54,0.07547169811320754,0.9814814814814815,0.1648344246084399,0.8290340783093658
20,65,9,94,0.23529411764705882,0.9042553191489362,0.19844786998659117,0.927444178847126
2,0,0,2,1.0,1.0,0.29734896888769,0.9376482604797791
1,15,1,17,0.0625,0.9411764705882353,0.2678980093994171,0.9333856858847236
6,86,2,94,0.06521739130434782,0.9787234042553191,0.2772147795857525,0.9371488932953475
11,110,21,142,0.09090909090909091,0.852112676056338,0.2495726968977983,0.948443611961957
11,43,4,58,0.2037037037037037,0.9310344827586207,0.24758514309677299,0.9412548334698473
3,25,2,30,0.10714285714285714,0.9333333333333333,0.2521095943867229,0.9343765265915402
2,22,0,24,0.08333333333333333,1.0,0.22730503839466848,0.9502819779967876
28,75,14,117,0.27184466019417475,0.8803418803418803,0.12328284699383632,0.9331879609027703
21,87,2,110,0.19444444444444445,0.9818181818181818,0.14213205334304266,0.9389939196499056
27,94,3,124,0.2231404958677686,0.9758064516129032,0.16700646591798998,0.9382849511990017
76,296,42,414,0.20430107526881722,0.8985507246376812,0.1839155480992496,0.9439264257637328
8,84,13,105,0.08695652173913043,0.8761904761904762,0.16678125810139138,0.9354559407955519
4,34,1,39,0.10526315789473684,0.9743589743589743,0.1670405269632011,0.9410095269942994
0,12,2,14,0.0,0.8571428571428571,0.1551357650584392,0.9206013637289934
1,13,2,16,0.07142857142857142,0.875,0.12650489523478156,0.9198382379658676
26,229,15,270,0.10196078431372549,0.9444444444444444,0.11329294378753599,0.9144991326267622
31,123,14,168,0.2012987012987013,0.9166666666666666,0.11017268742052637,0.906050591920157
1,21,4,26,0.045454545454545456,0.8461538461538461,0.08748032601848757,0.8985653235653234
0,32,94,126,0.0,0.25396825396825395,0.07505796577004036,0.8096764346764346
7,38,8,53,0.15555555555555556,0.8490566037735849,0.08224259400730016,0.7917760960213789
10,171,25,206,0.055248618784530384,0.8786407766990292,0.09013525383366165,0.7948472273865462
12,152,2,166,0.07317073170731707,0.9879518072289156,0.09038413387348246,0.81098319984782
14,132,4,150,0.0958904109589041,0.9733333333333334,0.08951693767993656,0.8151101839748042
5,110,2,117,0.043478260869565216,0.9829059829059829,0.06697116047577426,0.8245729434375636
41,176,6,223,0.1889400921658986,0.9730941704035875,0.08746909572025327,0.8427072754732409
10,91,1,102,0.09900990099009901,0.9901960784313726,0.10161336729026742,0.9478826789679723
4,56,1,61,0.06666666666666667,0.9836065573770492,0.08891495459185472,0.9671041009113243
1,29,9,39,0.03333333333333333,0.7692307692307693,0.085784199527398,0.9514740998444299
13,146,4,163,0.08176100628930817,0.9754601226993865,0.08701138161053958,0.9496895734830686
13,113,14,140,0.10317460317460317,0.9,0.0880519804984966,0.9392133830068782
26,94,20,140,0.21666666666666667,0.8571428571428571,0.11279318132665395,0.9212472221835745
12,94,2,108,0.11320754716981132,0.9814814814814815,0.10197424632721289,0.9224454094804164
5,61,1,67,0.07575757575757576,0.9850746268656716,0.09865248557970958,0.9217137735424592
5,124,4,133,0.03875968992248062,0.9699248120300752,0.09466577461625444,0.9197592384928914
10,39,1,50,0.20408163265306123,0.98,0.11905838880478699,0.9498691286027816
13,87,1,101,0.13,0.9900990099009901,0.1259496736206001,0.9519603982030107
3,26,1,30,0.10344827586206896,0.9666666666666667,0.1259887697188095,0.9614842077268202
7,78,11,96,0.08235294117647059,0.8854166666666666,0.1068010946487815,0.9655233233730787
16,37,1,54,0.3018867924528302,0.9814814814814815,0.13375527254635564,0.9655233233730787
0,4,59,63,0.0,0.06349206349206349,0.1229327617238448,0.8338686714625633
6,189,13,208,0.03076923076923077,0.9375,0.12179126755909482,0.8292365554582668
17,203,13,233,0.07727272727272727,0.944206008583691,0.10367570964761855,0.8241231281130798
31,105,13,149,0.22794117647058823,0.912751677852349,0.117667306286274,0.8130735092489881
3,55,7,65,0.05172413793103448,0.8923076923076924,0.11027814372469764,0.8024507986262776
34,188,6,228,0.15315315315315314,0.9736842105263158,0.12039245972136658,0.8150604477490847
0,10,55,65,0.0,0.15384615384615385,0.07726577508524798,0.6968268295154664
4,10,1,15,0.2857142857142857,0.9333333333333333,0.11808210161586022,0.8210898680642192
19,66,2,87,0.2235294117647059,0.9770114942528736,0.14561927032949953,0.8267343672432012
1,61,3,65,0.016129032258064516,0.9538461538461539,0.13688445675597627,0.8281115308521244
31,79,32,142,0.2818181818181818,0.7746478873239436,0.1445811718056325,0.8083824179194952
131,453,11,595,0.2243150684931507,0.9815126050420168,0.16923701902879196,0.8211259768815414
4,55,1,60,0.06779661016949153,0.9833333333333333,0.15704322717398317,0.8225044229968297
21,76,9,106,0.21649484536082475,0.9150943396226415,0.18797106222552953,0.9312541638220422
2,0,0,2,1.0,1.0,0.2900118785520602,0.9407779733458517
1,15,1,17,0.0625,0.9411764705882353,0.2670076768713879,0.9356586842509034
6,96,2,104,0.058823529411764705,0.9807692307692307,0.27310689075048794,0.9395048380970572
11,117,21,149,0.0859375,0.8590604026845637,0.24512393620503334,0.95156376886286
12,46,4,62,0.20689655172413793,0.9354838709677419,0.242635576666603,0.9449882354236779
3,26,2,31,0.10344827586206896,0.9354838709677419,0.2477286717655426,0.9381525979428791
2,22,0,24,0.08333333333333333,1.0,0.2296057643801482,0.9490159855638759
28,75,14,117,0.27184466019417475,0.8803418803418803,0.12558357297931605,0.9319219684698588
19,89,2,110,0.17592592592592593,0.9818181818181818,0.14178727668301974,0.9377279272169939
27,94,3,124,0.2231404958677686,0.9758064516129032,0.1638605688097878,0.9370189587660901
73,299,42,414,0.19623655913978494,0.8985507246376812,0.18064576904685495,0.9436192061016744
6,86,13,105,0.06521739130434782,0.8761904761904762,0.16040588898688493,0.9351487211334936
4,34,1,39,0.10526315789473684,0.9743589743589743,0.16013736052286773,0.9410095269942994
0,12,2,14,0.0,0.8571428571428571,0.14823259861810584,0.9206013637289933
1,13,2,16,0.07142857142857142,0.875,0.11960172879444822,0.9198382379658676
26,229,15,270,0.10196078431372549,0.9444444444444444,0.1090352799927053,0.9144991326267623
31,123,14,168,0.2012987012987013,0.9166666666666666,0.10591502362569569,0.9060505919201569
1,21,4,26,0.045454545454545456,0.8461538461538461,0.08437473595637576,0.8985653235653235
0,36,90,126,0.0,0.2857142857142857,0.07505796577004034,0.8142115820687248
7,38,8,53,0.15555555555555556,0.8490566037735849,0.08224259400730018,0.7963112434136692
9,174,23,206,0.04918032786885246,0.8883495145631068,0.08926835513142195,0.8007693373308477
13,151,2,166,0.07926829268292683,0.9879518072289156,0.0903883153106156,0.8169053097921213
14,132,4,150,0.0958904109589041,0.9733333333333334,0.08952111911706966,0.8210322939191055
5,110,2,117,0.043478260869565216,0.9829059829059829,0.06697534191290737,0.830495053381865
41,176,6,223,0.1889400921658986,0.9730941704035875,0.0874732771573864,0.8486293854175422
10,91,1,102,0.09900990099009901,0.9901960784313726,0.10161754872740054,0.9492696415199832
4,52,5,61,0.07142857142857142,0.9180327868852459,0.08959940813783139,0.9591233819645062
0,30,9,39,0.0,0.7692307692307693,0.0825736470137096,0.9421064183456008
13,146,4,163,0.08176100628930817,0.9754601226993865,0.08292974895747837,0.9403218919842395
14,112,14,140,0.1111111111111111,0.9,0.08510413469350794,0.9298457015080491
26,94,20,140,0.21666666666666667,0.8571428571428571,0.10984533552166528,0.9118795406847454
11,95,2,108,0.10377358490566038,0.9814814814814815,0.09767869162734555,0.9130777279815875
5,61,1,67,0.07575757575757576,0.9850746268656716,0.0943569308798422,0.9123460920436302
5,124,4,133,0.03875968992248062,0.9699248120300752,0.08968994780754354,0.9197592384928914
11,38,1,50,0.22448979591836735,0.98,0.12175991865302459,0.9498691286027816
14,86,1,101,0.14,0.9900990099009901,0.13007977489740913,0.9519603982030107
4,25,1,30,0.13793103448275862,0.9666666666666667,0.1339111925219302,0.9614842077268202
7,78,11,96,0.08235294117647059,0.8854166666666666,0.11472351745190221,0.9655233233730787
17,36,1,54,0.32075471698113206,0.9814814814814815,0.14572082203411243,0.9655233233730787
0,4,59,63,0.0,0.06349206349206349,0.13489831121160162,0.8338686714625633
6,189,13,208,0.03076923076923077,0.9375,0.13375681704685163,0.8292365554582668
17,203,13,233,0.07727272727272727,0.944206008583691,0.11272580724033161,0.8241231281130798
31,106,12,149,0.22627737226277372,0.9194630872483222,0.12505114613501359,0.8140322820198415
4,54,7,65,0.06896551724137931,0.8923076923076924,0.1151989293862451,0.8034095713971309
33,189,6,228,0.14864864864864866,0.9736842105263158,0.12466974473941339,0.816019220519938
0,11,54,65,0.0,0.16923076923076924,0.07884764231353739,0.6999834044841219
4,10,1,15,0.2857142857142857,0.9333333333333333,0.11966396884414963,0.8242464430328748
19,66,2,87,0.2235294117647059,0.9770114942528736,0.14720113755778894,0.8298909422118567
1,61,3,65,0.016129032258064516,0.9538461538461539,0.13846632398426567,0.8312681058207799
31,78,33,142,0.28440366972477066,0.7676056338028169,0.14677008076455095,0.8095741838999935
130,454,11,595,0.2226027397260274,0.9815126050420168,0.16871825540521496,0.8223177428620397
4,55,1,60,0.06779661016949153,0.9833333333333333,0.1571679641939068,0.823696188977328
20,77,9,106,0.20618556701030927,0.9150943396226415,0.18662304519537956,0.9302481276047383
2,0,0,2,1.0,1.0,0.2886638615219102,0.9397719371285478
1,15,1,17,0.0625,0.9411764705882353,0.2656596598412379,0.9346526480335996
5,97,2,104,0.049019607843137254,0.9807692307692307,0.2703583134962483,0.9384988018797534
11,117,21,149,0.0859375,0.8590604026845637,0.24200600353556675,0.95156376886286
12,46,4,62,0.20689655172413793,0.9354838709677419,0.23976226239243972,0.9449882354236779
3,26,2,31,0.10344827586206896,0.9354838709677419,0.24485535749137935,0.9381525979428791
2,22,0,24,0.08333333333333333,1.0,0.23231900518828247,0.9499747583347291
29,75,13,117,0.27884615384615385,0.8888888888888888,0.12929702716630445,0.9341017424617133
23,85,2,110,0.21296296296296297,0.9818181818181818,0.15079173616101343,0.9399077012088485
25,96,3,124,0.2066115702479339,0.9758064516129032,0.16770263275105443,0.9391987327579445
75,297,41,413,0.20161290322580644,0.9007263922518159,0.1853437617833125,0.9451510169818376
8,84,13,105,0.08695652173913043,0.8761904761904762,0.16820947178545428,0.936680532013657
4,34,1,39,0.10526315789473684,0.9743589743589743,0.16794094332143708,0.9425413378744628
0,12,2,14,0.0,0.8571428571428571,0.15603618141667516,0.9221331746091567
1,13,2,16,0.07142857142857142,0.875,0.1264050982141634,0.9201490476250296
26,229,15,270,0.10196078431372549,0.9444444444444444,0.11054764412141518,0.9148099422859243
32,122,14,168,0.2077922077922078,0.9166666666666666,0.11071630662774004,0.9063614015793192
2,20,4,26,0.09090909090909091,0.8461538461538461,0.09490147629678068,0.8985653235653234
1,36,89,126,0.02702702702702703,0.29365079365079366,0.08634011990933733,0.8153453689167973
6,39,8,53,0.13333333333333333,0.8490566037735849,0.09035014497199398,0.7974450302617416
12,171,23,206,0.06557377049180328,0.8883495145631068,0.09971782647082303,0.8019031241789202
13,151,2,166,0.07926829268292683,0.9879518072289156,0.10083778665001665,0.818039096640194
16,130,4,150,0.1095890410958904,0.9733333333333334,0.10192753761889736,0.822166080767178
4,111,2,117,0.034782608695652174,0.9829059829059829,0.07721188060510369,0.8316288402299374
41,176,6,223,0.1889400921658986,0.9730941704035875,0.0912163093560762,0.8497631722656148
10,91,1,102,0.09900990099009901,0.9901960784313726,0.10149957706508651,0.9492696415199833
3,53,5,61,0.05357142857142857,0.9180327868852459,0.09010501924195724,0.9591233819645063
1,29,9,39,0.03333333333333333,0.7692307692307693,0.08549924250503296,0.9421064183456008
12,147,4,163,0.07547169811320754,0.9754601226993865,0.08495687185221593,0.9403218919842395
14,111,15,140,0.112,0.8928571428571429,0.08530129455280301,0.9288252933447838
25,95,20,140,0.20833333333333334,0.8571428571428571,0.1100942552153289,0.9108591325214802
12,94,2,108,0.11320754716981132,0.9814814814814815,0.09927532021588785,0.912057319818322
7,59,1,67,0.10606060606060606,0.9850746268656716,0.10028256379738887,0.9113256838803648
4,125,4,133,0.031007751937984496,0.9699248120300752,0.09705918142118257,0.9187388303296261
12,37,1,50,0.24489795918367346,0.98,0.12728269939980258,0.9488487204395162
15,85,1,101,0.15,0.9900990099009901,0.13792959966934437,0.9509399900397453
3,26,1,30,0.10344827586206896,0.9666666666666667,0.13670792479249708,0.9614842077268202
8,78,10,96,0.09302325581395349,0.8958333333333334,0.1202350565754428,0.9670114186111739
16,37,1,54,0.3018867924528302,0.9814814814814815,0.14718923447301696,0.9670114186111739
0,4,59,63,0.0,0.06349206349206349,0.1320377193215018,0.8353567667006584
6,189,13,208,0.03076923076923077,0.9375,0.13200364486882268,0.830724650696362
17,202,14,233,0.0776255707762557,0.9399141630901288,0.1081075893820487,0.8249981025663804
31,106,12,149,0.22627737226277372,0.9194630872483222,0.11900435684815924,0.8149072564731422
5,53,7,65,0.08620689655172414,0.8923076923076924,0.11654130266096711,0.8042845458504315
32,190,6,228,0.14414414414414414,0.9736842105263158,0.12384428670813723,0.8154060997351432
0,15,50,65,0.0,0.23076923076923078,0.08071760207201863,0.7081614924905361
4,9,2,15,0.3076923076923077,0.8666666666666667,0.12467364602806259,0.8229007215154793
19,66,2,87,0.2235294117647059,0.9770114942528736,0.1522108147417019,0.8285452206944612
1,61,3,65,0.016129032258064516,0.9538461538461539,0.14342559495338889,0.8305355050881793
29,82,32,143,0.26126126126126126,0.7762237762237763,0.14842329338174423,0.8100727463703868
135,449,11,595,0.23116438356164384,0.9815126050420168,0.16913150581173272,0.8228163053324333
4,55,1,60,0.06779661016949153,0.9833333333333333,0.15822471524392526,0.8241947514477215
21,76,9,106,0.21649484536082475,0.9150943396226415,0.18915255029547165,0.9219554812839231
2,0,0,2,1.0,1.0,0.2880536491965705,0.9410031003315421
1,15,1,17,0.0625,0.9411764705882353,0.26504944751589826,0.9358838112365938
7,95,2,104,0.06862745098039216,0.9807692307692307,0.27254922161908796,0.9397299650827475
10,117,22,149,0.07874015748031496,0.8523489932885906,0.2464747782218099,0.9506049960920068
12,46,4,62,0.20689655172413793,0.9354838709677419,0.2430079451021662,0.9440294626528247
3,25,2,30,0.10714285714285714,0.9333333333333333,0.2486288375269327,0.9368866055099675
2,22,0,24,0.08333333333333333,1.0,0.23194284741082227,0.9500943810551303
29,76,12,117,0.2761904761904762,0.8974358974358975,0.12854148686660458,0.9354423664031157
21,87,2,110,0.19444444444444445,0.9818181818181818,0.14739069321581094,0.9412483251502509
27,95,3,125,0.22131147540983606,0.976,0.16627677386134623,0.9405936788257018
73,299,44,416,0.19623655913978494,0.8942307692307693,0.18314985373845835,0.9456180169037312
8,84,13,105,0.08695652173913043,0.8761904761904762,0.1665165239142663,0.9370012368583795
4,34,1,39,0.10526315789473684,0.9743589743589743,0.16624799545024915,0.9428620427191855
0,12,2,14,0.0,0.8571428571428571,0.15434323354548724,0.9224538794538794
1,13,2,16,0.07142857142857142,0.875,0.12509153286521513,0.919248751248751
27,228,15,270,0.10588235294117647,0.9444444444444444,0.11243980550760543,0.9139096459096459
34,119,15,168,0.2222222222222222,0.9107142857142857,0.11256991219508916,0.9045831152974008
2,20,4,26,0.09090909090909091,0.8461538461538461,0.0975231310192757,0.897714983429269
1,37,88,126,0.02631578947368421,0.30158730158730157,0.08886016926706912,0.8156288156288155
6,39,8,53,0.13333333333333333,0.8490566037735849,0.09287019432972576,0.7977284769737599
11,168,25,204,0.061452513966480445,0.8774509803921569,0.10164912489636582,0.8006296374379456
13,151,2,166,0.07926829268292683,0.9879518072289156,0.10276908507555946,0.8167656098992192
14,132,4,150,0.0958904109589041,0.9733333333333334,0.10134166479237769,0.8208925940262033
6,109,2,117,0.05217391304347826,0.9829059829059829,0.07704904919541426,0.8312056936250173
41,176,6,223,0.1889400921658986,0.9730941704035875,0.09105347794638678,0.8493400256606946
10,91,1,102,0.09900990099009901,0.9901960784313726,0.10143835102016034,0.9477127080669904
2,54,5,61,0.03571428571428571,0.9180327868852459,0.08749277278886783,0.9575664485115133
2,28,9,39,0.06666666666666667,0.7692307692307693,0.08823765174603729,0.9421064183456009
12,147,4,163,0.07547169811320754,0.9754601226993865,0.08769528109322024,0.9403218919842397
14,111,15,140,0.112,0.8928571428571429,0.08999665095623395,0.9288252933447838
26,94,20,140,0.21666666666666667,0.8571428571428571,0.11349561575954657,0.9108591325214801
13,93,2,108,0.12264150943396226,0.9814814814814815,0.10402438965498424,0.912057319818322
6,60,1,67,0.09090909090909091,0.9850746268656716,0.10286713107198307,0.9113256838803647
4,125,4,133,0.031007751937984496,0.9699248120300752,0.10219476910394006,0.9187388303296261
10,39,1,50,0.20408163265306123,0.98,0.12182547853056784,0.9488487204395162
15,85,1,101,0.15,0.9900990099009901,0.13247237880010962,0.9509399900397453
5,24,1,30,0.1724137931034483,0.9666666666666667,0.1411029206720308,0.9614842077268202
7,78,11,96,0.08235294117647059,0.8854166666666666,0.1219152456020028,0.9655233233730788
17,36,1,54,0.32075471698113206,0.9814814814814815,0.15021713239445564,0.9655233233730787
0,4,59,63,0.0,0.06349206349206349,0.13723011940744262,0.8338686714625633
6,193,9,208,0.03015075376884422,0.9567307692307693,0.13710769109756543,0.8319838082055195
18,202,13,233,0.08181818181818182,0.944206008583691,0.11964148383543982,0.8268703808603325
32,106,11,149,0.2318840579710145,0.9261744966442953,0.13133920640272762,0.8177383075379475
5,53,7,65,0.08620689655172414,0.8923076923076924,0.11902393546676703,0.8071155969152369
34,188,6,228,0.15315315315315314,0.9736842105263158,0.12913825146343597,0.819725246038044
0,15,50,65,0.0,0.23076923076923078,0.08331614903755995,0.7124806387934368
4,10,1,15,0.2857142857142857,0.9333333333333333,0.1241324755681722,0.8367436773421897
19,66,2,87,0.2235294117647059,0.9770114942528736,0.1517579981390096,0.8396409237739187
2,60,3,65,0.03225806451612903,0.9538461538461539,0.14467798138157348,0.8410180873828421
28,83,32,143,0.25225225225225223,0.7762237762237763,0.14758772342175028,0.8195965558941964
134,450,11,595,0.22945205479452055,0.9815126050420168,0.16805131745643548,0.8323401148562428
4,55,1,60,0.06779661016949153,0.9833333333333333,0.15585752560162666,0.833718560971531
21,76,9,106,0.21649484536082475,0.9150943396226415,0.18678536065317308,0.9314792908077324
2,0,0,2,1.0,1.0,0.2888261769797037,0.9410031003315419
1,15,1,17,0.0625,0.9411764705882353,0.26582197529903145,0.9358838112365937
9,93,2,104,0.08823529411764706,0.9807692307692307,0.2738187223849626,0.9397299650827475
10,118,21,149,0.078125,0.8590604026845637,0.2489434006346408,0.95156376886286
12,46,4,62,0.20689655172413793,0.9354838709677419,0.24572118591030043,0.9449882354236779
3,25,2,30,0.10714285714285714,0.9333333333333333,0.25134207833506694,0.9378453782808208
2,22,0,24,0.08333333333333333,1.0,0.23588898475262135,0.9487235707431532
29,78,10,117,0.27102803738317754,0.9145299145299145,0.13175013295021817,0.936513558533141
20,87,2,109,0.18691588785046728,0.981651376146789,0.14952383121457063,0.9422956878986486
28,94,3,125,0.22950819672131148,0.976,0.17132170547146128,0.9419393130906608
71,299,46,416,0.1918918918918919,0.8894230769230769,0.18456718235330177,0.9464060343127011
9,83,13,105,0.09782608695652174,0.8761904761904762,0.16737350646397373,0.9384041895069825
4,34,1,39,0.10526315789473684,0.9743589743589743,0.1665380845759203,0.944593402592747
0,13,1,14,0.0,0.9285714285714286,0.1546333226711584,0.9343893209600941
1,14,1,16,0.06666666666666667,0.9375,0.12543884114022824,0.9376707617415347
28,228,14,270,0.109375,0.9481481481481482,0.11436157144730434,0.9328845863131576
32,122,14,168,0.2077922077922078,0.9166666666666666,0.11125928731457524,0.9244083958369671
2,24,0,26,0.07692307692307693,1.0,0.09483517089045881,0.9402050991336706
0,62,64,126,0.0,0.49206349206349204,0.08086001561095571,0.8853298156869583
6,46,1,53,0.11538461538461539,0.9811320754716981,0.0823059381095098,0.8862974015602048
9,172,23,204,0.049723756906077346,0.8872549019607843,0.08940933195323512,0.880395040615827
12,152,2,166,0.07317073170731707,0.9879518072289156,0.09033848410189947,0.8876024416485292
14,132,4,150,0.0958904109589041,0.9733333333333334,0.08841211423888577,0.8912003252464127
5,110,2,117,0.043478260869565216,0.9829059829059829,0.06493869324993683,0.9006630847091722
41,176,6,223,0.1889400921658986,0.9730941704035875,0.08094112399891136,0.8968193947668277
10,91,1,102,0.09900990099009901,0.9901960784313726,0.09508539556892551,0.967981192819382
3,57,1,61,0.05,0.9836065573770492,0.08574473622826616,0.968334690234432
1,29,9,39,0.03333333333333333,0.7692307692307693,0.08340324714644558,0.9514740998444299
12,147,4,163,0.07547169811320754,0.9754601226993865,0.08373195663300137,0.9496895734830686
14,112,14,140,0.1111111111111111,0.9,0.08590634236903094,0.9392133830068782
26,94,20,140,0.21666666666666667,0.8571428571428571,0.1106475431971883,0.9212472221835745
13,93,2,108,0.12264150943396226,0.9814814814814815,0.10117631709262596,0.9224454094804164
6,60,1,67,0.09090909090909091,0.9850746268656716,0.1000190585096248,0.9217137735424591
4,125,4,133,0.031007751937984496,0.9699248120300752,0.09730588021505115,0.9197592384928915
10,39,1,50,0.20408163265306123,0.98,0.12169849440358371,0.9498691286027815
15,85,1,101,0.15,0.9900990099009901,0.1323453946731255,0.9519603982030107
4,25,1,30,0.13793103448275862,0.9666666666666667,0.13617681229764655,0.9614842077268202
7,84,5,96,0.07692307692307693,0.9479166666666666,0.11621344233427659,0.9744518948016501
15,38,1,54,0.2830188679245283,0.9814814814814815,0.13912449354721462,0.9744518948016501
0,4,59,63,0.0,0.06349206349206349,0.1261374805602016,0.8427972428911347
6,192,9,207,0.030303030303030304,0.9565217391304348,0.12603680604092246,0.840882518191186
17,205,11,233,0.07657657657657657,0.9527896995708155,0.10782179802999607,0.8369953324155883
33,104,12,149,0.24087591240875914,0.9194630872483222,0.12080407123124738,0.82690448632235
5,54,6,65,0.0847457627118644,0.9076923076923077,0.11320617526397678,0.8184795778974416
33,189,6,228,0.14864864864864866,0.9736842105263158,0.12345268551048702,0.8221606555916772
6,58,1,65,0.09375,0.9846153846153847,0.09641427580698296,0.8226083560393775
4,9,2,15,0.3076923076923077,0.8666666666666667,0.1403703197630269,0.937347585064321
18,67,2,87,0.21176470588235294,0.9770114942528736,0.16629341627435873,0.9402746929389549
1,61,3,65,0.016129032258064516,0.9538461538461539,0.15765805280028558,0.9404256149782891
30,86,27,143,0.25862068965517243,0.8111888111888111,0.16019302097834465,0.9249578612555017
131,453,11,595,0.2243150684931507,0.9815126050420168,0.1801314932328141,0.935503618019746
4,55,1,60,0.06779661016949153,0.9833333333333333,0.16858120202150592,0.9368820641350342
22,75,9,106,0.2268041237113402,0.9150943396226415,0.18758893398026882,0.9269504862789281
2,0,0,2,1.0,1.0,0.2864900328813677,0.945998105326547
1,15,1,17,0.0625,0.9411764705882353,0.265166503469603,0.9408788162315987
9,92,2,103,0.0891089108910891,0.9805825242718447,0.27559220041717797,0.944698297720983
10,118,21,149,0.078125,0.8590604026845637,0.24980710189501049,0.9515370965060906
12,47,4,63,0.2033898305084746,0.9365079365079365,0.24681778218291386,0.9451078581440793
3,25,2,30,0.10714285714285714,0.9333333333333333,0.25243867460768044,0.937965001001222
2,20,0,22,0.09090909090909091,1.0,0.2385410945475883,0.9487235707431532
28,64,15,107,0.30434782608695654,0.8598130841121495,0.13916221256001066,0.9286968684734601
18,69,2,89,0.20689655172413793,0.9775280898876404,0.15979029137774464,0.9338899569448038
25,73,3,101,0.25510204081632654,0.9702970297029703,0.18367457036406445,0.9327188720943832
72,258,50,380,0.21818181818181817,0.868421052631579,0.2006757510016087,0.9341853041319238
7,76,13,96,0.08433734939759036,0.8645833333333334,0.18155511260386187,0.9245252960608988
4,28,1,33,0.125,0.9696969696969697,0.18353923958798887,0.9300485084806631
0,12,2,14,0.0,0.8571428571428571,0.17055222660097585,0.909640345215357
1,7,2,10,0.125,0.8,0.14493110858855354,0.9010956189136213
26,188,15,229,0.12149532710280374,0.9344978165938864,0.13273093364264865,0.8949484370145135
33,108,16,157,0.23404255319148937,0.8980891719745223,0.12972243541052905,0.8846330287675924
1,19,4,24,0.05,0.8333333333333334,0.10569646138455502,0.8796204974392717
0,34,88,122,0.0,0.2786885245901639,0.09364826861347067,0.7959212390473903
5,35,8,48,0.125,0.8333333333333334,0.09364826861347067,0.7764407195668709
12,152,22,186,0.07317073170731707,0.8817204301075269,0.10410123028594453,0.7799518014189665
9,125,2,136,0.06716417910447761,0.9852941176470589,0.09583897015801278,0.8064223896542606
13,124,4,141,0.0948905109489051,0.9716312056737588,0.09203828213602726,0.8117271595228138
5,96,2,103,0.04950495049504951,0.9805825242718447,0.06567576746510728,0.823511924136717
41,176,6,223,0.1889400921658986,0.9730941704035875,0.08552435206023566,0.8434777580038961
6,72,1,79,0.07692307692307693,0.9873417721518988,0.09651336304924664,0.9447139362270011
3,49,1,53,0.057692307692307696,0.9811320754716981,0.08689797843386203,0.9658280422467674
1,27,8,36,0.03571428571428571,0.7777777777777778,0.0815470575777147,0.9509790919139461
12,143,4,159,0.07741935483870968,0.9748427672955975,0.08301208268260497,0.9494860418637374
14,103,14,131,0.11965811965811966,0.8931297709923665,0.08655031249820708,0.9382715511949672
24,80,20,124,0.23076923076923078,0.8387096774193549,0.11244520968023296,0.9180040016446115
13,85,2,100,0.1326530612244898,0.98,0.1044042052600317,0.9189905487298132
7,57,1,65,0.109375,0.9846153846153847,0.10904019427102073,0.9186010647960254
5,110,4,119,0.043478260869565216,0.9663865546218487,0.10700961615348607,0.9164945618174756
9,37,1,47,0.1956521739130435,0.9787234042553191,0.12985788589616573,0.9452010798856959
15,84,1,100,0.15151515151515152,0.99,0.140442999707086,0.9473663988434675
6,21,1,28,0.2222222222222222,0.9642857142857143,0.15509501435910064,0.9575315335996601
6,61,11,78,0.08955223880597014,0.8589743589743589,0.13492115836434915,0.9604264881075179
15,36,1,52,0.29411764705882354,0.9807692307692307,0.15798752776925395,0.960536378217408
0,1,59,60,0.0,0.016666666666666666,0.14236252776925395,0.8222579899390198
5,165,9,179,0.029411764705882353,0.9497206703910615,0.14035302831729926,0.8198771493346214
17,168,13,198,0.0918918918918919,0.9343434343434344,0.1255301308857062,0.8135371536329237
33,92,12,137,0.264,0.9124087591240876,0.14159939495497026,0.8024526906506504
2,54,7,63,0.03571428571428571,0.8888888888888888,0.11495540402526505,0.7916817155939612
30,175,6,211,0.14634146341463414,0.9715639810426541,0.12306815039793133,0.8077659473180032
0,14,51,65,0.0,0.2153846153846154,0.08105134367524225,0.6984252879773438
4,9,1,14,0.3076923076923077,0.9285714285714286,0.12500738763128622,0.8286973968208813
18,49,2,69,0.26865671641791045,0.9710144927536232,0.15918523787586164,0.8317393714441045
1,59,3,63,0.016666666666666666,0.9523809523809523,0.14843877712940093,0.8343161597351784
31,78,33,142,0.28440366972477066,0.7676056338028169,0.15135358709008243,0.8136299989749969
132,447,11,590,0.22797927461139897,0.9813559322033898,0.1788200140753843,0.8268395765913542
4,49,1,54,0.07547169811320754,0.9814814814814815,0.16869576188946622,0.8282563623683296
22,63,9,94,0.25882352941176473,0.9042553191489362,0.20567055180543264,0.9266664629060897
2,0,0,2,1.0,1.0,0.3045716507065315,0.9368705445387427
1,15,1,17,0.0625,0.9411764705882353,0.2751206912182586,0.9326079699436873
7,84,2,93,0.07692307692307693,0.978494623655914,0.2837287498263172,0.936338494411539
12,109,20,141,0.09917355371900827,0.8581560283687943,0.2572673046826369,0.9492742650638214
12,43,4,59,0.21818181818181817,0.9322033898305084,0.2558676680498396,0.9422524732962669
3,24,2,29,0.1111111111111111,0.9310344827586207,0.2609590127638258,0.9350457591930011
2,20,0,22,0.09090909090909091,1.0,0.23672216382701022,0.9493029006474384
28,64,15,107,0.30434782608695654,0.8598130841121495,0.1373432818394326,0.9292761983777453
18,69,2,89,0.20689655172413793,0.9775280898876404,0.15797136065716658,0.934469286849089
28,70,3,101,0.2857142857142857,0.9702970297029703,0.18478208494688245,0.9329732581253375
70,262,48,380,0.21084337349397592,0.8736842105263158,0.203741852588879,0.9358805262957635
8,75,13,96,0.0963855421686747,0.8645833333333334,0.18603421817714008,0.9256055829851061
4,28,1,33,0.125,0.9696969696969697,0.18858523858530332,0.9308003881799112
0,12,2,14,0.0,0.8571428571428571,0.17559822559829036,0.910392224914605
1,7,2,10,0.125,0.8,0.149977107585868,0.9018474986128694
24,191,15,230,0.11162790697674418,0.9347826086956522,0.13636730119338317,0.8957410012997282
32,108,16,156,0.22857142857142856,0.8974358974358975,0.1282040358872607,0.8853322681187178
2,18,4,24,0.1,0.8333333333333334,0.11236926824526415,0.8795678570911489
1,33,88,122,0.029411764705882353,0.2786885245901639,0.10280158575057952,0.7958685986992675
5,35,8,48,0.125,0.8333333333333334,0.10280158575057952,0.7763880792187481
11,154,22,187,0.06666666666666667,0.8823529411764706,0.11232539527438903,0.7799895197949785
10,124,2,136,0.07462686567164178,0.9852941176470589,0.10512923322748072,0.8064601080302728
13,124,4,141,0.0948905109489051,0.9716312056737588,0.10273817665207514,0.8117241933128595
5,97,2,104,0.049019607843137254,0.9807692307692307,0.07708791654803353,0.8236289552176211
41,176,6,223,0.1889400921658986,0.9730941704035875,0.08979364400030476,0.8435947890848005
6,72,1,79,0.07692307692307693,0.9873417721518988,0.09658097431704685,0.9448309673079054
3,49,1,53,0.057692307692307696,0.9811320754716981,0.08696558970166224,0.9659450733276718
1,27,8,36,0.03571428571428571,0.7777777777777778,0.08254382099417924,0.9510057642707156
12,143,4,159,0.07741935483870968,0.9748427672955975,0.08294274801804609,0.9495127142205069
13,104,14,131,0.1111111111111111,0.8931297709923665,0.08525997661264693,0.9382982235517365
24,81,19,124,0.22857142857142856,0.8467741935483871,0.11091023671668855,0.9191560753773304
13,85,2,100,0.1326530612244898,0.98,0.10286923229648728,0.9201426224625322
6,58,1,65,0.09375,0.9846153846153847,0.10527307845033344,0.9197531385287444
5,110,4,119,0.043478260869565216,0.9663865546218487,0.1032425003327988,0.9176466355501945
8,38,1,47,0.17391304347826086,0.9787234042553191,0.12298518001336668,0.9463531536184145
15,84,1,100,0.15151515151515152,0.99,0.13357029382428695,0.9485184725761864
4,23,1,28,0.14814814814814814,0.9642857142857143,0.13886129911529224,0.958683607332379
6,61,11,78,0.08955223880597014,0.8589743589743589,0.1190014148630839,0.9604264881075179
16,36,1,53,0.3076923076923077,0.9811320754716981,0.1440070215013436,0.9605882131749032
0,1,59,60,0.0,0.016666666666666666,0.13061416435848644,0.8223098248965149
5,167,9,181,0.029069767441860465,0.9502762430939227,0.12855580815452863,0.820008351821097
18,168,13,199,0.0967741935483871,0.9346733668341709,0.11753597245026094,0.8137154893323615
32,95,11,138,0.25196850393700787,0.9202898550724637,0.131886451367669,0.8037568971998563
3,53,7,63,0.05357142857142857,0.8888888888888888,0.11837549142813764,0.792985922143167
29,176,6,211,0.14146341463414633,0.9715639810426541,0.12579137368930565,0.8090701538672092
0,17,48,65,0.0,0.26153846153846155,0.08183532973326169,0.7062710661624612
4,9,1,14,0.3076923076923077,0.9285714285714286,0.12579137368930565,0.8365431750059986
18,49,2,69,0.26865671641791045,0.9710144927536232,0.16001808068588422,0.8395057821002414
1,59,3,63,0.016666666666666666,0.9523809523809523,0.14857414827420987,0.8420354371783532
31,79,32,142,0.2818181818181818,0.7746478873239436,0.15283838797152044,0.8212294417857073
128,452,11,591,0.2206896551724138,0.9813874788494078,0.17671242034308973,0.8344435260657814
4,49,1,54,0.07547169811320754,0.9814814814814815,0.16728503226866992,0.8358603118427569
22,63,9,94,0.25882352941176473,0.9042553191489362,0.20425982218463634,0.9276770057871103
2,0,0,2,1.0,1.0,0.3031609210857352,0.9378810874197633
1,15,1,17,0.0625,0.9411764705882353,0.2737099615974623,0.933618512824708
8,83,2,93,0.08791208791208792,0.978494623655914,0.28388787891823675,0.9373490372925596
12,109,20,141,0.09917355371900827,0.8581560283687943,0.2577957891897834,0.9492787717275384
12,43,4,59,0.21818181818181817,0.9322033898305084,0.25743752676255544,0.942252473296267
3,24,2,29,0.1111111111111111,0.9310344827586207,0.2625288714765417,0.9350457591930011
2,22,0,24,0.08333333333333333,1.0,0.23954966011494702,0.9483505196950573
28,74,15,117,0.27450980392156865,0.8717948717948718,0.135908203532314,0.930035501380039
16,92,2,110,0.14814814814814814,0.9818181818181818,0.14814365326776374,0.9358414601271744
27,94,3,124,0.2231404958677686,0.9758064516129032,0.16461470449817323,0.9351324916762704
73,291,52,416,0.20054945054945056,0.875,0.18201603207947833,0.9391801107238894
6,86,13,105,0.06521739130434782,0.8761904761904762,0.15743449718106797,0.9305633306785379
4,35,1,40,0.10256410256410256,0.975,0.15678038938410305,0.9365157116309188
0,12,2,14,0.0,0.8571428571428571,0.14487562747934116,0.9161075483656127
2,12,2,16,0.14285714285714285,0.875,0.12606810447013744,0.9165654238234883
25,230,15,270,0.09803921568627451,0.9444444444444444,0.11890968554701263,0.9112263184843828
30,125,16,171,0.1935483870967742,0.9064327485380117,0.11468224143687057,0.9013157894736841
1,21,4,26,0.045454545454545456,0.8461538461538461,0.09252582642331271,0.8971949103528049
1,31,94,126,0.03125,0.25396825396825395,0.08767334195126301,0.808306021463916
6,39,8,53,0.13333333333333333,0.8490566037735849,0.09206894634686742,0.7903141077172853
10,170,25,205,0.05555555555555555,0.8780487804878049,0.10000545428337536,0.7933006681951351
11,153,2,166,0.06707317073170732,0.9879518072289156,0.08917917255117026,0.8094366406564087
14,132,4,150,0.0958904109589041,0.9733333333333334,0.08887220044726021,0.8135636247833927
5,110,2,117,0.043478260869565216,0.9829059829059829,0.06743361098623037,0.8244883725502458
41,176,6,223,0.1889400921658986,0.9730941704035875,0.08793154623070938,0.8426227045859233
10,91,1,102,0.09900990099009901,0.9901960784313726,0.09761153208643782,0.9477981080806545
3,53,5,61,0.05357142857142857,0.9180327868852459,0.08621697426330856,0.9576518485251775
1,29,9,39,0.03333333333333333,0.7692307692307693,0.08304237108870538,0.9421064183456008
13,146,4,163,0.08176100628930817,0.9754601226993865,0.0851406333112198,0.9403218919842395
14,102,24,140,0.1206896551724138,0.8285714285714286,0.08868338248457831,0.919641619875396
26,94,20,140,0.21666666666666667,0.8571428571428571,0.11342458331273567,0.9016754590520925
12,94,2,108,0.11320754716981132,0.9814814814814815,0.10260564831329463,0.9028736463489343
6,59,2,67,0.09230769230769231,0.9701492537313433,0.10164818993009368,0.9000098142489302
6,122,5,133,0.046875,0.9624060150375939,0.10069155727703245,0.9063488468421228
10,39,1,50,0.20408163265306123,0.98,0.12508417146556502,0.9364587369520129
14,86,1,101,0.14,0.9900990099009901,0.13340402770994955,0.9385500065522419
5,24,1,30,0.1724137931034483,0.9666666666666667,0.1407931902715259,0.9582778977087045
8,78,10,96,0.09302325581395349,0.8958333333333334,0.12312984586399546,0.9638051085930582
15,39,2,56,0.2777777777777778,0.9642857142857143,0.14663987880799065,0.9613485704222343
0,4,59,63,0.0,0.06349206349206349,0.13345306562117748,0.8318261146737659
5,194,9,208,0.02512562814070352,0.9567307692307693,0.13034601249842084,0.8310153652727909
21,197,13,231,0.0963302752293578,0.9437229437229437,0.11495296143789178,0.8258329286617829
31,106,13,150,0.22627737226277372,0.9133333333333333,0.12727830033257373,0.8148664034378319
4,54,7,65,0.06896551724137931,0.8923076923076924,0.11249997520942102,0.8042436928151213
32,191,6,229,0.14349775784753363,0.9737991266375546,0.11971061835707533,0.8153816632871529
0,16,49,65,0.0,0.24615384615384617,0.08002807867453565,0.7127913964111717
4,10,1,15,0.2857142857142857,0.9333333333333333,0.1208444052051479,0.8370544349599245
19,66,2,87,0.2235294117647059,0.9770114942528736,0.14918780286571967,0.8399516813916537
0,62,3,65,0.0,0.9538461538461539,0.1354263349758114,0.841397854266398
31,79,32,142,0.2818181818181818,0.7746478873239436,0.1433607363408697,0.8215856476936282
131,453,11,595,0.2243150684931507,0.9815126050420168,0.16555352937683707,0.8343292066556744
4,55,1,60,0.06779661016949153,0.9833333333333333,0.15473907970854534,0.8356912361836429
21,76,9,106,0.21649484536082475,0.9150943396226415,0.18566691476009173,0.9312541638220422
2,0,0,2,1.0,1.0,0.28770773108662234,0.9407779733458517
1,15,1,17,0.0625,0.9411764705882353,0.26470352940595004,0.9356586842509034
10,92,2,104,0.09803921568627451,0.9807692307692307,0.2787091316468464,0.9395048380970572
10,118,22,150,0.078125,0.8533333333333334,0.24961010567282044,0.9507456160983985
13,46,4,63,0.22033898305084745,0.9365079365079365,0.2490420934667771,0.944316377736387
3,25,2,30,0.10714285714285714,0.9333333333333333,0.2546629858915436,0.93717352059353
2,22,0,24,0.08333333333333333,1.0,0.23733376874596926,0.9502552815998193
28,74,15,117,0.27450980392156865,0.8717948717948718,0.13369231216333619,0.931940263284801
16,92,2,110,0.14814814814814814,0.9818181818181818,0.14592776189878595,0.9377462220319362
26,95,3,124,0.21487603305785125,0.9758064516129032,0.15841705513674229,0.9370372535810324
72,292,52,416,0.1978021978021978,0.875,0.17560031484491895,0.9391801107238894
9,83,13,105,0.09782608695652174,0.8761904761904762,0.1605197800517828,0.9305633306785379
4,35,1,40,0.10256410256410256,0.975,0.15986567225481788,0.9365157116309187
0,12,2,14,0.0,0.8571428571428571,0.14796091035005596,0.9161075483656127
2,12,2,16,0.14285714285714285,0.875,0.12915338734085227,0.9165654238234883
25,230,15,270,0.09803921568627451,0.9444444444444444,0.12199496841772747,0.911226318484383
31,124,16,171,0.2,0.9064327485380117,0.11986982083803444,0.9013157894736841
1,21,4,26,0.045454545454545456,0.8461538461538461,0.09810587050265551,0.8971949103528049
1,31,94,126,0.03125,0.25396825396825395,0.08859500093743812,0.8083060214639161
6,39,8,53,0.13333333333333333,0.8490566037735849,0.09299060533304251,0.7903141077172854
11,171,23,205,0.06043956043956044,0.8878048780487805,0.10162482825297972,0.7946943964181316
10,154,2,166,0.06097560975609756,0.9879518072289156,0.08992746638140184,0.8108303688794052
14,132,4,150,0.0958904109589041,0.9733333333333334,0.08962049427749176,0.8149573530063893
5,110,2,117,0.043478260869565216,0.9829059829059829,0.06726024583028681,0.8258821007732423
41,176,6,223,0.1889400921658986,0.9730941704035875,0.08775818107476582,0.8440164328089198
11,90,1,102,0.10891089108910891,0.9901960784313726,0.09885259408749568,0.9491918363036509
3,53,5,61,0.05357142857142857,0.9180327868852459,0.08745803626436642,0.9590455767481739
1,29,9,39,0.03333333333333333,0.7692307692307693,0.08358571810633397,0.9421064183456009
13,146,4,163,0.08176100628930817,0.9754601226993865,0.08655506046822123,0.9403218919842395
15,111,14,140,0.11904761904761904,0.9,0.08986323305232334,0.9298457015080491
27,92,21,140,0.226890756302521,0.85,0.11606501811417418,0.9108591325214801
12,94,2,108,0.11320754716981132,0.9814814814814815,0.10524608311473314,0.912057319818322
6,60,1,67,0.09090909090909091,0.9850746268656716,0.10267439737473054,0.9113256838803648
5,124,4,133,0.03875968992248062,0.9699248120300752,0.10055843471059514,0.9187388303296261
10,39,1,50,0.20408163265306123,0.98,0.1249510488991277,0.9488487204395162
14,86,1,101,0.14,0.9900990099009901,0.13327090514351225,0.9509399900397454
4,25,1,30,0.13793103448275862,0.9666666666666667,0.13596853591996075,0.9604637995635549
9,76,11,96,0.10588235294117647,0.8854166666666666,0.11868162115405438,0.9655233233730787
17,37,2,56,0.3148148148148148,0.9642857142857143,0.1474826593890549,0.9630667852022547
0,4,59,63,0.0,0.06349206349206349,0.13449564640204192,0.8314121332917395
5,194,9,208,0.02512562814070352,0.9567307692307693,0.13254792329035947,0.8295272700346957
19,199,14,232,0.0871559633027523,0.9396551724137931,0.11584425624031533,0.823763723236666
31,106,13,150,0.22627737226277372,0.9133333333333333,0.1281695951349973,0.8127971980127151
4,54,7,65,0.06896551724137931,0.8923076923076924,0.1183173783862288,0.8021744873900045
30,193,6,229,0.13452914798206278,0.9737991266375546,0.122409777677784,0.8148005531001316
0,14,51,65,0.0,0.2153846153846154,0.07743623270423902,0.7078146818285458
4,10,1,15,0.2857142857142857,0.9333333333333333,0.11825255923485126,0.8320777203772985
19,66,2,87,0.2235294117647059,0.9770114942528736,0.146595956895423,0.8349749668090277
0,62,3,65,0.0,0.9538461538461539,0.13414510499502985,0.8370022498707936
31,79,33,143,0.2818181818181818,0.7692307692307693,0.14207950636008815,0.8164161692847131
134,450,11,595,0.22945205479452055,0.9815126050420168,0.16500615458196546,0.8291597282467594
4,55,1,60,0.06779661016949153,0.9833333333333333,0.15547293489445527,0.8305217577747278
21,76,9,106,0.21649484536082475,0.9150943396226415,0.18640076994600172,0.9304802898087317
2,0,0,2,1.0,1.0,0.28844158627253236,0.9400040993325411
1,15,1,17,0.0625,0.9411764705882353,0.26543738459186,0.9348848102375928
11,91,2,104,0.10784313725490197,0.9807692307692307,0.28084354705684605,0.9387309640837466
10,117,23,150,0.07874015748031496,0.8466666666666667,0.25183240072286506,0.9497932351460177
14,45,4,63,0.23728813559322035,0.9365079365079365,0.25295184083696504,0.9433639967840062
3,25,2,30,0.10714285714285714,0.9333333333333333,0.2585727332617315,0.9362211396411491
2,22,0,24,0.08333333333333333,1.0,0.23506309303382394,0.9473981387426764
29,74,14,117,0.2815533980582524,0.8803418803418803,0.13242786418500282,0.9303041216486593
16,92,2,110,0.14814814814814814,0.9818181818181818,0.14466331392045256,0.9361100803957945
27,94,3,124,0.2231404958677686,0.9758064516129032,0.15973380492677244,0.9354011119448906
75,287,54,416,0.20718232044198895,0.8701923076923077,0.17912719764297494,0.9397142987580773
6,86,13,105,0.06521739130434782,0.8761904761904762,0.15938827775667114,0.9310975187127261
4,35,1,40,0.10256410256410256,0.975,0.1587341699597062,0.9370498996651069
0,12,2,14,0.0,0.8571428571428571,0.14682940805494432,0.9166417363998008
2,12,2,16,0.14285714285714285,0.875,0.12701565731192863,0.915878610636675
26,230,14,270,0.1015625,0.9481481481481482,0.12036056471933605,0.9110686058266702
32,123,16,171,0.2064516129032258,0.9064327485380117,0.1179764385815442,0.9011580768159714
2,20,4,26,0.09090909090909091,0.8461538461538461,0.10136597721970164,0.8977240108819056
0,34,92,126,0.0,0.2698412698412698,0.09204920703336625,0.8111026956891617
6,39,8,53,0.13333333333333333,0.8490566037735849,0.09644481142897063,0.7931107819425309
9,173,23,205,0.04945054945054945,0.8878048780487805,0.10350917563619198,0.7974910706433772
11,153,2,166,0.06707317073170732,0.9879518072289156,0.0926828939039869,0.8136270431046508
13,133,4,150,0.08904109589041095,0.9733333333333334,0.09089412188833133,0.8172249267025344
5,110,2,117,0.043478260869565216,0.9829059829059829,0.06761221445495125,0.8281496744693875
42,175,6,223,0.1935483870967742,0.9730941704035875,0.08227497105319172,0.8462840065050649
10,91,1,102,0.09900990099009901,0.9901960784313726,0.09641924262320586,0.9491918363036509
2,54,5,61,0.03571428571428571,0.9180327868852459,0.08247366439191335,0.9590455767481739
1,29,9,39,0.03333333333333333,0.7692307692307693,0.08017120494659676,0.9421064183456008
13,146,4,163,0.08176100628930817,0.9754601226993865,0.08226946716911117,0.9403218919842395
14,112,14,140,0.1111111111111111,0.9,0.08542232648635405,0.9298457015080491
27,94,19,140,0.2231404958677686,0.8642857142857143,0.11108836005752597,0.9128999488480108
13,93,2,108,0.12264150943396226,0.9814814814814815,0.10095880610569567,0.9140981361448528
6,60,1,67,0.09090909090909091,0.9850746268656716,0.09980154752269452,0.9133665002068955
5,124,4,133,0.03875968992248062,0.9699248120300752,0.10023660526672237,0.9207796466561567
10,39,1,50,0.20408163265306123,0.98,0.12462921945525493,0.9508895367660469
16,84,1,101,0.16,0.9900990099009901,0.13580621855678235,0.952980806366276
5,24,1,30,0.1724137931034483,0.9666666666666667,0.14456374455568763,0.9625046158900855
8,77,11,96,0.09411764705882353,0.8854166666666666,0.12613190901155263,0.9655233233730787
14,41,1,56,0.2545454545454545,0.9821428571428571,0.1449753297417658,0.965617805610418
0,4,59,63,0.0,0.06349206349206349,0.13198831675475284,0.8339631536999026
5,194,9,208,0.02512562814070352,0.9567307692307693,0.13004059364307038,0.832078290442859
20,199,13,232,0.091324200913242,0.9439655172413793,0.1139323891088105,0.8269305071916273
33,106,11,150,0.23741007194244604,0.9266666666666666,0.1249909708148742,0.8178687438724382
3,55,7,65,0.05172413793103448,0.8923076923076924,0.10774959150452937,0.8072460332497278
29,194,6,229,0.13004484304932734,0.9737991266375546,0.11288204807460135,0.8198720989598546
1,17,47,65,0.05555555555555555,0.27692307692307694,0.08445491964747294,0.7191264160713144
4,9,2,15,0.3076923076923077,0.8666666666666667,0.1284109636035169,0.8338656450962578
19,66,2,87,0.2235294117647059,0.9770114942528736,0.15675436126408865,0.836762891527987
1,61,3,65,0.016129032258064516,0.9538461538461539,0.146012194313349,0.8381744110429549
30,81,32,143,0.2702702702702703,0.7762237762237763,0.15070650836018107,0.8166825695511133
137,447,11,595,0.2345890410958904,0.9815126050420168,0.17683006595516046,0.8294261285131597
4,55,1,60,0.06779661016949153,0.9833333333333333,0.16793746125804107,0.830788158041128
22,75,9,106,0.2268041237113402,0.9150943396226415,0.19240154242315316,0.9219554812839231
2,0,0,2,1.0,1.0,0.29130264132425204,0.9410031003315421
1,15,1,17,0.0625,0.9411764705882353,0.2682984396435798,0.9358838112365938
13,89,2,104,0.12745098039215685,0.9807692307692307,0.2842015750913073,0.9397299650827475
10,119,21,150,0.07751937984496124,0.86,0.2566657336019774,0.9516979970507796
12,47,4,63,0.2033898305084746,0.9365079365079365,0.25220870351806085,0.9452687586887681
3,25,2,30,0.10714285714285714,0.9333333333333333,0.2578295959428274,0.9381259015459109
2,22,0,24,0.08333333333333333,1.0,0.2355463632649933,0.9512076625522001
30,74,13,117,0.28846153846153844,0.8888888888888888,0.13389801161664167,0.9353346466791843
19,89,2,110,0.17592592592592593,0.9818181818181818,0.15010171532034539,0.9411406054263195
27,94,3,124,0.2231404958677686,0.9758064516129032,0.16657276655075487,0.9404316369754157
73,287,56,416,0.20277777777777778,0.8653846153846154,0.18345310843109677,0.9402484867922655
6,86,13,105,0.06521739130434782,0.8761904761904762,0.16371418854479294,0.931631706746914
4,35,1,40,0.10256410256410256,0.975,0.163060080747828,0.937584087699295
0,12,2,14,0.0,0.8571428571428571,0.15115531884306607,0.9171759244339889
2,12,2,16,0.14285714285714285,0.875,0.13035469089958102,0.9151917974498618
28,228,14,270,0.109375,0.9481481481481482,0.12084741576730587,0.9103817926398571
32,123,15,170,0.2064516129032258,0.9117647058823529,0.11846328962951405,0.9012329718212069
1,21,4,26,0.045454545454545456,0.8461538461538461,0.09598854215476658,0.8984857190739542
0,36,90,126,0.0,0.2857142857142857,0.08667177196843116,0.8141319775773556
6,39,8,53,0.13333333333333333,0.8490566037735849,0.09106737636403557,0.7961400638307249
12,168,25,205,0.06666666666666667,0.8780487804878049,0.1005911858878451,0.7991266243085746
11,153,2,166,0.06707317073170732,0.9879518072289156,0.08976490415564001,0.8152625967698482
14,133,3,150,0.09523809523809523,0.98,0.08774534633251077,0.8198128613201128
5,110,2,117,0.043478260869565216,0.9829059829059829,0.06446343889913068,0.829975900894917
42,175,6,223,0.1935483870967742,0.9730941704035875,0.08561970199087765,0.8481102329305943
10,91,1,102,0.09900990099009901,0.9901960784313726,0.0997639735608918,0.9487504890330353
3,56,2,61,0.05084745762711865,0.9672131147540983,0.08798027703143256,0.9656299906016802
1,29,9,39,0.03333333333333333,0.7692307692307693,0.08321837226952779,0.9500845604221037
13,146,4,163,0.08176100628930817,0.9754601226993865,0.0853166344920422,0.9483000340607424
13,103,24,140,0.11206896551724138,0.8285714285714286,0.08772104453192021,0.9266673809995177
27,92,21,140,0.226890756302521,0.85,0.11392282959377106,0.9076808120129487
12,94,2,108,0.11320754716981132,0.9814814814814815,0.10244556674706207,0.9088789993097909
5,61,1,67,0.07575757575757576,0.9850746268656716,0.09912380599955874,0.9081473633718335
7,122,4,133,0.05426356589147287,0.9699248120300752,0.09961182146589508,0.9085347486969731
11,38,1,50,0.22448979591836735,0.98,0.12691988754947134,0.9386446388068632
16,84,1,101,0.16,0.9900990099009901,0.13809688665099876,0.9407359084070922
5,24,1,30,0.1724137931034483,0.9666666666666667,0.1467175763061712,0.9604637995635549
10,75,11,96,0.11764705882352941,0.8854166666666666,0.13111133380917236,0.9655233233730788
18,37,1,56,0.32727272727272727,0.9821428571428571,0.16169207382387465,0.9656178056104181
0,4,59,63,0.0,0.06349206349206349,0.15086956300136384,0.8339631536999026
6,193,9,208,0.03015075376884422,0.9567307692307693,0.147424875555274,0.8320782904428589
19,200,13,232,0.0867579908675799,0.9439655172413793,0.1277489034051615,0.8269305071916274
28,108,14,150,0.20588235294117646,0.9066666666666666,0.13430352525390102,0.8150116010152955
2,56,7,65,0.034482758620689655,0.8923076923076924,0.11459909175636407,0.8043888903925849
29,194,6,229,0.13004484304932734,0.9737991266375546,0.11637020378862092,0.8170149561027117
0,17,48,65,0.0,0.26153846153846155,0.06961695703537416,0.7140714710163695
4,9,2,15,0.3076923076923077,0.8666666666666667,0.11357300099141811,0.8288107000413129
19,66,2,87,0.2235294117647059,0.9770114942528736,0.1411985235622555,0.831707946473042
1,61,3,65,0.016129032258064516,0.9538461538461539,0.13110867233232473,0.8331194659880098
31,80,32,143,0.27927927927927926,0.7762237762237763,0.14159394752348226,0.8144847673533111
128,456,11,595,0.2191780821917808,0.9815126050420168,0.16797899374792388,0.8272283263153575
4,55,1,60,0.06779661016949153,0.9833333333333333,0.1590863890508045,0.8285903558433259
22,75,9,106,0.2268041237113402,0.9150943396226415,0.1914869781524245,0.9219554812839231
2,0,0,2,1.0,1.0,0.2903880770535234,0.9410031003315421
1,15,1,17,0.0625,0.9411764705882353,0.26738387537285113,0.9358838112365938
12,90,2,104,0.11764705882352941,0.9807692307692307,0.281886450596489,0.9397299650827475
9,117,24,150,0.07142857142857142,0.84,0.25219349233210214,0.9488408541936367
12,47,4,63,0.2033898305084746,0.9365079365079365,0.2499380278059155,0.9424116158316252
3,25,2,30,0.10714285714285714,0.9333333333333333,0.255558920230682,0.9352687586887681
2,22,0,24,0.08333333333333333,1.0,0.24643188100980332,0.9478602346985164
30,77,10,117,0.2803738317757009,0.9145299145299145,0.1436281426920463,0.9356502224885042
19,89,2,110,0.17592592592592593,0.9818181818181818,0.15983184639575,0.9414561812356396
26,95,3,124,0.21487603305785125,0.9758064516129032,0.17169011799428135,0.9410721566580665
72,291,53,416,0.19834710743801653,0.8725961538461539,0.18585776852556823,0.9439983677708975
7,85,13,105,0.07608695652173914,0.8761904761904762,0.16815590517153095,0.9359965229651784
4,35,1,40,0.10256410256410256,0.975,0.16164389865952447,0.9422773111425183
0,13,1,14,0.0,0.9285714285714286,0.14973913675476255,0.9320732295098653
2,13,1,16,0.13333333333333333,0.9375,0.12873335126299576,0.9353546702913061
26,229,15,270,0.10196078431372549,0.9444444444444444,0.11816690246125283,0.9300155649522007
32,123,15,170,0.2064516129032258,0.9117647058823529,0.11696341386773493,0.9208667441335506
3,23,0,26,0.11538461538461539,1.0,0.10511162928867761,0.9390672935841001
1,65,60,126,0.015151515151515152,0.5238095238095238,0.09640656623578847,0.8887271575296785
6,46,1,53,0.11538461538461539,0.9811320754716981,0.0982380680672903,0.8896031683113497
11,170,23,204,0.06077348066298342,0.8872549019607843,0.10691999387628792,0.8837008073669718
11,153,2,166,0.06707317073170732,0.9879518072289156,0.09745425636176994,0.890908208399674
12,135,3,150,0.08163265306122448,0.98,0.09455023761141265,0.8959875734790391
6,109,2,117,0.05217391304347826,0.9829059829059829,0.07251056620287728,0.9061506130538434
43,174,6,223,0.19815668202764977,0.9730941704035875,0.08433514715188219,0.9023069231114987
10,91,1,102,0.09900990099009901,0.9901960784313726,0.09631491655739417,0.9689335737717629
2,58,1,61,0.03333333333333333,0.9836065573770492,0.08459330483578244,0.969287071186813
1,29,9,39,0.03333333333333333,0.7692307692307693,0.08067328378868957,0.9524264807968109
13,146,4,163,0.08176100628930817,0.9754601226993865,0.08277154601120398,0.9506419544354495
15,111,14,140,0.11904761904761904,0.9,0.0881165411521175,0.9392133830068782
28,92,20,140,0.23333333333333334,0.8571428571428571,0.1139964583363825,0.9212472221835745
13,93,2,108,0.12264150943396226,0.9814814814814815,0.1032085765372843,0.9224454094804164
5,61,1,67,0.07575757575757576,0.9850746268656716,0.09988681578978097,0.9217137735424592
4,124,4,132,0.03125,0.9696969696969697,0.09958919674216192,0.9197266895881622
10,39,1,50,0.20408163265306123,0.98,0.12398181093069448,0.9498365796980524
16,84,1,101,0.16,0.9900990099009901,0.13515881003222188,0.9519278492982813
4,25,1,30,0.13793103448275862,0.9666666666666667,0.13785644080867038,0.9614516588220907
9,83,4,96,0.09782608695652174,0.9583333333333334,0.11849826275484017,0.975907441135016
16,39,1,56,0.2909090909090909,0.9821428571428571,0.14253648867985855,0.9760019233723554
0,4,59,63,0.0,0.06349206349206349,0.13171397785734773,0.84434727146184
6,192,9,207,0.030303030303030304,0.9565217391304348,0.13157869647206635,0.8424650956666208
18,203,11,232,0.08144796380090498,0.9525862068965517,0.11405960092175829,0.8385488395089852
32,107,11,150,0.2302158273381295,0.9266666666666666,0.12409043339863393,0.8294870761897961
4,54,7,65,0.06896551724137931,0.8923076923076924,0.11423821664986547,0.8188643655670854
30,193,6,229,0.13452914798206278,0.9737991266375546,0.11948151108208563,0.8210737646105457
5,58,2,65,0.07936507936507936,0.9692307692307692,0.0892609380043697,0.8192291806231047
4,10,1,15,0.2857142857142857,0.9333333333333333,0.13007726453498195,0.9434922191718573
19,66,2,87,0.2235294117647059,0.9770114942528736,0.1576810333152213,0.9464193270464916
2,60,3,65,0.03225806451612903,0.9538461538461539,0.1506539048459676,0.9465993194678634
29,85,29,143,0.2543859649122807,0.7972027972027972,0.1541067816422749,0.9281044809730247
135,454,5,594,0.22920203735144312,0.9915824915824916,0.17699771308656972,0.9422865951551389
4,55,1,60,0.06779661016949153,0.9833333333333333,0.16746449339905958,0.9436486246831073
23,74,9,106,0.23711340206185566,0.9150943396226415,0.18999996807002756,0.9359148490248034
2,0,0,2,1.0,1.0,0.2920407843965582,0.945438658548613
1,15,1,17,0.0625,0.9411764705882353,0.26903658271588593,0.9403193694536646
11,91,2,104,0.10784313725490197,0.9807692307692307,0.27983445024999637,0.9441655232998184
11,119,20,150,0.08461538461538462,0.8666666666666667,0.25558151020758263,0.9540889332232283
12,47,4,63,0.2033898305084746,0.9365079365079365,0.25189405208715854,0.9462211396411491
3,25,2,30,0.10714285714285714,0.9333333333333333,0.257514944511925,0.939078282498292
1,21,0,22,0.045454545454545456,1.0,0.236194921177357,0.9480079742828759
29,64,14,107,0.3118279569892473,0.8691588785046729,0.13788462931867804,0.9293163854978291
15,73,2,90,0.17045454545454544,0.9777777777777777,0.15330670724075596,0.9345451436677638
27,71,3,101,0.2755102040816326,0.9702970297029703,0.17853657940940362,0.9333740588173433
72,251,57,380,0.22291021671826625,0.85,0.1963293738351981,0.9329245083677927
6,77,13,96,0.07228915662650602,0.8645833333333334,0.17808496763898468,0.9232645002967678
4,28,1,33,0.125,0.9696969696969697,0.1747780893321064,0.9287877127165319
0,12,2,14,0.0,0.8571428571428571,0.1682845828385999,0.9083795494512258
1,7,2,10,0.125,0.8,0.14159487469727886,0.898499709664844
24,191,15,230,0.11162790697674418,0.9347826086956522,0.1331910692004501,0.8923575426531116
30,110,15,155,0.21428571428571427,0.9032258064516129,0.1244447135153189,0.8827759393314892
2,18,4,24,0.1,0.8333333333333334,0.10688611112699516,0.8803949869505369
2,31,89,122,0.06060606060606061,0.27049180327868855,0.10521709740978866,0.7955247683713018
3,37,8,48,0.075,0.8333333333333334,0.09807424026693153,0.7760442488907824
13,151,22,186,0.07926829268292683,0.8817204301075269,0.1093982820787782,0.7795553307428781
9,124,2,135,0.06766917293233082,0.9851851851851852,0.10120816392625402,0.8060103571979045
12,127,3,142,0.08633093525179857,0.9788732394366197,0.09759431082269036,0.8123090187323285
5,96,2,103,0.04950495049504951,0.9805825242718447,0.07405420170973828,0.823359978420933
43,174,6,223,0.19815668202764977,0.9730941704035875,0.08807658485654538,0.8433258122881121
6,72,1,79,0.07692307692307693,0.9873417721518988,0.09040758718754771,0.9457329506985708
3,49,1,53,0.057692307692307696,0.9811320754716981,0.08793505971502025,0.9668470567183372
1,27,8,36,0.03571428571428571,0.7777777777777778,0.08171305871950009,0.9519981063855159
12,142,4,158,0.07792207792207792,0.9746835443037974,0.08317775943232109,0.950497871973889
13,94,24,131,0.12149532710280374,0.816793893129771,0.08820124398246468,0.9273436796443392
26,78,19,123,0.25,0.8455284552845529,0.11684339391174332,0.9080502412175832
12,86,2,100,0.12244897959183673,0.98,0.10602800784948432,0.9090367883027851
6,58,1,65,0.09375,0.9846153846153847,0.10843185400333047,0.9086473043689974
3,111,4,118,0.02631578947368421,0.9661016949152542,0.10394949425781284,0.9065001071466481
8,38,1,47,0.17391304347826086,0.9787234042553191,0.12369217393838072,0.9352066252148683
15,84,1,100,0.15151515151515152,0.99,0.13420547016596265,0.9373946903143259
4,23,1,28,0.14814814814814814,0.9642857142857143,0.1380130160295833,0.9584649504794607
7,60,11,78,0.1044776119402985,0.8589743589743589,0.11722410344962593,0.9603857938637186
16,36,1,53,0.3076923076923077,0.9811320754716981,0.14368743603540748,0.960547518931104
0,1,59,60,0.0,0.016666666666666666,0.13029457889255036,0.8222691306527157
6,160,13,179,0.03614457831325301,0.9273743016759777,0.13169869158391734,0.8167366459042477
18,168,13,199,0.0967741935483871,0.9346733668341709,0.12067885587964965,0.8104437834155123
30,96,12,138,0.23809523809523808,0.9130434782608695,0.13304743967680485,0.7994499945956364
3,53,7,63,0.05357142857142857,0.8888888888888888,0.11953647973727351,0.7886790195389471
30,175,6,211,0.14634146341463414,0.9715639810426541,0.12551702994789288,0.8047632512629893
0,16,48,64,0.0,0.25,0.08156098599184892,0.7003158119098896
4,8,2,14,0.3333333333333333,0.8571428571428571,0.12918003361089653,0.820383839120774
18,49,2,69,0.26865671641791045,0.9710144927536232,0.16239605334013332,0.8266181521318661
1,59,3,63,0.016666666666666666,0.9523809523809523,0.15095212092845897,0.8291478072099777
31,79,32,142,0.2818181818181818,0.7746478873239436,0.15719825574602236,0.8093770085047026
128,457,5,590,0.2188034188034188,0.9915254237288136,0.18080282577916382,0.8240393706246918
1,52,1,54,0.018867924528301886,0.9814814814814815,0.1625923202239735,0.8254561564016673
22,63,9,94,0.25882352941176473,0.9042553191489362,0.19956711013993989,0.9189212019943724
2,0,0,2,1.0,1.0,0.2948052053780351,0.9393293652596785
1,15,1,17,0.0625,0.9411764705882353,0.2653542458897622,0.9350667906646232
12,79,2,93,0.13186813186813187,0.978494623655914,0.2818115980614001,0.9387973151324748
12,109,21,142,0.09917355371900827,0.852112676056338,0.25571950833294677,0.9498637135228167
11,44,4,59,0.2,0.9322033898305084,0.25303330564674403,0.9413891372516304
4,23,2,29,0.14814814814814814,0.9310344827586207,0.2715019090210078,0.9341824231483645
1,21,0,22,0.045454545454545456,1.0,0.23232326488484117,0.9502552815998193
29,64,14,107,0.3118279569892473,0.8691588785046729,0.13401297302616222,0.9315636928147725
19,70,2,91,0.21348314606741572,0.978021978021978,0.1555819938929359,0.9368273367338785
27,71,3,101,0.2755102040816326,0.9702970297029703,0.18233555245921956,0.9353313080101272
73,250,57,380,0.2260061919504644,0.85,0.20022569505236448,0.9339027365815556
7,76,13,96,0.08433734939759036,0.8645833333333334,0.18563950525686287,0.9236277932708982
4,29,1,34,0.12121212121212122,0.9705882352941176,0.1825473593075741,0.9289499221224388
0,12,2,14,0.0,0.8571428571428571,0.1760538528140676,0.9085417588571325
0,8,2,10,0.0,0.8,0.13150700181560368,0.8986619190707508
23,195,13,231,0.10550458715596331,0.9437229437229437,0.11608149339968192,0.8937620570280317
31,108,15,154,0.22302158273381295,0.9025974025974026,0.10858311892142196,0.8840906817272363
2,18,4,24,0.1,0.8333333333333334,0.09058223435706991,0.8817097293462838
0,35,87,122,0.0,0.28688524590163933,0.07853404158598558,0.7991814311417561
3,38,8,49,0.07317073170731707,0.8367346938775511,0.07167098594244213,0.7800594966536751
11,155,22,188,0.06626506024096386,0.8829787234042553,0.08113742311972268,0.7837503346910177
10,123,2,135,0.07518796992481203,0.9851851851851852,0.09187856168041011,0.8102053611460444
14,124,3,141,0.10144927536231885,0.9787234042553191,0.09129923142417518,0.8152054269363835
6,95,2,103,0.0594059405940594,0.9805825242718447,0.06792556826135325,0.8263461586041609
43,174,6,223,0.19815668202764977,0.9730941704035875,0.08194795140816036,0.8463119924713401
6,72,1,79,0.07692307692307693,0.9873417721518988,0.09293696239717135,0.9463772105070916
3,45,5,53,0.0625,0.9056603773584906,0.09141257215326892,0.9562237367186543
1,27,8,36,0.03571428571428571,0.7777777777777778,0.0870481757923149,0.9411950302005861
12,142,4,158,0.07792207792207792,0.9746835443037974,0.08743876264906716,0.9396947957889592
13,104,14,131,0.1111111111111111,0.8931297709923665,0.08881902489889462,0.9274671338942518
25,79,19,123,0.2403846153846154,0.8455284552845529,0.11467312129754549,0.9081736954674958
12,86,2,100,0.12244897959183673,0.98,0.10385773523528649,0.9091602425526976
6,58,1,65,0.09375,0.9846153846153847,0.10626158138913264,0.9087707586189098
3,111,4,118,0.02631578947368421,0.9661016949152542,0.1010924084568018,0.9174052325555904
9,37,1,47,0.1956521739130435,0.9787234042553191,0.12394067819948149,0.9461117506238106
15,84,1,100,0.15151515151515152,0.99,0.13445397442706342,0.9482998157232682
4,23,1,28,0.14814814814814814,0.9642857142857143,0.13974497971806873,0.9584649504794606
8,59,11,78,0.11940298507462686,0.8589743589743589,0.12246188967378464,0.9603857938637186
15,37,1,53,0.28846153846153844,0.9811320754716981,0.14617796951231346,0.9605475189311041
0,1,59,60,0.0,0.016666666666666666,0.1327851123694563,0.8222691306527158
4,162,13,179,0.024096385542168676,0.9273743016759777,0.1324680546649541,0.8167366459042478
17,168,13,198,0.0918918918918919,0.9343434343434344,0.11764515723336101,0.8103966502025498
30,96,12,138,0.23809523809523808,0.9130434782608695,0.13001374103051624,0.799402861382674
3,53,7,63,0.05357142857142857,0.8888888888888888,0.11650278109098487,0.7886318863259848
32,172,6,210,0.1568627450980392,0.9714285714285714,0.1218541753800438,0.8046967738194437
0,17,47,64,0.0,0.265625,0.08064538417125257,0.7024814773234869
4,8,2,14,0.3333333333333333,0.8571428571428571,0.12826443179030017,0.8225495045343711
18,49,2,69,0.26865671641791045,0.9710144927536232,0.16320162191540616,0.8287838175454633
1,59,3,63,0.016666666666666666,0.9523809523809523,0.1524551611689454,0.8313606058365374
33,75,33,141,0.3055555555555556,0.7659574468085106,0.16209234937756217,0.8103483156290575
132,447,11,590,0.22797927461139897,0.9813559322033898,0.18700775595470082,0.8235578932454147
1,52,1,54,0.018867924528301886,0.9814814814814815,0.16729421015902407,0.8249940232529733
21,64,9,94,0.24705882352941178,0.9042553191489362,0.2025883278060829,0.9162269259885356
2,0,0,2,1.0,1.0,0.2978264230441781,0.9366350892538419
1,15,1,17,0.0625,0.9411764705882353,0.2683754635559052,0.9323725146587865
9,82,2,93,0.0989010989010989,0.978494623655914,0.2801232395893955,0.9361030391266381
12,110,21,143,0.09836065573770492,0.8531468531468531,0.25052396818684547,0.9485586686035442
11,44,4,59,0.2,0.9322033898305084,0.24652692895664557,0.9415368768359897
4,23,2,29,0.14814814814814814,0.9310344827586207,0.26499553233090933,0.9343301627327237
1,23,0,24,0.041666666666666664,1.0,0.2268613483529007,0.9493029006474385
29,75,13,117,0.27884615384615385,0.8888888888888888,0.1238393703309227,0.9334298847744226
19,89,2,110,0.17592592592592593,0.9818181818181818,0.14004307403462637,0.9392358435215576
25,97,3,125,0.20491803278688525,0.976,0.15951315714983968,0.9385545248402389
74,288,51,413,0.20441988950276244,0.8765133171912833,0.17643921279309147,0.9418659511056605
6,86,13,105,0.06521739130434782,0.8761904761904762,0.1591216004128409,0.9332491710603089
4,35,1,40,0.10256410256410256,0.975,0.15336545179954944,0.9392015520126898
0,12,2,14,0.0,0.8571428571428571,0.14741307084716845,0.9187933887473838
2,12,2,16,0.14285714285714285,0.875,0.1279860692773098,0.9168092617632568
26,230,14,270,0.1015625,0.9481481481481482,0.11736272271646321,0.911999256953252
30,125,15,170,0.1935483870967742,0.9117647058823529,0.11573848761787593,0.9028227863650168
1,21,4,26,0.045454545454545456,0.8461538461538461,0.09302915275384492,0.8984857190739541
0,36,90,126,0.0,0.2857142857142857,0.0837123825675095,0.8141319775773557
4,41,8,53,0.08888888888888889,0.8490566037735849,0.08175878061390755,0.796140063830725
11,170,23,204,0.06077348066298342,0.8872549019607843,0.0904407064229052,0.8004417845190002
10,153,3,166,0.06134969325153374,0.9819277108433735,0.07879678505067532,0.8157171717823392
14,133,3,150,0.09523809523809523,0.98,0.0778932986561175,0.8202674363326039
5,110,2,117,0.043478260869565216,0.9829059829059829,0.056454709195087646,0.8304304759074081
44,173,6,223,0.20276497695852536,0.9730941704035875,0.0789276279813705,0.8485648079430854
10,91,1,102,0.09900990099009901,0.9901960784313726,0.09307189955138463,0.9492050640455264
4,56,1,61,0.06666666666666667,0.9836065573770492,0.08989729637678145,0.9684264859888785
1,29,9,39,0.03333333333333333,0.7692307692307693,0.08597727532968859,0.9515658955988763
13,147,4,164,0.08125,0.975609756097561,0.0888201762937552,0.9506633306351888
13,103,24,140,0.11206896551724138,0.8285714285714286,0.09122458633363321,0.9290306775739643
28,92,20,140,0.23333333333333334,0.8571428571428571,0.11834673954274295,0.9110645167506606
12,93,2,107,0.11428571428571428,0.9813084112149533,0.1057068448751985,0.9122379797237129
5,60,2,67,0.07692307692307693,0.9701492537313433,0.10255158429419535,0.9093741476237087
3,125,4,132,0.0234375,0.9696969696969697,0.09637598905610012,0.9073870636694117
12,37,1,50,0.24489795918367346,0.98,0.12659950703472014,0.9374969537793018
15,85,1,101,0.15,0.9900990099009901,0.1364209356061487,0.9395668471797916
4,25,1,30,0.13793103448275862,0.9666666666666667,0.14011551688693688,0.9592947383362542
9,77,10,96,0.10465116279069768,0.8958333333333334,0.12173234966656037,0.9648219492206079
17,37,1,55,0.3148148148148148,0.9818181818181818,0.15037936402786042,0.9648947735924978
0,4,59,63,0.0,0.06349206349206349,0.13939035303884945,0.8353723178440291
5,190,13,208,0.02564102564102564,0.9375,0.13970514241613882,0.830772750744462
17,202,13,232,0.0776255707762557,0.9439655172413793,0.11580908692936485,0.8256249674932307
31,108,12,151,0.22302158273381295,0.9205298013245033,0.12624074160562385,0.815686509125161
5,53,7,65,0.08620689655172414,0.8923076923076924,0.1188515790440475,0.8050637985024505
31,192,6,229,0.13901345291479822,0.9737991266375546,0.12376047763320472,0.8162017689744819
0,14,51,65,0.0,0.2153846153846154,0.07878693265965975,0.7067112594839725
4,10,1,15,0.2857142857142857,0.9333333333333333,0.119603259190272,0.8309742980327254
19,66,2,87,0.2235294117647059,0.9770114942528736,0.14787302863651203,0.8366187972117073
0,62,3,65,0.0,0.9538461538461539,0.1367836613827612,0.8380303167266752
32,78,32,142,0.2909090909090909,0.7746478873239436,0.14648187683637234,0.8171900432980237
132,452,11,595,0.22602739726027396,0.9815126050420168,0.1664562340804509,0.82993360226007
1,58,1,60,0.01694915254237288,0.9833333333333333,0.14901847688439013,0.8312956317880384
21,76,9,106,0.21649484536082475,0.9150943396226415,0.17994631193593655,0.9312541638220422
2,0,0,2,1.0,1.0,0.28198712826246713,0.9407779733458517
1,15,1,17,0.0625,0.9411764705882353,0.25898292658179484,0.9356586842509034
9,93,2,104,0.08823529411764706,0.9807692307692307,0.27158796859860157,0.9395048380970571
13,116,21,150,0.10077519379844961,0.86,0.2444259832970814,0.9516979970507796
11,48,4,63,0.1864406779661017,0.9365079365079365,0.2387707376836282,0.9452687586887681
4,24,2,30,0.14285714285714285,0.9333333333333333,0.25675759344288107,0.9381259015459109
1,23,0,24,0.041666666666666664,1.0,0.2268613483529007,0.9493029006474385
29,75,13,117,0.27884615384615385,0.8888888888888888,0.12383937033092265,0.9334298847744226
19,89,2,110,0.17592592592592593,0.9818181818181818,0.14004307403462637,0.9392358435215576
26,96,3,125,0.21311475409836064,0.976,0.16068411733719332,0.9385545248402389
74,287,52,413,0.20498614958448755,0.87409200968523,0.17769106727783437,0.9415200500333671
7,85,13,105,0.07608695652173914,0.8761904761904762,0.16192624992863974,0.9329032699880155
4,35,1,40,0.10256410256410256,0.975,0.15617010131534825,0.9388556509403966
0,12,2,14,0.0,0.8571428571428571,0.1502177203629673,0.9184474876750904
2,12,2,16,0.14285714285714285,0.875,0.1307907187931086,0.9164633606909635
25,230,14,269,0.09803921568627451,0.9479553903345725,0.11966404590172983,0.9116258190504479
31,125,14,170,0.1987179487179487,0.9176470588235294,0.11760735941881383,0.9032896845966664
1,21,4,26,0.045454545454545456,0.8461538461538461,0.09481713025739351,0.8992985183778972
0,38,88,126,0.0,0.30158730158730157,0.08394756504000221,0.8172123505774438
4,41,8,53,0.08888888888888889,0.8490566037735849,0.08199396308640026,0.799220436830813
10,171,23,204,0.055248618784530384,0.8872549019607843,0.08988662291276175,0.8035221575190883
9,154,3,166,0.05521472392638037,0.9819277108433735,0.07736627735122424,0.8187975447824274
13,134,3,150,0.08843537414965986,0.98,0.07599429998885074,0.8233753461632026
4,111,2,117,0.034782608695652174,0.9829059829059829,0.05257496569995123,0.8326980496035532
44,173,6,223,0.20276497695852536,0.9730941704035875,0.07504788448623408,0.8508323816392304
11,90,1,102,0.10891089108910891,0.9901960784313726,0.09060658321324963,0.9492050640455264
3,57,1,61,0.05,0.9836065573770492,0.08505102765769405,0.9684264859888784
1,29,9,39,0.03333333333333333,0.7692307692307693,0.08192027259323735,0.9515658955988763
13,147,4,164,0.08125,0.975609756097561,0.08563959774661158,0.9506633306351887
13,113,14,140,0.10317460317460317,0.9,0.08774520189303206,0.9392347592066174
30,90,20,140,0.25,0.8571428571428571,0.11849054350793889,0.9212685983833137
12,93,2,107,0.11428571428571428,0.9813084112149533,0.10585064884039444,0.9224420613563661
5,60,2,67,0.07692307692307693,0.9701492537313433,0.10128096110238989,0.9195782292563618
3,125,4,132,0.0234375,0.9696969696969697,0.09748631824524703,0.9175911453020646
12,37,1,50,0.24489795918367346,0.98,0.12770983622386703,0.9477010354119548
15,85,1,101,0.15,0.9900990099009901,0.13753126479529562,0.9497709288124447
3,26,1,30,0.10344827586206896,0.9666666666666667,0.13757036089350502,0.9592947383362542
8,77,11,96,0.09411764705882353,0.8854166666666666,0.11530145333047981,0.9633338539825127
18,36,1,55,0.3333333333333333,0.9818181818181818,0.14659397033728253,0.9634066783544025
0,4,59,63,0.0,0.06349206349206349,0.13560495934827152,0.833884222605934
4,191,13,208,0.020512820512820513,0.9375,0.13518714799296017,0.8292846555063669
17,202,13,232,0.0776255707762557,0.9439655172413793,0.11129109250618621,0.8241368722551352
33,106,12,151,0.23741007194244604,0.9205298013245033,0.12377824564082136,0.8141984138870658
5,53,7,65,0.08620689655172414,0.8923076923076924,0.12131519145362923,0.803575703264355
34,189,6,229,0.15246636771300448,0.9737991266375546,0.1296507229756551,0.816201768974482
0,14,51,65,0.0,0.2153846153846154,0.08203167535660749,0.7067112594839725
4,10,1,15,0.2857142857142857,0.9333333333333333,0.12284800188721971,0.8309742980327253
19,66,2,87,0.2235294117647059,0.9770114942528736,0.15185037206606047,0.8366187972117073
0,62,3,65,0.0,0.9538461538461539,0.14076100481230966,0.8380303167266752
29,77,36,142,0.27358490566037735,0.7464788732394366,0.14592883820058558,0.8131658984288084
133,451,11,595,0.22773972602739725,0.9815126050420168,0.16614781383996743,0.8259094573908549
1,58,1,60,0.01694915254237288,0.9833333333333333,0.14678821167273434,0.8272714869188231
21,76,9,106,0.21649484536082475,0.9150943396226415,0.17771604672428074,0.9272300189528269
2,0,0,2,1.0,1.0,0.2797568630508114,0.9367538284766364
1,15,1,17,0.0625,0.9411764705882353,0.2567526613701391,0.9316345393816879
7,95,2,104,0.06862745098039216,0.9807692307692307,0.26655658293876655,0.9354806932278418
11,117,22,150,0.0859375,0.8533333333333334,0.23974981070156978,0.9507456160983986
11,48,4,63,0.1864406779661017,0.9365079365079365,0.23384994669281325,0.9443163777363871
4,24,2,30,0.14285714285714285,0.9333333333333333,0.25183680245206613,0.93717352059353
1,23,0,24,0.041666666666666664,1.0,0.2319155545279341,0.9435886149331526
28,75,14,117,0.27184466019417475,0.8803418803418803,0.12789336312710195,0.9264945978391356
19,89,2,110,0.17592592592592593,0.9818181818181818,0.14409706683080564,0.9323005565862708
24,98,3,125,0.19672131147540983,0.976,0.1581945090863964,0.931619237904952
73,286,54,413,0.20334261838440112,0.8692493946731235,0.17487000125154709,0.9348453419058744
7,85,13,105,0.07608695652173914,0.8761904761904762,0.15910518390235243,0.9262285618605229
4,35,1,40,0.10256410256410256,0.975,0.15259317739034592,0.9369428475748087
0,12,2,14,0.0,0.8571428571428571,0.14664079643796496,0.9165346843095027
2,12,2,16,0.14285714285714285,0.875,0.12821400824696041,0.9157715585463768
26,229,14,269,0.10196078431372549,0.9479553903345725,0.11764755944521746,0.9109340169058612
30,125,15,170,0.1935483870967742,0.9117647058823529,0.11719428453398383,0.901757546317626
3,19,4,26,0.13636363636363635,0.8461538461538461,0.10762585853101743,0.8984581822434434
0,41,85,126,0.0,0.3253968253968254,0.09675629331362612,0.8197733749872075
4,41,8,53,0.08888888888888889,0.8490566037735849,0.09480269136002416,0.801781461240577
8,171,25,204,0.0446927374301676,0.8774509803921569,0.10118736813576239,0.8046826217047626
11,153,2,166,0.06707317073170732,0.9879518072289156,0.0903610864035573,0.8208185941660362
13,134,3,150,0.08843537414965986,0.98,0.08842888495154795,0.8253963955468117
5,110,2,117,0.043478260869565216,0.9829059829059829,0.06699029549051808,0.8355594351216159
44,173,6,223,0.20276497695852536,0.9730941704035875,0.07647620128978794,0.8536937671572932
10,91,1,102,0.09900990099009901,0.9901960784313726,0.09062047285980208,0.9486650890193714
3,57,1,61,0.05,0.9836065573770492,0.08506491730424652,0.9678865109627234
1,29,9,39,0.03333333333333333,0.7692307692307693,0.08344214529041306,0.9524264807968109
13,147,4,164,0.08125,0.975609756097561,0.08546740661445489,0.9506633306351888
13,103,24,140,0.11206896551724138,0.8285714285714286,0.0888436339526808,0.9290306775739642
29,91,20,140,0.24166666666666667,0.8571428571428571,0.11715626335226673,0.9110645167506607
11,94,2,107,0.10476190476190476,0.9813084112149533,0.10315582446703521,0.9122379797237129
5,61,1,67,0.07575757575757576,0.9850746268656716,0.0998340637195319,0.9115063437857556
3,125,4,132,0.0234375,0.9696969696969697,0.09603942086238904,0.9095192598314584
12,37,1,50,0.24489795918367346,0.98,0.12626293884100906,0.9396291499413486
15,85,1,101,0.15,0.9900990099009901,0.13608436741243762,0.9416990433418385
4,25,1,30,0.13793103448275862,0.9666666666666667,0.1397789486932258,0.9614269344983012
8,77,11,96,0.09411764705882353,0.8854166666666666,0.11870051732067677,0.9654660501445596
17,37,1,55,0.3148148148148148,0.9818181818181818,0.14870807589966395,0.9655388745164494
0,4,59,63,0.0,0.06349206349206349,0.1378855650771531,0.833884222605934
4,191,13,208,0.020512820512820513,0.9375,0.13746775372184175,0.8292846555063669
16,204,13,233,0.07272727272727272,0.944206008583691,0.11287194137092736,0.8241712281611797
32,108,11,151,0.22857142857142856,0.9271523178807947,0.12409643116684574,0.8151788435868662
4,54,7,65,0.06896551724137931,0.8923076923076924,0.11424421441807724,0.8045561329641556
33,190,6,229,0.14798206278026907,0.9737991266375546,0.12193913094971233,0.8171821986742824
0,19,46,65,0.0,0.2923076923076923,0.07696558597616734,0.7186807001727838
4,10,1,15,0.2857142857142857,0.9333333333333333,0.1177819125067796,0.8429437387215367
19,66,2,87,0.2235294117647059,0.9770114942528736,0.14678428268562035,0.8485882379005186
1,61,3,65,0.016129032258064516,0.9538461538461539,0.13869881976144777,0.849965401509442
30,79,33,142,0.27522935779816515,0.7676056338028169,0.14536423822241012,0.8271730180697309
135,449,11,595,0.23116438356164384,0.9815126050420168,0.16853550483959082,0.8399165770317772
1,58,1,60,0.01694915254237288,0.9833333333333333,0.14981651766274848,0.8412786065597456
22,75,9,106,0.2268041237113402,0.9150943396226415,0.18221710676436853,0.9302481276047383
2,0,0,2,1.0,1.0,0.2842579230908991,0.9397719371285478
1,15,1,17,0.0625,0.9411764705882353,0.2612537214102269,0.9346526480335996
7,95,2,104,0.06862745098039216,0.9807692307692307,0.26875349551341654,0.9384988018797534
11,117,22,150,0.0859375,0.8533333333333334,0.24171180154225008,0.9507456160983986
11,48,4,63,0.1864406779661017,0.9365079365079365,0.2353227007428869,0.9443163777363871
4,24,2,30,0.14285714285714285,0.9333333333333333,0.25330955650213977,0.93717352059353
1,23,0,24,0.041666666666666664,1.0,0.22901776647570532,0.9445409958855338
29,76,12,117,0.2761904761904762,0.8974358974358975,0.12561640593148765,0.929888981233519
15,93,2,110,0.1388888888888889,0.9818181818181818,0.13652910434418605,0.9356949399806541
26,95,3,124,0.21487603305785125,0.9758064516129032,0.15602119870259057,0.9349859715297503
76,281,56,413,0.21288515406162464,0.864406779661017,0.17415657785425126,0.936567892433705
9,83,13,105,0.09782608695652174,0.8761904761904762,0.1614973505671684,0.9279511123883536
4,35,1,40,0.10256410256410256,0.975,0.15498534405516187,0.9386653981026393
0,12,2,14,0.0,0.8571428571428571,0.1490329631027809,0.9182572348373331
1,13,2,16,0.07142857142857142,0.875,0.11978126242250883,0.9150521066322049
25,229,15,269,0.0984251968503937,0.9442379182156134,0.11400073498843809,0.9096834975461238
31,125,15,171,0.1987179487179487,0.9122807017543859,0.11169243722559487,0.9006083904234784
2,20,4,26,0.09090909090909091,0.8461538461538461,0.09426728534666148,0.8980008284938826
1,36,89,126,0.02702702702702703,0.29365079365079366,0.08415313392816223,0.8147808738453565
4,41,8,53,0.08888888888888889,0.8490566037735849,0.08219953197456027,0.7967889600987258
11,170,23,204,0.06077348066298342,0.8872549019607843,0.09088145778355791,0.8010906807870011
10,153,2,165,0.06134969325153374,0.9878787878787879,0.0894416180439811,0.8172162219125421
13,134,3,150,0.08843537414965986,0.98,0.08801450051530482,0.8223250907388832
5,110,2,117,0.043478260869565216,0.9829059829059829,0.06583740225125004,0.8324144166176827
44,173,6,223,0.20276497695852536,0.9730941704035875,0.08181681454402638,0.8505487486533599
10,91,1,102,0.09900990099009901,0.9901960784313726,0.09210008225303667,0.9500552179077284
2,58,1,61,0.03333333333333333,0.9836065573770492,0.08416357431652875,0.9692766398510805
1,29,9,39,0.03333333333333333,0.7692307692307693,0.08024355326943587,0.9524160494610783
13,147,4,164,0.08125,0.975609756097561,0.08308645423350247,0.9506633306351888
13,103,24,140,0.11206896551724138,0.8285714285714286,0.08646268157172841,0.9290306775739643
28,92,20,140,0.23333333333333334,0.8571428571428571,0.11358483478083814,0.9110645167506606
12,93,2,107,0.11428571428571428,0.9813084112149533,0.1009449401132937,0.9122379797237129
5,61,1,67,0.07575757575757576,0.9850746268656716,0.09762317936579036,0.9115063437857557
3,125,4,132,0.0234375,0.9696969696969697,0.0962094888895999,0.9095192598314584
13,36,1,50,0.2653061224489796,0.98,0.12934845876326365,0.9396291499413486
16,84,1,101,0.16,0.9900990099009901,0.14059845876326366,0.9416990433418385
5,24,1,30,0.1724137931034483,0.9666666666666667,0.14921914841843606,0.9614269344983011
8,77,11,96,0.09411764705882353,0.8854166666666666,0.12933119323636325,0.9654660501445596
18,36,1,55,0.3333333333333333,0.9818181818181818,0.16062371024316596,0.9655388745164494
0,4,59,63,0.0,0.06349206349206349,0.14980119942065515,0.8338842226059339
4,191,13,208,0.020512820512820513,0.9375,0.14938338806534376,0.8292846555063669
14,206,13,233,0.06363636363636363,0.944206008583691,0.12057342252068436,0.8241712281611798
33,107,11,151,0.2357142857142857,0.9271523178807947,0.13138974905129658,0.8151788435868662
4,54,7,65,0.06896551724137931,0.8923076923076924,0.11661142392814387,0.8045561329641556
33,190,6,229,0.14798206278026907,0.9737991266375546,0.12430634045977897,0.8171821986742824
0,20,45,65,0.0,0.3076923076923077,0.07668729284073136,0.720878502370586
4,10,1,15,0.2857142857142857,0.9333333333333333,0.11750361937134358,0.8451415409193389
19,66,2,87,0.2235294117647059,0.9770114942528736,0.14650598955018435,0.850786040098321
1,61,3,65,0.016129032258064516,0.9538461538461539,0.13971922792471306,0.8521632037072441
31,79,32,142,0.2818181818181818,0.7746478873239436,0.1463054987966982,0.830376856484837
136,448,11,595,0.2328767123287671,0.9815126050420168,0.1697213838091822,0.8431204154468832
1,58,1,60,0.01694915254237288,0.9833333333333333,0.15100239663233989,0.8444824449748517
21,76,9,106,0.21649484536082475,0.9150943396226415,0.18193023168388628,0.9312541638220421
2,0,0,2,1.0,1.0,0.2839710480104169,0.9407779733458518
1,15,1,17,0.0625,0.9411764705882353,0.26096684632974465,0.9356586842509033
10,92,2,104,0.09803921568627451,0.9807692307692307,0.27266830110520324,0.9395048380970572
11,116,23,150,0.08661417322834646,0.8466666666666667,0.24478201416379813,0.9497932351460177
11,48,4,63,0.1864406779661017,0.9365079365079365,0.23814829496913165,0.9433639967840062
4,23,3,30,0.14814814814814814,0.9,0.2568910086270995,0.9314592348792442
2,22,0,24,0.08333333333333333,1.0,0.23821595071595092,0.9429341263241323
30,77,10,117,0.2803738317757009,0.9145299145299145,0.1354122123981939,0.9307241141141201
19,88,2,109,0.17757009345794392,0.981651376146789,0.15185079717790018,0.9365062434796277
27,94,3,124,0.2231404958677686,0.9758064516129032,0.1727389998842847,0.9361222189020547
72,287,54,413,0.20055710306406685,0.8692493946731235,0.18840300162070983,0.9385703215615955
8,84,13,105,0.08695652173913043,0.8761904761904762,0.17225393329772845,0.9305684767558766
4,35,1,40,0.10256410256410256,0.975,0.16492792597172115,0.9417753733076007
0,13,1,14,0.0,0.9285714285714286,0.15302316406695923,0.9315712916749478
2,13,1,16,0.13333333333333333,0.9375,0.13201737857519244,0.9348527324563884
24,229,15,268,0.09486166007905138,0.9440298507462687,0.1202018880924935,0.9294782288277428
32,124,15,171,0.20512820512820512,0.9122807017543859,0.11762870370112728,0.9204031217050975
2,24,0,26,0.07692307692307693,1.0,0.09996669996670016,0.939081779608937
1,62,63,126,0.015873015873015872,0.5,0.08981191341439808,0.8853402830102974
4,47,1,52,0.0784313725490196,0.9807692307692307,0.0863643805551005,0.8861644588344734
9,170,23,202,0.05027932960893855,0.8861386138613861,0.093547141927806,0.88010262816161
10,153,2,165,0.06134969325153374,0.9878787878787879,0.08326376477326322,0.8872995978585798
14,133,3,150,0.09523809523809523,0.98,0.08331754122455519,0.8924381906091128
5,110,2,117,0.043478260869565216,0.9829059829059829,0.0602246920447495,0.9025275164879123
44,173,6,223,0.20276497695852536,0.9730941704035875,0.07820210633552785,0.8986838265455678
11,90,1,102,0.10891089108910891,0.9901960784313726,0.0914932313663983,0.9687118377500495
2,58,1,61,0.03333333333333333,0.9836065573770492,0.08505065433558597,0.969117170122595
1,29,9,39,0.03333333333333333,0.7692307692307693,0.08262979772478521,0.9524160494610784
13,147,4,164,0.08125,0.975609756097561,0.08547269868885181,0.9506633306351888
13,113,14,140,0.10317460317460317,0.9,0.08660648553692439,0.9392347592066174
27,93,20,140,0.225,0.8571428571428571,0.11253816255555792,0.9212685983833138
13,92,2,107,0.12380952380952381,0.9813084112149533,0.10125881210570056,0.9224420613563659
5,61,1,67,0.07575757575757576,0.9850746268656716,0.09652262420119583,0.9217104254184086
4,124,4,132,0.03125,0.9696969696969697,0.09622500515357678,0.9197233414641115
12,37,1,50,0.24489795918367346,0.98,0.1264485231321968,0.9498332315740017
15,85,1,101,0.15,0.9900990099009901,0.13626995170362538,0.9519031249744916
6,23,1,30,0.20689655172413793,0.9666666666666667,0.15108737292498747,0.9614269344983012
8,84,4,96,0.08695652173913043,0.9583333333333334,0.13136687603057753,0.9758827168112262
15,39,1,55,0.2777777777777778,0.9818181818181818,0.15336234088318523,0.975955541183116
0,4,59,63,0.0,0.06349206349206349,0.14253983006067442,0.8443008892726007
4,195,9,208,0.020100502512562814,0.9567307692307693,0.14094704470532624,0.8424485749202864
16,205,12,233,0.07239819004524888,0.9484978540772532,0.11630422054269417,0.8379482683598939
33,115,3,151,0.22297297297297297,0.9801324503311258,0.1267289309674046,0.8365244741356275
6,57,2,65,0.09523809523809523,0.9692307692307692,0.11077772289796993,0.8368907745019278
33,190,6,229,0.14798206278026907,0.9737991266375546,0.1194956573324183,0.839100173545388
6,58,1,65,0.09375,0.9846153846153847,0.09320597479273575,0.8394997739449886
4,8,3,15,0.3333333333333333,0.8,0.14082502241178335,0.9447151934461223
19,66,2,87,0.2235294117647059,0.9770114942528736,0.1698862951620895,0.9476124398778515
2,60,3,65,0.03225806451612903,0.9538461538461539,0.1641519915150724,0.9483764827019802
33,80,29,142,0.2920353982300885,0.795774647887324,0.17401805226608888,0.922039653781437
136,454,5,595,0.2305084745762712,0.9915966386554622,0.19334239217154264,0.9252347779849647
1,58,1,60,0.01694915254237288,0.9833333333333333,0.17462340499470033,0.926596807512933
22,75,9,106,0.2268041237113402,0.9150943396226415,0.19363113695346318,0.9166652296568267
2,0,0,2,1.0,1.0,0.2888692321915584,0.9452366582282554
1,15,1,17,0.0625,0.9411764705882353,0.26586503051088617,0.940117369133307
8,94,2,104,0.0784313725490196,0.9807692307692307,0.27246121737272766,0.9439635229794608
11,117,22,150,0.0859375,0.8533333333333334,0.243018660482715,0.9521861923288908
11,48,4,63,0.1864406779661017,0.9365079365079365,0.2367232609669765,0.9443163777363871
4,23,3,30,0.14814814814814814,0.9,0.2554659746249444,0.9324116158316251
2,20,0,22,0.09090909090909091,1.0,0.24086806051091786,0.9429341263241324
28,64,14,106,0.30434782608695654,0.8679245283018868,0.14148917852334023,0.9240662017958304
15,73,2,90,0.17045454545454544,0.9777777777777777,0.15691125644541812,0.929294959965765
25,72,3,100,0.25773195876288657,0.97,0.18117123799553222,0.9280814423006344
72,236,62,370,0.23376623376623376,0.8324324324324325,0.20157940126083834,0.9252699789257909
6,77,13,96,0.07228915662650602,0.8645833333333334,0.18333499506462494,0.9156099708547657
4,28,1,33,0.125,0.9696969696969697,0.17921411594374584,0.9260592916489141
0,12,2,14,0.0,0.8571428571428571,0.16622710295673282,0.9056511283836082
1,7,2,10,0.125,0.8,0.14060598494431045,0.8959476243404814
24,190,15,229,0.11214953271028037,0.9344978165938864,0.13227669740941544,0.8897647727427825
31,112,17,160,0.21678321678321677,0.89375,0.12642687712660547,0.8788719155999255
2,18,4,24,0.1,0.8333333333333334,0.10731741516000064,0.8790006157286256
0,35,87,122,0.0,0.28688524590163933,0.0969903927847855,0.796472317524098
3,37,8,48,0.075,0.8333333333333334,0.08984753564192836,0.7769917980435784
9,155,23,187,0.054878048780487805,0.8770053475935828,0.09768725689628376,0.7798292966793963
9,124,2,135,0.06766917293233082,0.9851851851851852,0.0894971387437596,0.8062843231344229
13,125,3,141,0.09420289855072464,0.9787234042553191,0.08693333386382306,0.8126022642289132
5,96,2,103,0.04950495049504951,0.9805825242718447,0.06303643867979916,0.8250069105534624
44,173,6,223,0.20276497695852536,0.9730941704035875,0.0777171496738742,0.8449727444206416
7,71,1,79,0.08974358974358974,0.9873417721518988,0.09053766249438702,0.9450379624563929
2,49,2,53,0.0392156862745098,0.9622641509433962,0.08542561767645986,0.9634566506864018
0,28,8,36,0.0,0.7777777777777778,0.07758589642210445,0.9492812835698583
3,151,4,158,0.01948051948051948,0.9746835443037974,0.07070180307184569,0.9477810491582315
13,104,14,131,0.1111111111111111,0.8931297709923665,0.07311726200904377,0.935553387263524
23,81,20,124,0.22115384615384615,0.8387096774193549,0.09763853281744328,0.9152858377131683
12,87,2,101,0.12121212121212122,0.9801980198019802,0.08598812485367126,0.9163006733415101
6,58,1,65,0.09375,0.9846153846153847,0.08656046917601558,0.9159111894077224
3,111,4,118,0.02631578947368421,0.9661016949152542,0.08471762677589764,0.9164594099751308
11,35,1,47,0.2391304347826087,0.9787234042553191,0.11887911745912746,0.945165928043351
15,84,1,100,0.15151515151515152,0.99,0.13774120774978918,0.9473539931428083
5,22,1,28,0.18518518518518517,0.9642857142857143,0.14832321833179976,0.957519127899001
7,61,10,78,0.10294117647058823,0.8717948717948718,0.13143569409133435,0.9622455842383605
15,36,1,52,0.29411764705882354,0.9807692307692307,0.1561364834980061,0.9623271858051107
0,1,59,60,0.0,0.016666666666666666,0.14274362635514895,0.8240487975267223
5,161,13,179,0.030120481927710843,0.9273743016759777,0.14328715384858134,0.8185163127782541
16,170,13,199,0.08602150537634409,0.9346733668341709,0.12141444964768637,0.8122234502895188
31,96,12,139,0.2440944881889764,0.9136690647482014,0.1346400691725185,0.8013190309678332
4,52,7,63,0.07142857142857142,0.8888888888888888,0.11838912435014513,0.7905480559111439
30,172,6,208,0.1485148514851485,0.9711538461538461,0.12489964935222517,0.804742195105283
0,18,47,65,0.0,0.27692307692307694,0.08288284262953607,0.7041927445558327
4,7,3,14,0.36363636363636365,0.7857142857142857,0.13483089457758804,0.8140566901340638
18,49,2,69,0.26865671641791045,0.9710144927536232,0.16890749950475942,0.8202910031451561
1,59,3,63,0.016666666666666666,0.9523809523809523,0.15899966540337693,0.8228206582232678
31,78,32,141,0.28440366972477066,0.7730496453900709,0.1647581199084904,0.8027321697435347
133,446,11,590,0.229706390328152,0.9813559322033898,0.18736923689414478,0.815941747359892
1,52,1,54,0.018867924528301886,0.9814814814814815,0.16884824732888096,0.8174171238352687
21,64,9,94,0.24705882352941178,0.9042553191489362,0.20414236497593977,0.9070360155818198
2,0,0,2,1.0,1.0,0.2950514558850307,0.937648260479779
1,15,1,17,0.0625,0.9411764705882353,0.26560049639675776,0.9333856858847236
7,84,2,93,0.07692307692307693,0.978494623655914,0.2742085550048164,0.9371162103525753
11,110,21,142,0.09090909090909091,0.852112676056338,0.24656647231686213,0.9484109290191849
11,44,4,59,0.2,0.9322033898305084,0.24232270226998326,0.9413891372516304
4,22,3,29,0.15384615384615385,0.896551724137931,0.2616053064582478,0.9292563147739804
1,22,0,23,0.043478260869565216,1.0,0.23579111523761057,0.9434677674201671
29,64,13,106,0.3118279569892473,0.8773584905660378,0.1374808233789316,0.9259475517867439
15,73,2,90,0.17045454545454544,0.9777777777777777,0.15290290130100953,0.9311763099566785
24,74,3,101,0.24489795918367346,0.9702970297029703,0.17263173596941225,0.9296541169210484
72,228,75,375,0.24,0.8,0.19217822123018322,0.9231344620792459
8,75,13,96,0.0963855421686747,0.8645833333333334,0.1793132018305508,0.9128595187685884
4,28,1,33,0.125,0.9696969696969697,0.1760063235236725,0.9228162287252983
0,12,2,14,0.0,0.8571428571428571,0.1697951433994489,0.9024080654599922
1,7,2,10,0.125,0.8,0.14310543525812783,0.8913568525219867
21,193,15,229,0.09813084112149532,0.9344978165938864,0.13277347749626353,0.885174000924288
32,111,17,160,0.22377622377622378,0.89375,0.12975608672377073,0.8742387109667209
2,18,4,24,0.1,0.8333333333333334,0.10975608672377073,0.8790006157286256
0,39,83,122,0.0,0.319672131147541,0.09598672355681721,0.8011561582735124
3,37,8,48,0.075,0.8333333333333334,0.08884386641396005,0.7816756387929928
10,154,22,186,0.06097560975609756,0.8817204301075269,0.09755466780768829,0.7851867206450887
10,124,2,136,0.07462686567164178,0.9852941176470589,0.09035850576077997,0.8116573088803828
13,124,4,141,0.0948905109489051,0.9716312056737588,0.08989560145040995,0.8169620787489358
4,97,2,103,0.039603960396039604,0.9805825242718447,0.06358527811038363,0.8293667250734851
44,173,6,223,0.20276497695852536,0.9730941704035875,0.07826598910445869,0.8493325589406643
7,71,1,79,0.08974358974358974,0.9873417721518988,0.0910865019249715,0.9447139362270011
2,50,1,53,0.038461538461538464,0.9811320754716981,0.08586672170519127,0.9658280422467674
1,27,8,36,0.03571428571428571,0.7777777777777778,0.08225796112778959,0.9509790919139461
7,147,4,158,0.045454545454545456,0.9746835443037974,0.07809048681106154,0.9494632957220518
14,103,14,131,0.11965811965811966,0.8931297709923665,0.08162871662666361,0.9382488050532815
24,82,19,125,0.22641509433962265,0.848,0.10831602147574691,0.9193084444430178
12,86,2,100,0.12244897959183673,0.98,0.09684230756621995,0.9202949915282197
6,58,1,65,0.09375,0.9846153846153847,0.09741465188856428,0.919905507594432
3,111,4,118,0.02631578947368421,0.9661016949152542,0.0956795448902994,0.9177583103720829
10,36,1,47,0.21739130434782608,0.9787234042553191,0.12163340469509087,0.946464828440303
15,84,1,100,0.15151515151515152,0.99,0.13678491984660604,0.9486528935397605
4,23,1,28,0.14814814814814814,0.9642857142857143,0.1408549239166101,0.9588180282959531
7,60,11,78,0.1044776119402985,0.8589743589743589,0.1234352835738495,0.9603857938637186
18,33,1,52,0.35294117647058826,0.9807692307692307,0.15636274027081404,0.9604956839736086
0,1,59,60,0.0,0.016666666666666666,0.1429698831279569,0.8222172956952204
4,162,13,179,0.024096385542168676,0.9273743016759777,0.14265282542345464,0.8166848109467523
17,169,13,199,0.0913978494623656,0.9346733668341709,0.12465376043981743,0.810391948458017
31,96,12,139,0.2440944881889764,0.9136690647482014,0.13787937996464955,0.7994875291363314
4,52,7,63,0.07142857142857142,0.8888888888888888,0.12691944043328146,0.788716554079642
31,172,6,209,0.15270935960591134,0.9712918660287081,0.13380969009979757,0.8047619122302633
0,19,46,65,0.0,0.2923076923076923,0.08338952203257068,0.706410263878615
4,8,2,14,0.3333333333333333,0.8571428571428571,0.1310085696516183,0.8264782910894993
18,49,2,69,0.26865671641791045,0.9710144927536232,0.16594575977672427,0.8327126041005916
1,59,3,63,0.016666666666666666,0.9523809523809523,0.15526987652019583,0.8352422591787032
33,76,32,141,0.30275229357798167,0.7730496453900709,0.16364956300433947,0.8151537706989702
133,446,11,590,0.229706390328152,0.9813559322033898,0.18626067998999382,0.8283633483153274
1,52,1,54,0.018867924528301886,0.9814814814814815,0.16714047497890674,0.8298190076657237
21,64,9,94,0.24705882352941178,0.9042553191489362,0.2024345926259656,0.9172400972144727
2,0,0,2,1.0,1.0,0.2976726878640608,0.9376482604797791
1,15,1,17,0.0625,0.9411764705882353,0.2682217283757879,0.9333856858847236
8,83,2,93,0.08791208791208792,0.978494623655914,0.27839964569656234,0.9371162103525752
11,110,21,142,0.09090909090909091,0.852112676056338,0.24813633102957797,0.9484109290191849
11,44,4,59,0.2,0.9322033898305084,0.24389256098269912,0.9413891372516304
4,22,3,29,0.15384615384615385,0.896551724137931,0.2631751651709637,0.9292563147739804
2,22,0,24,0.08333333333333333,1.0,0.2393418765674227,0.9439285969132546
29,73,15,117,0.28431372549019607,0.8717948717948718,0.1371009802088793,0.9256135785982362
18,90,2,110,0.16666666666666666,0.9818181818181818,0.15198193258983167,0.9314195373453715
26,97,3,126,0.21138211382113822,0.9761904761904762,0.1683097519013119,0.930739265236528
77,262,75,414,0.22713864306784662,0.8188405797101449,0.1860189004574895,0.9269111217818891
9,83,13,105,0.09782608695652174,0.8761904761904762,0.17335967317040665,0.9182943417365375
4,35,1,40,0.10256410256410256,0.975,0.16760352455711522,0.9285477979577357
0,12,2,14,0.0,0.8571428571428571,0.1556987626523533,0.9081396346924295
1,13,2,16,0.07142857142857142,0.875,0.1252865977864069,0.9085975101503051
26,228,15,269,0.10236220472440945,0.9442379182156134,0.11610024608037017,0.9032289010642237
31,125,16,172,0.1987179487179487,0.9069767441860465,0.1142910796370574,0.8933412250635911
3,19,4,26,0.13636363636363635,0.8461538461538461,0.10132322153645593,0.897243120269834
1,36,89,126,0.02702702702702703,0.29365079365079366,0.09120907011795668,0.814023165621308
3,41,8,52,0.06818181818181818,0.8461538461538461,0.08629731520620176,0.7956165722147145
13,168,23,204,0.0718232044198895,0.8872549019607843,0.09655777298047168,0.7999182929029899
14,149,2,165,0.08588957055214724,0.9878787878787879,0.09862362999812538,0.8160438340285311
15,131,4,150,0.10273972602739725,0.9733333333333334,0.09867756161283792,0.820200321902491
5,110,2,117,0.043478260869565216,0.9829059829059829,0.07650046334878313,0.8310473560053391
44,173,6,223,0.20276497695852536,0.9730941704035875,0.08598636914805301,0.8491816880410165
10,91,1,102,0.09900990099009901,0.9901960784313726,0.09626963685706329,0.9486881572953848
3,54,4,61,0.05263157894736842,0.9344262295081968,0.09404817410928475,0.9612984977745779
1,29,9,39,0.03333333333333333,0.7692307692307693,0.08854962109691958,0.9444379073845756
4,156,4,164,0.025,0.975609756097561,0.0798511110180414,0.942685188558686
14,112,14,140,0.1111111111111111,0.9,0.08104702317285768,0.9322089980824957
26,96,18,140,0.21311475409836064,0.8714285714285714,0.10528080791982844,0.9162836535857225
12,94,2,108,0.11320754716981132,0.9814814814814815,0.0924868893785836,0.9174818408825646
5,60,2,67,0.07692307692307693,0.9701492537313433,0.08933162879758041,0.9146180087825603
3,125,4,132,0.0234375,0.9696969696969697,0.08516104609081351,0.919656685952385
11,38,1,50,0.22448979591836735,0.98,0.1124691121743898,0.9497665760622752
15,85,1,101,0.15,0.9900990099009901,0.13032625503153267,0.951836469462765
4,25,1,30,0.13793103448275862,0.9666666666666667,0.13415767265605372,0.9613602789865745
10,77,9,96,0.11494252873563218,0.90625,0.12013306903280682,0.9663347687824929
15,39,1,55,0.2777777777777778,0.9818181818181818,0.14364310197680202,0.9663828688305929
0,4,59,63,0.0,0.06349206349206349,0.13265409098779105,0.8368604130821244
5,189,13,207,0.02577319587628866,0.9371980676328503,0.13298776182726083,0.8322177127872502
16,204,13,233,0.07272727272727272,0.944206008583691,0.11130740137139017,0.8271042854420632
29,109,13,151,0.21014492753623187,0.9139072847682119,0.11989953387656614,0.8162197532802378
4,54,7,65,0.06896551724137931,0.8923076923076924,0.11004731712779768,0.8055970426575271
31,191,6,228,0.13963963963963963,0.9736842105263158,0.11357547582837016,0.8152305013041437
2,20,49,71,0.09090909090909091,0.30985915492957744,0.08687994913284347,0.7192363546057717
5,9,1,15,0.35714285714285715,0.9333333333333333,0.13790035729610878,0.8434993931545245
19,66,2,87,0.2235294117647059,0.9770114942528736,0.1661512452801684,0.8491870255288134
1,61,3,65,0.016129032258064516,0.9538461538461539,0.1580657823559958,0.8505641891377368
32,78,32,142,0.2909090909090909,0.7746478873239436,0.16960351998068993,0.8306699895028412
132,452,11,595,0.22602739726027396,0.9815126050420168,0.1920409314119606,0.8434135484648877
1,58,1,60,0.01694915254237288,0.9833333333333333,0.17451371896949391,0.844791994580176
21,76,9,106,0.21649484536082475,0.9150943396226415,0.19245454103402732,0.9312541638220421
2,0,0,2,1.0,1.0,0.2842912757279049,0.9407779733458518
1,15,1,17,0.0625,0.9411764705882353,0.2612870740472326,0.9356586842509033
11,92,2,105,0.10679611650485436,0.9809523809523809,0.2742395146539169,0.9395310024089358
13,113,23,149,0.10317460317460317,0.8456375838926175,0.24742030212041866,0.9496723876330321
11,48,4,63,0.1864406779661017,0.9365079365079365,0.24176505650696548,0.9432431492710206
4,23,3,30,0.14814814814814814,0.9,0.26050777016493337,0.9313383873662586
1,23,0,24,0.041666666666666664,1.0,0.15879475110804356,0.9504544373858368
29,73,15,117,0.28431372549019607,0.8717948717948718,0.12798242617807157,0.9321394190708185
17,91,2,110,0.1574074074074074,0.9818181818181818,0.14154062723627264,0.9379453778179537
26,97,3,126,0.21138211382113822,0.9761904761904762,0.15786844654775287,0.9372651057091101
74,261,79,414,0.2208955223880597,0.8091787439613527,0.17714816403176137,0.9301391544629372
7,85,13,105,0.07608695652173914,0.8761904761904762,0.16138334668256674,0.9215223744175857
4,35,1,40,0.10256410256410256,0.975,0.15633092783704444,0.9271675357079082
0,12,2,14,0.0,0.8571428571428571,0.15037854688466348,0.9067593724426022
1,13,2,16,0.07142857142857142,0.875,0.1199663820187171,0.9072172479004775
23,231,15,269,0.09055118110236221,0.9442379182156134,0.11041549254656778,0.9018486388143964
30,125,17,172,0.1935483870967742,0.9011627906976745,0.10786781730023007,0.8911303980297104
1,21,4,26,0.045454545454545456,0.8461538461538461,0.08280482059544232,0.8964125554857809
1,35,90,126,0.027777777777777776,0.2857142857142857,0.07590350934630498,0.8120588139891822
2,42,8,52,0.045454545454545456,0.8461538461538461,0.06774500118779682,0.793652220582589
14,167,23,204,0.07734806629834254,0.8872549019607843,0.0787947249447029,0.7979539412708642
14,149,2,165,0.08588957055214724,0.9878787878787879,0.08086058196235658,0.8140794823964053
17,129,4,150,0.11643835616438356,0.9733333333333334,0.08455874982835963,0.8182359702703652
5,110,2,117,0.043478260869565216,0.9829059829059829,0.06312016036732979,0.8299135691572664
44,173,6,223,0.20276497695852536,0.9730941704035875,0.08559307915361261,0.8480479011929438
9,92,1,102,0.0891089108910891,0.9901960784313726,0.09435466959837138,0.9486881572953848
3,53,5,61,0.05357142857142857,0.9180327868852459,0.09551422432935468,0.9589565773998706
0,30,9,39,0.0,0.7692307692307693,0.0844645005724486,0.9420959870098684
4,156,4,164,0.025,0.975609756097561,0.07576599049357044,0.9403432681839787
13,103,24,140,0.11206896551724138,0.8285714285714286,0.07514179182969298,0.9196629960751352
25,96,19,140,0.2066115702479339,0.8642857142857143,0.09844655031231708,0.902717243415097
12,94,2,108,0.11320754716981132,0.9814814814814815,0.08565263177107221,0.9039154307119388
6,59,2,67,0.09230769230769231,0.9701492537313433,0.08610960054487268,0.9010515986119347
3,125,4,132,0.0234375,0.9696969696969697,0.08180475360609717,0.9084321961564666
11,38,1,50,0.22448979591836735,0.98,0.11387472445157822,0.9385420862663568
15,85,1,101,0.15,0.9900990099009901,0.13173186730872105,0.9406119796668467
4,25,1,30,0.13793103448275862,0.9666666666666667,0.13542644858950925,0.9603398708233092
9,78,9,96,0.10344827586206896,0.90625,0.12068883510581425,0.9663347687824928
17,37,1,55,0.3148148148148148,0.9818181818181818,0.14948987334081476,0.966382868830593
0,4,59,63,0.0,0.06349206349206349,0.13630306015400157,0.8368604130821244
5,189,13,207,0.02577319587628866,0.9371980676328503,0.13663673099347137,0.8322177127872502
15,206,13,234,0.06787330316742081,0.9444444444444444,0.11426294631476473,0.8271383477078851
29,110,12,151,0.20863309352517986,0.9205298013245033,0.12263910253264756,0.8171998893398157
3,55,7,65,0.05172413793103448,0.8923076923076924,0.11032383159668697,0.806577178717105
31,191,6,228,0.13963963963963963,0.9736842105263158,0.11549402642205421,0.8162106373637216
2,17,52,71,0.10526315789473684,0.2676056338028169,0.08555807543347164,0.7141802733615265
5,9,1,15,0.35714285714285715,0.9333333333333333,0.13657848359673694,0.8384433119102794
19,66,2,87,0.2235294117647059,0.9770114942528736,0.16482937158079655,0.8441309442845685
0,62,3,65,0.0,0.9538461538461539,0.15513318541402216,0.8454740456276698
33,78,32,143,0.2972972972972973,0.7762237762237763,0.16779950023861037,0.8248588991847087
137,447,11,595,0.2345890410958904,0.9815126050420168,0.19392305783358976,0.837602458146755
1,58,1,60,0.01694915254237288,0.9833333333333333,0.17639584539112313,0.8389809042620433
21,76,9,106,0.21649484536082475,0.9150943396226415,0.1922860864577071,0.9314792908077326
2,0,0,2,1.0,1.0,0.2841228211515846,0.9410031003315421
1,15,1,17,0.0625,0.9411764705882353,0.26111861947091236,0.9358838112365938
10,93,2,105,0.0970873786407767,0.9809523809523809,0.2749882449910233,0.939756129394626
13,113,23,149,0.10317460317460317,0.8456375838926175,0.24725643154492416,0.9496723876330321
11,48,4,63,0.1864406779661017,0.9365079365079365,0.2403780939549543,0.9432431492710206
4,24,3,31,0.14285714285714285,0.9032258064516129,0.2583649497142072,0.9317992168593463
1,23,0,24,0.041666666666666664,1.0,0.2313393939651864,0.9504544373858368
28,73,16,117,0.27722772277227725,0.8632478632478633,0.12808621150408317,0.9309184178498172
19,89,2,110,0.17592592592592593,0.9818181818181818,0.14428991520778686,0.9367243765969524
26,97,3,126,0.21138211382113822,0.9761904761904762,0.1606177345192671,0.9360441044881088
72,257,90,419,0.2188449848024316,0.7852028639618138,0.1784884466339002,0.9254930275277161
7,85,13,105,0.07608695652173914,0.8761904761904762,0.1627236292847055,0.9168762474823646
4,35,1,40,0.10256410256410256,0.975,0.15767121043918325,0.9225214087726872
0,12,2,14,0.0,0.8571428571428571,0.1517188294868023,0.9021132455073809
1,13,2,16,0.07142857142857142,0.875,0.12231895072341573,0.9037921221862577
24,230,15,269,0.09448818897637795,0.9442379182156134,0.11068498830205173,0.8984235131001767
31,124,17,172,0.2,0.9011627906976745,0.10905897204188912,0.8877052723154907
2,20,4,26,0.09090909090909091,0.8461538461538461,0.0907824157714119,0.8964125554857809
0,39,87,126,0.0,0.30952380952380953,0.0799128505540206,0.8154601745333999
3,41,8,52,0.06818181818181818,0.8461538461538461,0.07500109564226566,0.7970535811268066
12,169,23,204,0.06629834254143646,0.8872549019607843,0.08447228743389945,0.801355301815082
13,150,2,165,0.07975460122699386,0.9878787878787879,0.08566172026224551,0.8174808429406231
14,132,4,150,0.0958904109589041,0.9733333333333334,0.08586203768832067,0.8216373308145829
6,109,2,117,0.05217391304347826,0.9829059829059829,0.06474402526596043,0.8333149297014842
44,173,6,223,0.20276497695852536,0.9730941704035875,0.08072343755873677,0.8514492617371615
9,92,1,102,0.0891089108910891,0.9901960784313726,0.0934532819717495,0.9486881572953848
2,58,1,61,0.03333333333333333,0.9836065573770492,0.08847492699339453,0.9683242588986997
1,29,9,39,0.03333333333333333,0.7692307692307693,0.0837656399636655,0.9514636685086975
4,156,4,164,0.025,0.975609756097561,0.07594355407409495,0.9497109496828078
13,103,24,140,0.11206896551724138,0.8285714285714286,0.07825477615385742,0.9290306775739643
24,97,19,140,0.19834710743801653,0.8642857142857143,0.0991366610673629,0.912084924913926
13,93,2,108,0.12264150943396226,0.9814814814814815,0.08769045142099674,0.9132831122107679
6,60,1,67,0.09090909090909091,0.9850746268656716,0.087947619994997,0.9125514762728107
3,125,4,132,0.0234375,0.9696969696969697,0.08653392951880653,0.9105643923185135
11,38,1,50,0.22448979591836735,0.98,0.11384199560238281,0.9406742824284037
15,85,1,101,0.15,0.9900990099009901,0.13169913845952566,0.9427441758288936
3,26,1,30,0.10344827586206896,0.9666666666666667,0.1304676113659296,0.9624720669853561
8,78,10,96,0.09302325581395349,0.8958333333333334,0.1154213468482063,0.9669788697064445
16,38,1,55,0.2962962962962963,0.9818181818181818,0.14022917354282546,0.9670269697545447
0,4,59,63,0.0,0.06349206349206349,0.12724216055581247,0.8353723178440292
5,193,9,207,0.025252525252525252,0.9565217391304348,0.12750144987760179,0.8334901420488098
16,205,13,234,0.07239819004524888,0.9444444444444444,0.10577407761001344,0.8284107769694449
31,108,12,151,0.22302158273381295,0.9205298013245033,0.11620573228627243,0.8184723186013753
4,54,7,65,0.06896551724137931,0.8923076923076924,0.1112796239118882,0.8078496079786647
33,189,6,228,0.14864864864864866,0.9736842105263158,0.11922610860255893,0.8189711618633765
2,20,49,71,0.09090909090909091,0.30985915492957744,0.0898850792615296,0.7229770151650043
5,8,2,15,0.38461538461538464,0.8666666666666667,0.14483013420658455,0.8377162441899477
19,66,2,87,0.2235294117647059,0.9770114942528736,0.17315540370832463,0.8406433520645819
2,60,3,65,0.03225806451612903,0.9538461538461539,0.1674211000613075,0.8419864534076832
34,76,33,143,0.3090909090909091,0.7692307692307693,0.17971671811232123,0.8203723059657212
145,439,11,595,0.2482876712328767,0.9815126050420168,0.20533416868253515,0.8331158649277676
1,58,1,60,0.01694915254237288,0.9833333333333333,0.1865199549530672,0.8344943110430557
22,75,9,106,0.2268041237113402,0.9150943396226415,0.20593353106767423,0.920956480284922
1,1,0,2,0.5,1.0,0.2224170475511907,0.940004099332541
1,15,1,17,0.0625,0.9411764705882353,0.19941284587051844,0.9348848102375927
10,93,2,105,0.0970873786407767,0.9809523809523809,0.2086741764597538,0.9387571283956252
11,117,21,149,0.0859375,0.8590604026845637,0.1767951180181954,0.9515899331747387
11,48,4,63,0.1864406779661017,0.9365079365079365,0.16795983326579897,0.9451606948127271
4,25,2,31,0.13793103448275862,0.9354838709677419,0.18524295925728265,0.9383250573319284
1,23,0,24,0.041666666666666664,1.0,0.23186622837692022,0.9468049152258146
29,74,14,117,0.2815533980582524,0.8803418803418803,0.12923099952809916,0.9297108981317975
21,87,2,110,0.19444444444444445,0.9818181818181818,0.1480802058773055,0.9355168568789327
26,97,3,126,0.21138211382113822,0.9761904761904762,0.16579498774079685,0.9348365847700891
70,245,104,419,0.2222222222222222,0.7517899761336515,0.18535940265404896,0.9185534653491055
9,83,13,105,0.09782608695652174,0.8761904761904762,0.17027886786091284,0.909936685303754
4,35,1,40,0.10256410256410256,0.975,0.16452271924762135,0.9201901415249522
0,12,2,14,0.0,0.8571428571428571,0.1585703382952404,0.899781978259646
1,13,2,16,0.07142857142857142,0.875,0.1285525059195717,0.8990188524965202
26,228,15,269,0.10236220472440945,0.9442379182156134,0.11539790024528097,0.8936502434104391
30,126,15,171,0.19230769230769232,0.9122807017543859,0.11267298288621728,0.8845202756338547
2,20,4,26,0.09090909090909091,0.8461538461538461,0.09391396412719852,0.8980008284938826
0,38,88,126,0.0,0.30158730158730157,0.07993880884769541,0.815914660693429
3,41,8,52,0.06818181818181818,0.8461538461538461,0.07502705393594049,0.7975080672868357
13,168,23,204,0.0718232044198895,0.8872549019607843,0.08528751171021043,0.8018097879751108
13,150,2,165,0.07975460122699386,0.9878787878787879,0.08647694453855649,0.817935329100652
14,132,4,150,0.0958904109589041,0.9733333333333334,0.08555240257205574,0.8220918169746121
6,109,2,117,0.05217391304347826,0.9829059829059829,0.06553329124859657,0.8321811428534117
44,173,6,223,0.20276497695852536,0.9730941704035875,0.08151270354137292,0.850315474889089
10,91,1,102,0.09900990099009901,0.9901960784313726,0.09565697511138706,0.9486881572953848
2,54,5,61,0.03571428571428571,0.9180327868852459,0.09101875618745388,0.9589565773998705
1,29,9,39,0.03333333333333333,0.7692307692307693,0.0855202031750887,0.9420959870098684
12,148,4,164,0.075,0.975609756097561,0.08484097442837528,0.9403432681839787
15,111,14,140,0.11904761904761904,0.9,0.08814914701247742,0.9298670777077883
28,93,19,140,0.23140495867768596,0.8642857142857143,0.11375358210307851,0.91292132504775
12,94,2,108,0.11320754716981132,0.9814814814814815,0.10095966356183365,0.914119512344592
5,61,1,67,0.07575757575757576,0.9850746268656716,0.09763790281433034,0.9133878764066347
3,125,4,132,0.0234375,0.9696969696969697,0.09588407628371809,0.9207684739511667
10,39,1,50,0.20408163265306123,0.98,0.12027669047225065,0.9508783640610569
15,85,1,101,0.15,0.9900990099009901,0.13099097618653635,0.9529482574615467
5,24,1,30,0.1724137931034483,0.9666666666666667,0.1386147153373691,0.9624720669853561
8,77,11,96,0.09411764705882353,0.8854166666666666,0.1190022422489602,0.9654907744683493
18,36,1,55,0.3333333333333333,0.9818181818181818,0.15044878312946333,0.9655388745164493
0,4,59,63,0.0,0.06349206349206349,0.13962627230695251,0.833884222605934
6,192,9,207,0.030303030303030304,0.9565217391304348,0.14060706235024253,0.8320020468107147
15,206,13,234,0.06787330316742081,0.9444444444444444,0.12114872956657963,0.8269226817313495
31,108,12,151,0.22302158273381295,0.9205298013245033,0.13158038424283863,0.8169842233632799
3,55,7,65,0.05172413793103448,0.8923076923076924,0.1143390049324938,0.8063615127405696
32,190,6,228,0.14414414414414414,0.9736842105263158,0.12148564737325387,0.8189711618633765
2,24,45,71,0.07692307692307693,0.36619718309859156,0.08485561074321726,0.7310253049034349
5,9,1,15,0.35714285714285715,0.9333333333333333,0.13587601890648257,0.8552883434521877
19,66,2,87,0.2235294117647059,0.9770114942528736,0.16347978768672194,0.8582154513268219
2,60,3,65,0.03225806451612903,0.9538461538461539,0.1583918964508231,0.8595585526699232
32,79,32,143,0.2882882882882883,0.7762237762237763,0.16771571153003387,0.8389434062269624
145,439,11,595,0.2482876712328767,0.9815126050420168,0.1957962162874399,0.8516869651890087
1,58,1,60,0.01694915254237288,0.9833333333333333,0.17762550320147258,0.8530654113042967
22,75,9,106,0.2268041237113402,0.9150943396226415,0.19903708131408163,0.9314792908077326
2,0,0,2,1.0,1.0,0.2908738160079592,0.9410031003315421
1,15,1,17,0.0625,0.9411764705882353,0.2678696143272869,0.9358838112365938
10,93,2,105,0.0970873786407767,0.9809523809523809,0.2771309449165223,0.9397561293946263
12,116,21,149,0.09375,0.8590604026845637,0.24933976087533827,0.9515899331747386
11,48,4,63,0.1864406779661017,0.9365079365079365,0.24050447612294182,0.9451606948127272
4,25,2,31,0.13793103448275862,0.9354838709677419,0.25778760211442553,0.9383250573319285
1,22,0,23,0.043478260869565216,1.0,0.24423550052432058,0.9482213248662477
30,77,10,117,0.2803738317757009,0.9145299145299145,0.14143176220656356,0.9360113126562355
19,89,2,110,0.17592592592592593,0.9818181818181818,0.15763546591026725,0.9418172714033707
26,96,3,125,0.21311475409836064,0.976,0.17410527550195853,0.9414282136526106
78,307,34,419,0.2025974025974026,0.918854415274463,0.1900607486002888,0.9509627478266286
6,86,13,105,0.06521739130434782,0.8761904761904762,0.1656112850203904,0.9429609030209097
4,35,1,40,0.10256410256410256,0.975,0.1547530955907724,0.9489132839732907
0,13,1,14,0.0,0.9285714285714286,0.14854191546654882,0.9387092023406376
1,14,1,16,0.06666666666666667,0.9375,0.1180123204509725,0.9419906431220785
21,233,15,269,0.08267716535433071,0.9442379182156134,0.10469106894074462,0.9366220340359972
32,124,15,171,0.20512820512820512,0.9122807017543859,0.10355013337357954,0.9275192771437666
2,24,0,26,0.07692307692307693,1.0,0.08559665827724729,0.9391115035331291
1,63,62,126,0.015625,0.5079365079365079,0.07851203094805474,0.886503793782562
3,48,1,52,0.058823529411764705,0.9807692307692307,0.0722633776405779,0.887327969606738
11,170,23,204,0.06077348066298342,0.8872549019607843,0.08094530344957554,0.8814256086623601
12,151,2,165,0.0736196319018405,0.9878787878787879,0.08193858419745752,0.8886225783593299
15,131,4,150,0.10273972602739725,0.9733333333333334,0.08480466429360987,0.89277906623329
5,110,2,117,0.043478260869565216,0.9829059829059829,0.06171181511380418,0.9028683921120894
44,173,6,223,0.20276497695852536,0.9730941704035875,0.07968922940458253,0.8990247021697447
10,91,1,102,0.09900990099009901,0.9901960784313726,0.09160135811745382,0.967918926526154
2,58,1,61,0.03333333333333333,0.9836065573770492,0.08795990153482076,0.9683242588986996
1,29,9,39,0.03333333333333333,0.7692307692307693,0.0840398804877279,0.9514636685086975
13,147,4,164,0.08125,0.975609756097561,0.08512993307317925,0.9497109496828078
14,112,14,140,0.1111111111111111,0.9,0.08632584522799551,0.9392347592066174
27,95,18,140,0.22131147540983606,0.8714285714285714,0.11173059016231991,0.9233094147098442
11,95,2,108,0.10377358490566038,0.9814814814814815,0.09758896272619635,0.9245076020066864
6,60,1,67,0.09090909090909091,0.9850746268656716,0.0964317041431952,0.923775966068729
6,122,4,132,0.046875,0.9696969696969697,0.098366227952719,0.9217888821144319
9,40,1,50,0.1836734693877551,0.98,0.11984339024620784,0.951898772224322
15,85,1,101,0.15,0.9900990099009901,0.1296648188176364,0.9539686656248119
6,23,1,30,0.20689655172413793,0.9666666666666667,0.14334845319092593,0.9634924751486214
9,83,4,96,0.09782608695652174,0.9583333333333334,0.12570768341188104,0.975907441135016
18,36,1,55,0.3333333333333333,0.9818181818181818,0.15850193318726288,0.975955541183116
0,4,59,63,0.0,0.06349206349206349,0.1455149202002499,0.8443008892726006
5,193,9,207,0.025252525252525252,0.9565217391304348,0.14242599523632496,0.8424187134773814
16,206,12,234,0.07207207207207207,0.9487179487179487,0.12648293847694164,0.8379498490085168
31,109,11,151,0.22142857142857142,0.9271523178807947,0.13668702010959471,0.8289574644342032
3,60,2,65,0.047619047619047616,0.9692307692307692,0.11393309095172466,0.8293237648005036
26,196,6,228,0.11711711711711711,0.9736842105263158,0.11668895240323827,0.8315167472566439
9,57,5,71,0.13636363636363635,0.9295774647887324,0.08855042426471015,0.8240537876810083
5,9,1,15,0.35714285714285715,0.9333333333333333,0.13957083242797547,0.9483168262297612
19,66,2,87,0.2235294117647059,0.9770114942528736,0.16789610192971555,0.9512439341043952
2,60,3,65,0.03225806451612903,0.9538461538461539,0.16220838656458084,0.9519765348369961
33,82,28,143,0.28695652173913044,0.8041958041958042,0.1715695223232321,0.9344113185962831
141,449,5,595,0.23898305084745763,0.9915966386554622,0.19890723707014785,0.9376064427998106
1,58,1,60,0.01694915254237288,0.9833333333333333,0.18459752784518438,0.9389848889150988
22,75,9,106,0.2268041237113402,0.9150943396226415,0.19751759746628492,0.9369158710342287
2,0,0,2,1.0,1.0,0.2893543321601625,0.9464396805580382
1,15,1,17,0.0625,0.9411764705882353,0.26635013047949024,0.9413203914630899
9,94,2,105,0.08737864077669903,0.9809523809523809,0.2742244985167145,0.9451927096211223
11,118,20,149,0.08527131782945736,0.8657718120805369,0.24541232652961834,0.9539892821760841
12,47,4,63,0.2033898305084746,0.9365079365079365,0.2403275807669065,0.9461194675835805
4,24,3,31,0.14285714285714285,0.9032258064516129,0.2583144365261593,0.9346755351719062
1,21,0,22,0.045454545454545456,1.0,0.2414598360204865,0.9460422657070845
29,63,14,106,0.31521739130434784,0.8679245283018868,0.14363374906396478,0.9271743411787827
20,68,2,90,0.22727272727272727,0.9777777777777777,0.16717271010292584,0.9324030993487175
21,78,3,102,0.21212121212121213,0.9705882352941176,0.18350058512645304,0.9312409323542601
75,270,36,381,0.21739130434782608,0.905511811023622,0.20015072344264903,0.9408814526413367
9,74,13,96,0.10843373493975904,0.8645833333333334,0.18124972261393738,0.9313884312948673
4,28,1,33,0.125,0.9696969696969697,0.17869870220577413,0.9365832364896723
0,12,2,14,0.0,0.8571428571428571,0.17220519571226764,0.9161750732243662
0,9,1,10,0.0,0.9,0.12717413981164652,0.9207572834669538
18,196,15,229,0.08411214953271028,0.9344978165938864,0.10672262870592979,0.914574431869255
32,112,16,160,0.2222222222222222,0.9,0.10816563014893125,0.9044903982558097
2,18,4,24,0.1,0.8333333333333334,0.09139544381352752,0.894179187157197
0,37,85,122,0.0,0.30327868852459017,0.0759049102507048,0.8139928093273765
3,37,8,48,0.075,0.8333333333333334,0.06876205310784765,0.7945122898468571
13,151,22,186,0.07926829268292683,0.8817204301075269,0.08008609491969435,0.7980233716989528
12,122,2,136,0.08955223880597014,0.9852941176470589,0.0928792718919758,0.8102082456485326
14,123,4,141,0.10218978102189781,0.9716312056737588,0.09546179067614545,0.8155130155170858
4,97,2,103,0.039603960396039604,0.9805825242718447,0.06937346755811936,0.8270248046987778
44,173,6,223,0.20276497695852536,0.9730941704035875,0.08405417855219441,0.8469906385659571
6,72,1,79,0.07692307692307693,0.9873417721518988,0.09504318954120539,0.9447139362270012
2,50,1,53,0.038461538461538464,0.9811320754716981,0.08982340932142518,0.9658280422467677
1,27,8,36,0.03571428571428571,0.7777777777777778,0.08360140832590501,0.9509790919139463
12,143,4,159,0.07741935483870968,0.9748427672955975,0.08186813918772495,0.9494860418637375
13,104,14,131,0.1111111111111111,0.8931297709923665,0.08314261491475543,0.9382715511949671
25,78,20,123,0.24271844660194175,0.8373983739837398,0.11215897008702716,0.9178166725823808
12,86,2,100,0.12244897959183673,0.98,0.10068525617750021,0.9188032196675826
6,59,1,66,0.09230769230769231,0.9848484848484849,0.10288305837530241,0.9184470357670947
3,111,4,118,0.02631578947368421,0.9661016949152542,0.1011479513770375,0.9162998385447457
9,37,1,47,0.1956521739130435,0.9787234042553191,0.1239962211197172,0.9450063566129658
15,84,1,100,0.15151515151515152,0.99,0.13458133493063745,0.9471716755707377
5,22,1,28,0.18518518518518517,0.9642857142857143,0.14516334551264803,0.9573368103269303
8,59,11,78,0.11940298507462686,0.8589743589743589,0.1275468510087459,0.9604190938970186
17,34,1,52,0.3333333333333333,0.9807692307692307,0.15767318725753116,0.9605289840069087
0,1,59,60,0.0,0.016666666666666666,0.14448637407071793,0.8222172956952204
6,164,9,179,0.03529411764705882,0.9497206703910615,0.14576899238120006,0.8198771493346214
16,171,13,200,0.0855614973262032,0.935,0.1300417528687943,0.8136309487267189
30,97,12,139,0.23622047244094488,0.9136690647482014,0.1421425130010505,0.8027265294050333
2,54,7,63,0.03571428571428571,0.8888888888888888,0.12078952736235057,0.7919555543483439
23,181,6,210,0.11274509803921569,0.9714285714285714,0.11983840064300612,0.8080204418418029
0,2,69,71,0.0,0.028169014084507043,0.07221935302395847,0.671934696601128
4,9,1,14,0.3076923076923077,0.9285714285714286,0.11617539698000244,0.8022068054446655
19,48,2,69,0.2835820895522388,0.9710144927536232,0.151645107252171,0.8052487800678885
2,58,3,63,0.03333333333333333,0.9523809523809523,0.1441839409674753,0.8077317732651673
33,78,31,142,0.2972972972972973,0.7816901408450704,0.15290920166123995,0.7888776412790058
142,437,11,590,0.2452504317789292,0.9813559322033898,0.18284293681333189,0.8020872188953632
1,52,1,54,0.018867924528301886,0.9814814814814815,0.1694319120260585,0.8035233489029218
21,64,9,94,0.24705882352941178,0.9042553191489362,0.20472602967311732,0.9286785353406973
2,0,0,2,1.0,1.0,0.3036271285742162,0.9388826169733504
1,15,1,17,0.0625,0.9411764705882353,0.2720439729238963,0.934620042378295
9,83,2,94,0.09782608695652174,0.9787234042553191,0.28125722344149473,0.9383832497889187
11,110,21,142,0.09090909090909091,0.852112676056338,0.2517731939574652,0.948443611961957
13,42,4,59,0.23636363636363636,0.9322033898305084,0.25050365175528055,0.9414218201944026
5,23,2,30,0.17857142857142858,0.9333333333333333,0.2733184380471558,0.9345435133160956
1,21,0,22,0.045454545454545456,1.0,0.23658310195446314,0.9485368918441301
29,63,15,107,0.31521739130434784,0.8598130841121495,0.1387570149979414,0.9285101895744372
20,69,2,91,0.2247191011235955,0.978021978021978,0.1619311723013122,0.9337738334935434
25,74,3,102,0.25252525252525254,0.9705882352941176,0.18691050796025951,0.9322932412566487
83,262,37,382,0.24057971014492754,0.9031413612565445,0.2076735958040927,0.9405080665943525
6,77,13,96,0.07228915662650602,0.8645833333333334,0.1841023130945621,0.9302331232836948
4,28,1,33,0.125,0.9696969696969697,0.182255022454168,0.9351207088164416
0,12,2,14,0.0,0.8571428571428571,0.17576151596066153,0.9147125455511357
1,7,2,10,0.125,0.8,0.14858760291718326,0.9061678192493999
21,192,15,228,0.09859154929577464,0.9342105263157895,0.13056938122749454,0.8999090404342301
30,113,15,158,0.2097902097902098,0.9050632911392406,0.12446437512248844,0.8905483341263906
2,18,4,24,0.1,0.8333333333333334,0.1043815593874988,0.8805757587087889
1,37,84,122,0.02631578947368421,0.3114754098360656,0.09781393550852426,0.8015603410663221
3,38,8,49,0.07317073170731707,0.8367346938775511,0.09040975432385526,0.7825657302349767
10,154,22,186,0.06097560975609756,0.8817204301075269,0.09912055571758348,0.7860768120870721
10,123,2,135,0.07518796992481203,0.9851851851851852,0.09200455142112805,0.8125318385420988
14,123,4,141,0.10218978102189781,0.9716312056737588,0.09251858452485995,0.8178776498789515
4,97,2,103,0.039603960396039604,0.9805825242718447,0.06820626318283562,0.8286661117550377
45,172,6,223,0.2073732718894009,0.9730941704035875,0.08354530202417862,0.848631945622217
6,72,1,79,0.07692307692307693,0.9873417721518988,0.09077491451694901,0.9451842830959075
2,50,1,53,0.038461538461538464,0.9811320754716981,0.08581645833898063,0.9658124804664999
1,27,8,36,0.03571428571428571,0.7777777777777778,0.08220769776157895,0.9509635301336786
12,143,4,159,0.07741935483870968,0.9748427672955975,0.08252646703499289,0.9494860418637374
13,94,24,131,0.12149532710280374,0.816793893129771,0.08528440218940803,0.927366425786025
23,81,20,124,0.22115384615384615,0.8387096774193549,0.11122010015480896,0.9070988762356692
12,86,2,100,0.12244897959183673,0.98,0.09908805839801407,0.9080854233208709
6,58,1,65,0.09375,0.9846153846153847,0.10149190455186023,0.9076959393870833
3,111,4,118,0.02631578947368421,0.9661016949152542,0.09975679755359533,0.9055487421647342
10,37,1,48,0.2127659574468085,0.9791666666666666,0.12504989351538429,0.9343185834345754
15,84,1,100,0.15151515151515152,0.99,0.13563500732630457,0.9364839023923472
5,22,1,28,0.18518518518518517,0.9642857142857143,0.14473355848093047,0.9575541625574819
8,60,10,78,0.11764705882352941,0.8717948717948718,0.1299468745765995,0.9622806188968417
17,35,1,53,0.3269230769230769,0.9811320754716981,0.15915745990963387,0.962442343964227
0,1,59,60,0.0,0.016666666666666666,0.14576460276677672,0.8241639556858387
4,166,9,179,0.023529411764705882,0.9497206703910615,0.14536654880835123,0.8218238093252397
14,173,13,200,0.0748663101604278,0.935,0.12566659919601111,0.815514285515716
29,97,13,139,0.23015873015873015,0.9064748201438849,0.13690139614509378,0.8035821169648424
2,54,7,63,0.03571428571428571,0.8888888888888888,0.11554841050639385,0.792811141908153
25,178,6,209,0.12315270935960591,0.9712918660287081,0.11633493201154764,0.8070249982272725
0,2,69,71,0.0,0.028169014084507043,0.06963163530825094,0.6708874180291023
4,9,1,14,0.3076923076923077,0.9285714285714286,0.1135876792642949,0.8011595268726397
18,49,2,69,0.26865671641791045,0.9710144927536232,0.14860586564332415,0.8042015014958629
1,59,3,63,0.016666666666666666,0.9523809523809523,0.1402916308585011,0.8066844946931416
32,76,33,141,0.2962962962962963,0.7659574468085106,0.14973985459243913,0.7866105842166597
138,441,11,590,0.23834196891191708,0.9813559322033898,0.17868666647781503,0.799820161833017
1,52,1,54,0.018867924528301886,0.9814814814814815,0.16378884007334302,0.8012758211834131
20,65,9,94,0.23529411764705882,0.9042553191489362,0.1974022854514943,0.9264310076211888
2,0,0,2,1.0,1.0,0.2963033843525932,0.9366350892538419
1,15,1,17,0.0625,0.9411764705882353,0.26685242486432026,0.9323725146587863
9,83,2,94,0.09782608695652174,0.9787234042553191,0.278446627762871,0.9361357220694103
12,107,23,142,0.10084033613445378,0.8380281690140845,0.25052434773975063,0.9464315395273494
13,41,4,58,0.24074074074074073,0.9310344827586207,0.25086702942958256,0.9392427610352394
4,24,2,30,0.14285714285714285,0.9333333333333333,0.26857977490513124,0.9323644541569326
2,22,0,24,0.08333333333333333,1.0,0.24787670471613735,0.9448873696841079
27,73,17,117,0.27,0.8547008547008547,0.14359099043042306,0.9241303489270872
17,91,2,110,0.1574074074074074,0.9818181818181818,0.1571491914886241,0.9299363076742224
27,95,3,125,0.22131147540983606,0.976,0.1735085284750501,0.9292288246810251
85,299,35,419,0.22135416666666666,0.9164677804295943,0.19050738018108682,0.9383886514154541
7,85,13,105,0.07608695652173914,0.8761904761904762,0.16747864031373236,0.9297718713701028
4,35,1,40,0.10256410256410256,0.975,0.1617224917004409,0.940025327591301
0,12,2,14,0.0,0.8571428571428571,0.14981772979567903,0.9196171643259948
1,13,2,16,0.07142857142857142,0.875,0.12145038285690347,0.9225170422258726
22,233,14,269,0.08627450980392157,0.9479553903345725,0.11128854034211978,0.917679500585357
29,129,14,172,0.18354430379746836,0.9186046511627907,0.10589323011178153,0.9094801650371842
1,21,4,26,0.045454545454545456,0.8461538461538461,0.08076471279576423,0.8994353172835059
1,38,87,126,0.02564102564102564,0.30952380952380953,0.07355815124137657,0.818482936331125
4,40,8,52,0.09090909090909091,0.8461538461538461,0.07189314957637492,0.8000763429245316
11,168,25,204,0.061452513966480445,0.8774509803921569,0.08067208014301498,0.8029775033887173
12,151,2,165,0.0736196319018405,0.9878787878787879,0.08098508878205343,0.8191030445142584
15,131,4,150,0.10273972602739725,0.9733333333333334,0.08333726252826423,0.8227284649426528
6,108,2,116,0.05263157894736842,0.9827586206896551,0.06463544469253568,0.831893317732205
44,173,6,223,0.20276497695852536,0.9730941704035875,0.08710836347881853,0.8500276497678821
10,91,1,102,0.09900990099009901,0.9901960784313726,0.097589631385829,0.9472665453261054
3,57,1,61,0.05,0.9836065573770492,0.09174547554167314,0.9669026469294203
1,29,9,39,0.03333333333333333,0.7692307692307693,0.08772844973693784,0.9514426167635077
14,146,4,164,0.0875,0.975609756097561,0.08971135946524635,0.949689897937618
13,113,14,140,0.10317460317460317,0.9,0.08977348477199006,0.9392137074614277
28,91,21,140,0.23529411764705882,0.85,0.11586813315766012,0.9202481902200483
13,93,2,108,0.12264150943396226,0.9814814814814815,0.10442192351129397,0.9214463775168904
7,58,2,67,0.1076923076923077,0.9701492537313433,0.1056622673258952,0.9185825454168862
3,125,4,132,0.0234375,0.9696969696969697,0.10186762446875235,0.9165954614625892
11,38,1,50,0.22448979591836735,0.98,0.12917569055232864,0.9467053515724793
14,86,1,101,0.14,0.9900990099009901,0.13667569055232862,0.9487752449729692
4,25,1,30,0.13793103448275862,0.9666666666666667,0.14164089502492225,0.9582990544967787
10,76,10,96,0.11627906976744186,0.8958333333333334,0.12463874532783413,0.9648466735443977
17,37,1,55,0.3148148148148148,0.9818181818181818,0.15209207466795593,0.9648947735924978
0,3,59,62,0.0,0.04838709677419355,0.13670745928334055,0.833214465455762
5,194,9,208,0.02512562814070352,0.9567307692307693,0.13694862044629819,0.8313621511034477
14,207,13,234,0.06334841628959276,0.9444444444444444,0.11392842335647324,0.8262827860240826
30,108,13,151,0.21739130434782608,0.9139072847682119,0.12498432397759127,0.8153982538622572
1,57,7,65,0.017241379310344827,0.8923076923076924,0.10774294466724642,0.8047755432395466
26,197,6,229,0.11659192825112108,0.9737991266375546,0.10778763873634345,0.8159135137115782
0,1,70,71,0.0,0.014084507042253521,0.06281409376279848,0.6776658458864455
4,10,1,15,0.2857142857142857,0.9333333333333333,0.10363042029341073,0.8040867368234655
19,66,2,87,0.2235294117647059,0.9770114942528736,0.1319738179539825,0.8069839832551947
1,61,3,65,0.016129032258064516,0.9538461538461539,0.12522819166376417,0.808327084598296
30,80,32,142,0.2727272727272727,0.7746478873239436,0.13313333000368513,0.7884328849634006
138,446,11,595,0.2363013698630137,0.9815126050420168,0.1644276143683521,0.8011764439254468
1,58,1,60,0.01694915254237288,0.9833333333333333,0.1501929321242452,0.8025384734534153
20,77,9,106,0.20618556701030927,0.9150943396226415,0.17964801312571796,0.9312541638220422
2,0,0,2,1.0,1.0,0.2816888294522486,0.9407779733458518
1,15,1,17,0.0625,0.9411764705882353,0.2586846277715763,0.9356586842509033
8,95,2,105,0.07766990291262135,0.9809523809523809,0.2674761807222273,0.9395310024089357
12,114,23,149,0.09523809523809523,0.8456375838926175,0.24212058393805908,0.9496723876330321
14,45,4,63,0.23728813559322035,0.9365079365079365,0.24226155047094575,0.9432431492710206
4,25,2,31,0.13793103448275862,0.9354838709677419,0.25954467646242946,0.9364075117902217
1,23,0,24,0.041666666666666664,1.0,0.23721635393133508,0.9504544373858368
28,73,16,117,0.27722772277227725,0.8632478632478633,0.13396317147023187,0.9309184178498172
18,90,2,110,0.16666666666666666,0.9818181818181818,0.14884412385118423,0.9367243765969525
26,96,3,125,0.21311475409836064,0.976,0.16680642575427876,0.9360168936037552
80,303,36,419,0.20887728459530025,0.9140811455847255,0.1832531806964645,0.9438769997323497
5,87,13,105,0.05434782608695652,0.8761904761904762,0.15711885076699825,0.9352602196869982
4,35,1,40,0.10256410256410256,0.975,0.15206643192147595,0.9409053809773208
0,12,2,14,0.0,0.8571428571428571,0.14611405096909502,0.9204972177120148
1,13,2,16,0.07142857142857142,0.875,0.11671417220570846,0.9221760943908913
22,233,14,269,0.08627450980392157,0.9479553903345725,0.10522957836817344,0.9173385527503758
31,127,14,172,0.1962025316455696,0.9186046511627907,0.10281354658920329,0.9091392172022029
1,21,4,26,0.045454545454545456,0.8461538461538461,0.07946744099766688,0.899435317283506
2,41,83,126,0.046511627906976744,0.3412698412698413,0.07834798411481265,0.8230180837234152
4,40,8,52,0.09090909090909091,0.8461538461538461,0.07668298244981098,0.8046114903168219
14,168,23,205,0.07692307692307693,0.8878048780487805,0.08767199343882195,0.808991779017668
13,150,2,165,0.07975460122699386,0.9878787878787879,0.08886142626716802,0.8251173201432093
15,131,4,150,0.10273972602739725,0.9733333333333334,0.09121360001337885,0.8287427405716036
6,108,2,116,0.05263157894736842,0.9827586206896551,0.07070346391363581,0.8379075933611556
44,173,6,223,0.20276497695852536,0.9730941704035875,0.09317638269991865,0.8560419253968331
10,91,1,102,0.09900990099009901,0.9901960784313726,0.10067613599750756,0.9487456735627661
4,52,5,61,0.07142857142857142,0.9180327868852459,0.09789320464314763,0.9590140936672518
1,29,9,39,0.03333333333333333,0.7692307692307693,0.09166609841604141,0.9420749352646788
14,146,4,164,0.0875,0.975609756097561,0.09277258395504227,0.9403222164387891
14,112,14,140,0.1111111111111111,0.9,0.09396849610985854,0.9298460259625986
28,92,20,140,0.23333333333333334,0.8571428571428571,0.11978303245071066,0.9119009168844847
12,94,2,108,0.11320754716981132,0.9814814814814815,0.10698911390946582,0.9130991041813266
6,59,2,67,0.09230769230769231,0.9701492537313433,0.10603165552626485,0.9102352720813224
4,124,4,132,0.03125,0.9696969696969697,0.10029185960789751,0.9176158696258544
11,38,1,50,0.22448979591836735,0.98,0.12759992569147377,0.9477257597357445
14,86,1,101,0.14,0.9900990099009901,0.1350999256914738,0.9497956531362343
4,25,1,30,0.13793103448275862,0.9666666666666667,0.13893134331599485,0.959319462660044
9,78,9,96,0.10344827586206896,0.90625,0.12037633510581425,0.9663347687824928
16,38,1,55,0.2962962962962963,0.9818181818181818,0.14653187069531207,0.966382868830593
0,3,59,62,0.0,0.04838709677419355,0.1333450575084989,0.8347025606938573
5,194,9,208,0.02512562814070352,0.9567307692307693,0.1324701472428851,0.8328502463415429
14,207,13,234,0.06334841628959276,0.9444444444444444,0.10944995015306017,0.8277708812621779
30,109,12,151,0.2158273381294964,0.9205298013245033,0.12028242702870252,0.8178324228941083
1,57,7,65,0.017241379310344827,0.8923076923076924,0.10304104771835769,0.8072097122713977
22,201,6,229,0.09865470852017937,0.9737991266375546,0.10235625238380204,0.8168595875053342
0,0,71,71,,0.0,,0.6765998472455939
4,10,1,15,0.2857142857142857,0.9333333333333333,,0.8030207381826138
19,66,2,87,0.2235294117647059,0.9770114942528736,,0.805917984614343
1,61,3,65,0.016129032258064516,0.9538461538461539,,0.8072610859574443
32,79,32,143,0.2882882882882883,0.7762237762237763,,0.7866459395144833
136,448,11,595,0.2328767123287671,0.9815126050420168,,0.7993894984765297
1,58,1,60,0.01694915254237288,0.9833333333333333,,0.800751528004498
20,77,9,106,0.20618556701030927,0.9150943396226415,0.18138177855811352,0.9314792908077324
2,0,0,2,1.0,1.0,0.28342259488464416,0.9410031003315422
1,15,1,17,0.0625,0.9411764705882353,0.26041839320397187,0.9358838112365937
11,92,2,105,0.10679611650485436,0.9809523809523809,0.27337083381065613,0.9397561293946263
13,114,22,149,0.10236220472440945,0.8523489932885906,0.24680996473010203,0.9506311604038854
14,45,4,63,0.23728813559322035,0.9365079365079365,0.24744016805359534,0.9442019220418738
4,24,3,31,0.14285714285714285,0.9032258064516129,0.26542702381284816,0.9327579896301995
1,23,0,24,0.041666666666666664,1.0,0.23897087521083535,0.9494956646149834
29,73,15,117,0.28431372549019607,0.8717948717948718,0.13672997885229196,0.9311806462999651
20,88,2,110,0.18518518518518517,0.9818181818181818,0.15425643387874702,0.9369866050471004
26,96,3,125,0.21311475409836064,0.976,0.1694448106778193,0.9362791220539031
82,301,36,419,0.21409921671018275,0.9140811455847255,0.18765695974665306,0.945098000953351
5,87,13,105,0.05434782608695652,0.8761904761904762,0.1615226298171868,0.9364812209079995
4,35,1,40,0.10256410256410256,0.975,0.1564702109716645,0.942126382198322
0,12,2,14,0.0,0.8571428571428571,0.15051783001928357,0.921718218933016
1,13,2,16,0.07142857142857142,0.875,0.12010566515333719,0.9221760943908913
23,231,15,269,0.09055118110236221,0.9442379182156134,0.10658652171293391,0.9168074853048102
33,125,14,172,0.2088607594936709,0.9186046511627907,0.10597880819797822,0.9086081497566374
2,20,4,26,0.09090909090909091,0.8461538461538461,0.08838021879782224,0.8989042498379404
1,38,87,126,0.02564102564102564,0.30952380952380953,0.0842792473055464,0.8179518688855595
4,40,8,52,0.09090909090909091,0.8461538461538461,0.08261424564054475,0.7995452754789659
12,168,25,205,0.06666666666666667,0.8780487804878049,0.09213805516435426,0.8025318359568158
13,150,2,165,0.07975460122699386,0.9878787878787879,0.09332748799270033,0.8186573770823568
15,131,4,150,0.10273972602739725,0.9733333333333334,0.09506870869627677,0.8228138649563169
4,110,2,116,0.03508771929824561,0.9827586206896551,0.07024398866835886,0.831978717745869
44,173,6,223,0.20276497695852536,0.9730941704035875,0.08622340096113522,0.8501130497815462
9,92,1,102,0.0891089108910891,0.9901960784313726,0.09529024171114428,0.9473519453397695
3,57,1,61,0.05,0.9836065573770492,0.08944608586698845,0.9669880469430844
1,29,9,39,0.03333333333333333,0.7692307692307693,0.08468418110508368,0.9514426167635078
14,146,4,164,0.0875,0.975609756097561,0.08579066664408455,0.9496898979376182
15,111,14,140,0.11904761904761904,0.9,0.08812036564697337,0.9392137074614276
28,94,18,140,0.22950819672131148,0.8714285714285714,0.11589471956455422,0.9233094147098443
12,94,2,108,0.11320754716981132,0.9814814814814815,0.10310080102330936,0.9245076020066862
6,60,1,67,0.09090909090909091,0.9850746268656716,0.10335796959730961,0.923775966068729
3,125,4,132,0.0234375,0.9696969696969697,0.09956332674016675,0.9217888821144319
11,38,1,50,0.22448979591836735,0.98,0.12687139282374305,0.951898772224322
15,85,1,101,0.15,0.9900990099009901,0.13579996425231447,0.9539686656248119
5,24,1,30,0.1724137931034483,0.9666666666666667,0.1434237034031472,0.9634924751486215
10,76,10,96,0.11627906976744186,0.8958333333333334,0.12724811383830872,0.9669788697064445
16,38,1,55,0.2962962962962963,0.9818181818181818,0.15340364942780657,0.9670269697545447
0,3,59,62,0.0,0.04838709677419355,0.14041663644079358,0.8332144654557619
6,193,9,208,0.03015075376884422,0.9567307692307693,0.1413756726934856,0.8313621511034476
15,205,14,234,0.06818181818181818,0.9401709401709402,0.11904596158826429,0.825672285413582
29,110,12,151,0.20863309352517986,0.9205298013245033,0.12742211780614712,0.8157338270455126
2,56,7,65,0.034482758620689655,0.8923076923076924,0.10771768430861017,0.8051111164228019
26,197,6,229,0.11659192825112108,0.9737991266375546,0.1077623783777072,0.8162490868948336
0,0,71,71,,0.0,,0.6759893466350932
4,10,1,15,0.2857142857142857,0.9333333333333333,,0.8024102375721132
19,66,2,87,0.2235294117647059,0.9770114942528736,,0.8053074840038423
1,61,3,65,0.016129032258064516,0.9538461538461539,,0.8072610859574444
31,80,32,143,0.27927927927927926,0.7762237762237763,,0.7866459395144833
134,451,11,596,0.22905982905982905,0.9815436241610739,,0.7993939297792522
1,58,1,60,0.01694915254237288,0.9833333333333333,,0.8007559593072205
20,77,9,106,0.20618556701030927,0.9150943396226415,0.17954950823269253,0.9314837221104549
2,0,0,2,1.0,1.0,0.28159032455922317,0.9410075316342645
1,15,1,17,0.0625,0.9411764705882353,0.2585861228785509,0.9358882425393161
9,94,2,105,0.08737864077669903,0.9809523809523809,0.26876463838121295,0.9397605606973486
12,116,21,149,0.09375,0.8590604026845637,0.2422604556270302,0.951594364477461
14,45,4,63,0.23728813559322035,0.9365079365079365,0.24343592798894326,0.9451606948127271
4,25,2,31,0.13793103448275862,0.9354838709677419,0.2607190539804269,0.9383250573319284
1,23,0,24,0.041666666666666664,1.0,0.24134499031922177,0.9468049152258144
29,74,14,117,0.2815533980582524,0.8803418803418803,0.13870976147040073,0.9297108981317973
21,87,2,110,0.19444444444444445,0.9818181818181818,0.15755896781960707,0.9355168568789327
26,96,3,125,0.21311475409836064,0.976,0.17552126972270157,0.9348093738857354
87,295,37,419,0.22774869109947643,0.9116945107398569,0.19366034076570543,0.9413697594084953
5,87,13,105,0.05434782608695652,0.8761904761904762,0.16510470333018587,0.9327529793631439
4,35,1,40,0.10256410256410256,0.975,0.1593485547168944,0.943006435584342
0,12,2,14,0.0,0.8571428571428571,0.15339617376451348,0.9225982723190359
1,13,2,16,0.07142857142857142,0.875,0.12337834138884475,0.9218351465559103
22,232,15,269,0.08661417322834646,0.9442379182156134,0.10797401692940219,0.916466537469829
31,125,15,171,0.1987179487179487,0.9122807017543859,0.10591733044648619,0.9073637805775984
2,20,4,26,0.09090909090909091,0.8461538461538461,0.08636881613357397,0.8980008284938826
0,41,85,126,0.0,0.3253968253968254,0.07860484097829447,0.8193160212376467
4,40,8,52,0.09090909090909091,0.8461538461538461,0.0769398393132928,0.8009094278310533
12,170,23,205,0.06593406593406594,0.8878048780487805,0.08635899158958794,0.8052897165318995
14,149,2,165,0.08588957055214724,0.9878787878787879,0.08842484860724163,0.8214152576574405
12,134,4,150,0.0821917808219178,0.9733333333333334,0.08779307826346609,0.8255717455314006
4,110,2,116,0.03508771929824561,0.9827586206896551,0.06441733120350852,0.8356400196650106
44,173,6,223,0.20276497695852536,0.9730941704035875,0.08039674349628487,0.8537743517006878
9,92,1,102,0.0891089108910891,0.9901960784313726,0.09312658790929759,0.9487456735627661
2,54,5,61,0.03571428571428571,0.9180327868852459,0.08524161573861112,0.9590140936672517
1,29,9,39,0.03333333333333333,0.7692307692307693,0.08058436822422076,0.9420749352646787
14,146,4,164,0.0875,0.975609756097561,0.08081442957391402,0.9403222164387891
15,111,14,140,0.11904761904761904,0.9,0.08607954932044277,0.9298460259625987
30,90,20,140,0.25,0.8571428571428571,0.11678130370640769,0.9119009168844846
12,94,2,108,0.11320754716981132,0.9814814814814815,0.10398738516516282,0.9130991041813267
6,60,1,67,0.09090909090909091,0.9850746268656716,0.10424455373916308,0.9123674682433693
4,124,4,132,0.03125,0.9696969696969697,0.10360679863712227,0.9197480657879014
12,37,1,50,0.24489795918367346,0.98,0.13383031661574227,0.9498579558977915
15,85,1,101,0.15,0.9900990099009901,0.14275888804431372,0.9519278492982813
6,23,1,30,0.20689655172413793,0.9666666666666667,0.15530873556953068,0.9614516588220907
9,76,11,96,0.10588235294117647,0.8854166666666666,0.13472050027541305,0.9654907744683493
16,38,1,55,0.2962962962962963,0.9818181818181818,0.1608760358649109,0.9655388745164493
0,3,59,62,0.0,0.04838709677419355,0.1478890228778979,0.8317263702176668
4,195,9,208,0.020100502512562814,0.9567307692307693,0.14629623752254975,0.8298740558653525
15,205,14,234,0.06818181818181818,0.9401709401709402,0.12105107452228471,0.8241841901754867
30,108,13,151,0.21739130434782608,0.9139072847682119,0.13067840371483128,0.8132996580136612
2,56,7,65,0.034482758620689655,0.8923076923076924,0.10604786184291011,0.8026769473909506
24,199,6,229,0.10762331838565023,0.9737991266375546,0.10629657119212065,0.8153030131010776
0,0,71,71,,0.0,,0.6750432728413374
4,9,2,15,0.3076923076923077,0.8666666666666667,,0.7919403542545478
19,66,2,87,0.2235294117647059,0.9770114942528736,,0.794837600686277
1,61,3,65,0.016129032258064516,0.9538461538461539,,0.7967912026398789
30,81,32,143,0.2702702702702703,0.7762237762237763,,0.7771221299906738
135,450,11,596,0.23076923076923078,0.9815436241610739,,0.7898701202554426
1,57,1,59,0.017241379310344827,0.9830508474576272,,0.7911917946583101
21,76,9,106,0.21649484536082475,0.9150943396226415,0.1831609253465357,0.9219195574615446
2,0,0,2,1.0,1.0,0.2820620242476346,0.9409671765091636
1,15,1,17,0.0625,0.9411764705882353,0.25905782256696236,0.9358478874142152
11,92,2,105,0.10679611650485436,0.9809523809523809,0.2720102631736466,0.9397202055722477
11,116,22,149,0.08661417322834646,0.8523489932885906,0.2457736778819432,0.950595236581507
14,45,4,63,0.23728813559322035,0.9365079365079365,0.246704949999656,0.944161566916773
4,25,2,31,0.13793103448275862,0.9354838709677419,0.26394632931000084,0.9373662845610751
1,23,0,24,0.041666666666666664,1.0,0.2414300177549027,0.9472472835297628
30,76,11,117,0.2830188679245283,0.905982905982906,0.13900414174412104,0.9338162700987495
18,89,2,109,0.16822429906542055,0.981651376146789,0.1541076130391811,0.9395983994642572
26,96,3,125,0.21311475409836064,0.976,0.17072769311774877,0.9391773468326782
82,303,33,418,0.21298701298701297,0.9210526315789473,0.1880591711635125,0.9500319481246404
5,87,13,105,0.05434782608695652,0.8761904761904762,0.15945950995515565,0.9420301033189215
4,35,1,40,0.10256410256410256,0.975,0.1537033613418642,0.9479824842713025
0,13,1,14,0.0,0.9285714285714286,0.14775098038948323,0.9377784026386495
1,14,1,16,0.06666666666666667,0.9375,0.11684352306693158,0.9422808446410915
22,232,15,269,0.08661417322834646,0.9442379182156134,0.10518493366163527,0.9369360649366377
33,124,14,171,0.21019108280254778,0.9181286549707602,0.10476726633366203,0.9286687299324609
2,24,0,26,0.07692307692307693,1.0,0.08532956118167113,0.9399469254211825
1,62,63,126,0.015873015873015872,0.5,0.07983315972253677,0.886205428822543
4,46,1,51,0.08,0.9803921568627451,0.07660971649909354,0.8869757369457923
12,170,23,205,0.06593406593406594,0.8878048780487805,0.08602886877538866,0.8811519440139854
13,150,2,165,0.07975460122699386,0.9878787878787879,0.08789857371257827,0.8883489137109551
17,129,4,150,0.11643835616438356,0.9733333333333334,0.09215917127486929,0.8925054015849152
4,110,2,116,0.03508771929824561,0.9827586206896551,0.06714440505996898,0.9017382538304715
44,173,6,223,0.20276497695852536,0.9730941704035875,0.08512181935074734,0.8978945638881269
9,92,1,102,0.0891089108910891,0.9901960784313726,0.09558409006761492,0.9679225750926087
2,58,1,61,0.03333333333333333,0.9836065573770492,0.08891742340094826,0.9683817751660807
1,29,9,39,0.03333333333333333,0.7692307692307693,0.08426017588655789,0.9514426167635077
14,146,4,164,0.0875,0.975609756097561,0.08536666142555878,0.9496898979376182
15,111,14,140,0.11904761904761904,0.9,0.08573941326602098,0.9392137074614276
28,93,19,140,0.23140495867768596,0.8642857142857143,0.1137847331773696,0.9222890065465791
12,94,2,108,0.11320754716981132,0.9814814814814815,0.10099081463612473,0.923487193843421
5,61,1,67,0.07575757575757576,0.9850746268656716,0.09908348104562284,0.9227555579054637
3,125,4,132,0.0234375,0.9696969696969697,0.09766979056943237,0.9207684739511667
11,38,1,50,0.22448979591836735,0.98,0.12497785665300865,0.9508783640610566
15,85,1,101,0.15,0.9900990099009901,0.13390642808158007,0.9529482574615465
6,23,1,30,0.20689655172413793,0.9666666666666667,0.14645627560679705,0.9624720669853561
11,81,4,96,0.11956521739130435,0.9583333333333334,0.13047916970874254,0.975907441135016
16,38,1,55,0.2962962962962963,0.9818181818181818,0.1566347052982404,0.975955541183116
0,3,59,62,0.0,0.04838709677419355,0.14581219447572957,0.8421430368843336
5,190,13,208,0.02564102564102564,0.9375,0.14612698385301895,0.8375434697847665
14,208,12,234,0.06306306306306306,0.9487179487179487,0.1230660220165469,0.8330746053159019
29,113,9,151,0.20422535211267606,0.9403973509933775,0.13081250088978635,0.8259743683291001
4,54,7,65,0.06896551724137931,0.8923076923076924,0.1111080673922494,0.8153516577063895
25,198,6,229,0.11210762331838565,0.9737991266375546,0.11004269681040388,0.8175610567498496
9,57,5,71,0.13636363636363635,0.9295774647887324,0.08719517396288103,0.8100980971742141
4,9,2,15,0.3076923076923077,0.8666666666666667,0.13115121791892498,0.9269951785874244
19,66,2,87,0.2235294117647059,0.9770114942528736,0.15942098736516502,0.9326396777664065
1,61,3,65,0.016129032258064516,0.9538461538461539,0.1527161258215938,0.9333722784990072
31,84,28,143,0.26956521739130435,0.8041958041958042,0.16205039228996926,0.9139149146707825
136,449,11,596,0.23247863247863249,0.9815436241610739,0.18540940875243403,0.9266629049355511
1,57,1,59,0.017241379310344827,0.9830508474576272,0.17185708817985673,0.9279845793384187
22,75,9,106,0.2268041237113402,0.9150943396226415,0.1847771578009573,0.9259155614575486
2,0,0,2,1.0,1.0,0.2836782567020562,0.9449631805051677
1,15,1,17,0.0625,0.9411764705882353,0.2606740550213839,0.9398438914102192
9,94,2,105,0.08737864077669903,0.9809523809523809,0.270852570524046,0.9437162095682518
13,116,20,149,0.10077519379844961,0.8657718120805369,0.24673971001078104,0.9525127821232137
15,44,4,63,0.2542372881355932,0.9365079365079365,0.2498480893903469,0.9460791124584796
4,24,3,31,0.14285714285714285,0.9032258064516129,0.2677931984684609,0.9346755351719062
1,21,0,22,0.045454545454545456,1.0,0.2430370833492766,0.9492593559643705
29,63,14,106,0.31521739130434784,0.8679245283018868,0.14521099639275487,0.9303914314360686
21,66,2,89,0.2413793103448276,0.9775280898876404,0.1707651835848731,0.9355845199074121
28,72,3,103,0.28,0.970873786407767,0.1954042004819545,0.9344311510483714
83,262,36,381,0.24057971014492754,0.905511811023622,0.21455024806706127,0.9410535626835367
7,76,13,96,0.08433734939759036,0.8645833333333334,0.19283220707191182,0.9313935546125117
4,29,1,34,0.12121212121212122,0.9705882352941176,0.189740061122623,0.9367156834640523
0,12,2,14,0.0,0.8571428571428571,0.18324655462911651,0.9163075201987462
1,7,2,10,0.125,0.8,0.15607264158563824,0.9066040161556195
22,193,15,230,0.10232558139534884,0.9347826086956522,0.13620782316428418,0.9004975188424783
31,110,15,156,0.2198581560283688,0.9038461538461539,0.12761613116833684,0.8909221427622479
2,18,4,24,0.1,0.8333333333333334,0.1075333154333472,0.8806109316636352
1,39,82,122,0.025,0.32786885245901637,0.09905655123369142,0.8039374343958757
3,37,8,48,0.075,0.8333333333333334,0.09245481963195981,0.7843295912586207
10,155,22,187,0.06060606060606061,0.8823529411764706,0.10111282828996848,0.7879310318348514
11,124,2,137,0.08148148148148149,0.9854014598540146,0.09489589707303726,0.8144169546711392
16,121,4,141,0.11678832116788321,0.9716312056737588,0.0969620027548279,0.8196810399537258
4,97,2,103,0.039603960396039604,0.9805825242718447,0.07121140337878086,0.8306433785859673
44,173,6,223,0.20276497695852536,0.9730941704035875,0.08589211437285592,0.8506092124531465
7,71,1,79,0.08974358974358974,0.9873417721518988,0.09514119862194016,0.9448196295521296
2,50,1,53,0.038461538461538464,0.9811320754716981,0.08992141840215995,0.9659337355718961
1,27,8,36,0.03571428571428571,0.7777777777777778,0.08636545056047781,0.9509944265149398
13,140,4,157,0.08496732026143791,0.9745222929936306,0.08686342752904301,0.9494402598205994
14,103,14,131,0.11965811965811966,0.8931297709923665,0.08727339874193395,0.9382257691518291
26,76,21,123,0.2549019607843137,0.8292682926829268,0.11803025594025882,0.9166094503534122
12,86,2,100,0.12244897959183673,0.98,0.10655654203073185,0.9175959974386139
5,59,1,65,0.078125,0.9846153846153847,0.10489674349593332,0.9172065135048262
5,109,4,118,0.043859649122807015,0.9661016949152542,0.10566790216182884,0.915059316282477
11,35,1,47,0.2391304347826087,0.9787234042553191,0.13472735202873212,0.9437658343506973
15,84,1,100,0.15151515151515152,0.99,0.1442341850649769,0.9459769353516071
4,23,1,28,0.14814814814814814,0.9642857142857143,0.14830418913498097,0.9561420701077996
9,59,10,78,0.1323529411764706,0.8717948717948718,0.13079718633386053,0.9622172956952204
17,34,1,52,0.3333333333333333,0.9807692307692307,0.16092352258264578,0.9623271858051107
0,1,59,60,0.0,0.016666666666666666,0.1497628082969315,0.8240487975267223
4,162,13,179,0.024096385542168676,0.9273743016759777,0.14693948492826886,0.8185163127782543
14,173,13,200,0.0748663101604278,0.935,0.12347318141081444,0.8122701121703514
28,99,13,140,0.2204724409448819,0.9071428571428571,0.13332422275791878,0.800433377476474
3,53,7,63,0.05357142857142857,0.8888888888888888,0.11981326281838742,0.7896624024197846
23,181,6,210,0.11274509803921569,0.9714285714285714,0.11701214237020816,0.8038957880817417
0,0,71,71,,0.0,,0.6637858979718515
4,8,2,14,0.3333333333333333,0.8571428571428571,,0.7838539251827358
18,49,2,69,0.26865671641791045,0.9710144927536232,,0.7900882381938281
1,59,3,63,0.016666666666666666,0.9523809523809523,,0.792571231391107
31,78,33,142,0.28440366972477066,0.7676056338028169,,0.7726373423425298
128,452,11,591,0.2206896551724138,0.9813874788494078,,0.785851426622604
1,51,1,53,0.019230769230769232,0.9811320754716981,,0.7872376414859078
23,62,9,94,0.27058823529411763,0.9042553191489362,0.20193843511999754,0.9164169727928987
2,0,0,2,1.0,1.0,0.29717653035809277,0.9368251360582048
1,15,1,17,0.0625,0.9411764705882353,0.2677255708698199,0.9325625614631494
9,84,2,95,0.0967741935483871,0.9789473684210527,0.2791695032814942,0.9363577637545923
11,109,22,142,0.09166666666666666,0.8450704225352113,0.2516356457017651,0.9474241621449344
14,41,4,59,0.2545454545454545,0.9322033898305084,0.25647218846934233,0.9403978637136631
4,24,2,30,0.14285714285714285,0.9333333333333333,0.2741330989873957,0.933569471979611
1,21,0,22,0.045454545454545456,1.0,0.23144617543381377,0.9496362846213753
28,64,14,106,0.30434782608695654,0.8679245283018868,0.13206729344623613,0.9307683600930734
17,71,2,90,0.19318181818181818,0.9777777777777777,0.1507361246150673,0.9359971182630081
28,72,3,103,0.28,0.970873786407767,0.18102738675098964,0.934557319042349
84,262,36,382,0.24277456647398843,0.9057591623036649,0.20343268196155942,0.9420467231809678
5,78,13,96,0.060240963855421686,0.8645833333333334,0.18056153636221287,0.9317717798703101
4,29,1,34,0.12121212121212122,0.9705882352941176,0.17817312018069323,0.9367866890597923
0,12,2,14,0.0,0.8571428571428571,0.17167961368718673,0.9163785257944862
0,8,2,10,0.0,0.8,0.12820135281762152,0.9066750217513595
22,191,15,228,0.10328638497652583,0.9342105263157895,0.11535914807400834,0.9004511286853611
33,107,15,155,0.2357142857142857,0.9032258064516129,0.10903261746176342,0.8907871315487678
3,17,4,24,0.15,0.8333333333333334,0.09577910796547937,0.8804405845530062
0,40,82,122,0.0,0.32786885245901637,0.08717325598613342,0.8037670872852465
3,37,8,48,0.075,0.8333333333333334,0.08057152438440182,0.7841592441479917
10,155,22,187,0.06060606060606061,0.8823529411764706,0.08922953304241046,0.7877606847242221
13,121,2,136,0.09701492537313433,0.9852941176470589,0.10308880809571538,0.8142312729595164
15,122,4,141,0.10948905109489052,0.9716312056737588,0.10397490325548175,0.8195770842963691
5,96,2,103,0.04950495049504951,0.9805825242718447,0.07737356965273372,0.8306280439849737
44,173,6,223,0.20276497695852536,0.9730941704035875,0.08491142350395163,0.8505938778521527
6,72,1,79,0.07692307692307693,0.9873417721518988,0.09590043449296262,0.944804294951136
2,46,5,53,0.041666666666666664,0.9056603773584906,0.09113852973105786,0.9551367298118727
1,27,8,36,0.03571428571428571,0.7777777777777778,0.08758256188937573,0.9401974207549166
13,140,4,157,0.08496732026143791,0.9745222929936306,0.08586147544484768,0.9386585886615697
13,103,15,131,0.11206896551724138,0.8854961832061069,0.08623003464804066,0.9263535854519052
27,79,19,125,0.25471698113207547,0.848,0.11554603902475864,0.9074132248416416
12,86,2,100,0.12244897959183673,0.98,0.1040723251152317,0.9083997719268434
5,59,1,65,0.078125,0.9846153846153847,0.104244028411935,0.9080102879930555
3,111,4,118,0.02631578947368421,0.9661016949152542,0.10205104595579464,0.9166447619297361
10,36,1,47,0.21739130434782608,0.9787234042553191,0.12800490576058612,0.9453512799979563
15,84,1,100,0.15151515151515152,0.99,0.13751173879683093,0.9475623809988664
4,23,1,28,0.14814814814814814,0.9642857142857143,0.14266590774410332,0.9588180282959531
9,59,10,78,0.1323529411764706,0.8717948717948718,0.12518533060758835,0.9622172956952204
15,37,1,53,0.28846153846153844,0.9811320754716981,0.14890141044611718,0.962379020762606
0,1,59,60,0.0,0.016666666666666666,0.13774069616040288,0.8241006324842176
5,161,13,179,0.030120481927710843,0.9273743016759777,0.13828422365383525,0.8185681477357496
14,174,12,200,0.07446808510638298,0.94,0.11786662090505766,0.8130362328421326
31,98,11,140,0.24031007751937986,0.9214285714285714,0.13055161033423315,0.8032403144747855
4,52,7,63,0.07142857142857142,0.8888888888888888,0.11959167080286505,0.7924693394180962
23,181,6,210,0.11274509803921569,0.9714285714285714,0.11679055035468576,0.8067027250800534
1,2,64,67,0.3333333333333333,0.04477611940298507,0.12320080676494218,0.6729375884988087
4,8,2,14,0.3333333333333333,0.8571428571428571,0.1708198543839898,0.793005615709693
18,49,2,69,0.26865671641791045,0.9710144927536232,0.20489645931116116,0.7992399287207851
1,59,3,63,0.016666666666666666,0.9523809523809523,0.19663911381977314,0.8010086362037783
32,77,32,141,0.29357798165137616,0.7730496453900709,0.20424881441005832,0.7798116467697068
130,449,11,590,0.22452504317789293,0.9813559322033898,0.2261197389456757,0.793021224386064
1,51,1,53,0.019230769230769232,0.9811320754716981,0.21276054911589762,0.794407439249368
23,62,9,94,0.27058823529411763,0.9042553191489362,0.2037969636817239,0.9171901820702181
2,0,0,2,1.0,1.0,0.2990350589198192,0.9375983453355242
1,15,1,17,0.0625,0.9411764705882353,0.26958409943154626,0.9333357707404689
10,83,2,95,0.10752688172043011,0.9789473684210527,0.2825641301535124,0.9371309730319117
13,109,20,142,0.10655737704918032,0.8591549295774648,0.2558469009246273,0.9494317279158252
13,42,4,59,0.23636363636363636,0.9322033898305084,0.25753812852259067,0.9424099361482706
4,24,2,30,0.14285714285714285,0.9333333333333333,0.2751990390406441,0.9355815444142185
1,23,0,24,0.041666666666666664,1.0,0.23151361077895127,0.9459803706428807
30,74,13,117,0.28846153846153844,0.8888888888888888,0.12986525913059963,0.9301073547698647
18,90,2,110,0.16666666666666666,0.9818181818181818,0.14474621151155204,0.935913313517
25,98,3,126,0.2032520325203252,0.9761904761904762,0.1640734782932351,0.9352330414081564
86,299,32,417,0.22337662337662337,0.9232613908872902,0.18380280765711596,0.9442703829634836
7,85,13,105,0.07608695652173914,0.8761904761904762,0.16319537529581477,0.9356536029181323
4,35,1,40,0.10256410256410256,0.975,0.1574392266825233,0.9459070591393303
0,12,2,14,0.0,0.8571428571428571,0.15148684573014234,0.9254988958740241
1,13,2,16,0.07142857142857142,0.875,0.12048213615400419,0.9235147688898973
26,226,15,267,0.10317460317460317,0.9438202247191011,0.1114118413694237,0.9180864893043142
31,126,14,171,0.19745222929936307,0.9181286549707602,0.1105832980521434,0.9097919434157833
1,21,4,26,0.045454545454545456,0.8461538461538461,0.0851658583489894,0.8987765798824343
0,37,89,126,0.0,0.29365079365079366,0.07429629313159809,0.8155566252339082
4,40,8,52,0.09090909090909091,0.8461538461538461,0.07263129146659643,0.7971500318273147
11,171,23,205,0.06043956043956044,0.8878048780487805,0.08126551438653364,0.801530320528161
13,150,2,165,0.07975460122699386,0.9878787878787879,0.0824549472148797,0.8176558616537022
16,131,3,150,0.10884353741496598,0.98,0.08326479496350296,0.8228244009795448
3,112,2,117,0.02608695652173913,0.9829059829059829,0.05878404170955668,0.8320783049702909
44,173,6,223,0.20276497695852536,0.9730941704035875,0.08125696049583953,0.8502126370059682
10,91,1,102,0.09900990099009901,0.9901960784313726,0.09540123206585369,0.9497191062603366
3,57,1,61,0.05,0.9836065573770492,0.08955707622169783,0.9693552078636515
1,29,9,39,0.03333333333333333,0.7692307692307693,0.08568475806366538,0.9524160494610784
14,146,4,164,0.0875,0.975609756097561,0.08679124360266625,0.9506633306351888
14,111,15,140,0.112,0.8928571428571429,0.08724216682909969,0.9382143510433519
28,91,21,140,0.23529411764705882,0.85,0.11712890413271679,0.9192277820567831
12,94,2,108,0.11320754716981132,0.9814814814814815,0.10433498559147193,0.920425969353625
5,59,2,66,0.078125,0.9696969696969697,0.10135142830717207,0.9174975252487104
4,123,5,132,0.031496062992125984,0.9621212121212122,0.09870800873461863,0.9144281902121623
11,38,1,50,0.22448979591836735,0.98,0.12601607481819493,0.9445380803220523
13,87,1,101,0.13,0.9900990099009901,0.1320875033896235,0.9466079737225421
4,25,1,30,0.13793103448275862,0.9666666666666667,0.13579193688716046,0.9571521914096169
9,77,10,96,0.10465116279069768,0.8958333333333334,0.11712865762196599,0.9636998104572362
15,39,1,55,0.2777777777777778,0.9818181818181818,0.1406386905659612,0.9637479105053363
0,4,59,63,0.0,0.06349206349206349,0.1294779762802469,0.8342900667617782
4,191,13,208,0.020512820512820513,0.9375,0.12790894164034614,0.830772750744462
16,204,12,232,0.07272727272727272,0.9482758620689655,0.10622858118447547,0.8262407310400286
29,109,13,151,0.21014492753623187,0.9139072847682119,0.11767785654679432,0.8153561988782032
5,53,7,65,0.08620689655172414,0.8923076923076924,0.11028869398521797,0.8047334882554925
24,199,6,229,0.10762331838565023,0.9737991266375546,0.11071328764163976,0.8158714587275241
1,1,65,67,0.5,0.029850746268656716,0.1424593193876715,0.6798761107918777
3,11,1,15,0.21428571428571427,0.9333333333333333,0.17307156428563067,0.8041391493406306
19,66,2,87,0.2235294117647059,0.9770114942528736,0.20207393446447147,0.8097836485196125
0,62,3,65,0.0,0.9538461538461539,0.19168432407486108,0.8105794044877823
32,78,32,142,0.2909090909090909,0.7746478873239436,0.20322206169955523,0.7906852048528867
132,451,11,594,0.22641509433962265,0.9814814814814815,0.22325180424068355,0.8034243175919995
0,58,1,59,0.0,0.9830508474576272,0.20787704447130498,0.804745991994867
23,74,9,106,0.23711340206185566,0.9150943396226415,0.17032181619442718,0.9312093624740078
2,0,0,2,1.0,1.0,0.2825667141536109,0.9407331719978173
1,15,1,17,0.0625,0.9411764705882353,0.2595625124729386,0.9356138829028688
7,96,2,105,0.06796116504854369,0.9809523809523809,0.26927125033701627,0.9394862010609012
11,117,22,150,0.0859375,0.8533333333333334,0.23998959449286045,0.9507269790622426
13,46,4,63,0.22033898305084745,0.9365079365079365,0.239121578594464,0.9443021869231648
4,25,2,31,0.13793103448275862,0.9354838709677419,0.2588260120920009,0.937506904567467
2,22,0,24,0.08333333333333333,1.0,0.2442250822494541,0.9450279896904997
30,74,13,117,0.28846153846153844,0.8888888888888888,0.14257673060110249,0.9291549738174838
19,89,2,110,0.17592592592592593,0.9818181818181818,0.15878043430480618,0.9349609325646192
28,95,3,126,0.22764227642276422,0.9761904761904762,0.17604417143593618,0.9342806604557755
85,300,32,417,0.22077922077922077,0.9232613908872902,0.19419120297582484,0.9442703829634836
7,85,13,105,0.07608695652173914,0.8761904761904762,0.17358377061452362,0.9356536029181323
4,35,1,40,0.10256410256410256,0.975,0.1678276220012322,0.9459070591393303
0,12,2,14,0.0,0.8571428571428571,0.1559228600964703,0.9254988958740241
2,12,2,16,0.14285714285714285,0.875,0.1351222321529852,0.9235147688898973
24,228,15,267,0.09523809523809523,0.9438202247191011,0.12359539919758081,0.9180864893043142
31,126,14,171,0.19745222929936307,0.9181286549707602,0.11928253532280922,0.9097919434157833
3,19,4,26,0.13636363636363635,0.8461538461538461,0.10722316612058287,0.8987765798824343
0,44,82,126,0.0,0.3492063492063492,0.09635360090319156,0.8234931331704162
4,40,8,52,0.09090909090909091,0.8461538461538461,0.09468859923818991,0.8050865397638226
11,170,24,205,0.06077348066298342,0.8829268292682927,0.10337052504718754,0.8087699643531706
13,150,2,165,0.07975460122699386,0.9878787878787879,0.09435587624288054,0.8248955054787118
16,130,4,150,0.1095890410958904,0.9733333333333334,0.0964060113654227,0.8291116638521735
3,112,2,117,0.02608695652173913,0.9829059829059829,0.07192525811147642,0.8383655678429197
44,173,6,223,0.20276497695852536,0.9730941704035875,0.08141116391074628,0.8564998998785969
10,91,1,102,0.09900990099009901,0.9901960784313726,0.09555543548076043,0.9480698611964574
2,55,4,61,0.03508771929824561,0.9344262295081968,0.08758095382206824,0.9606802016756504
0,30,9,39,0.0,0.7692307692307693,0.07889902801307061,0.9444379073845758
14,146,4,164,0.0875,0.975609756097561,0.08000551355207149,0.9426851885586861
15,111,14,140,0.11904761904761904,0.9,0.081356738973747,0.9322089980824956
28,92,20,140,0.23333333333333334,0.8571428571428571,0.11096336423254617,0.9142428372591919
12,94,2,108,0.11320754716981132,0.9814814814814815,0.09816944569130133,0.9154410245560339
5,59,2,66,0.078125,0.9696969696969697,0.09518588840700147,0.9125125804511193
5,122,5,132,0.03937007874015748,0.9621212121212122,0.09579765404156028,0.916469006538693
11,38,1,50,0.22448979591836735,0.98,0.12786762488704134,0.9465788966485829
15,85,1,101,0.15,0.9900990099009901,0.13679619631561277,0.9486487900490728
4,25,1,30,0.13793103448275862,0.9666666666666667,0.1394938270920613,0.9581725995728824
9,76,11,96,0.10588235294117647,0.8854166666666666,0.12128654417889602,0.9622117152191407
14,39,1,54,0.2641509433962264,0.9814814814814815,0.14284988649695532,0.9622117152191408
0,4,59,63,0.0,0.06349206349206349,0.13168917221124102,0.8327538714755828
5,190,13,208,0.02564102564102564,0.9375,0.12972787891136506,0.8292365554582667
16,204,12,232,0.07272727272727272,0.9482758620689655,0.10804751845549439,0.8247045357538333
28,110,13,151,0.2028985507246377,0.9139072847682119,0.11560445427329978,0.8138200035920079
5,53,7,65,0.08620689655172414,0.8923076923076924,0.10821529171172342,0.8031972929692971
25,198,6,229,0.11210762331838565,0.9737991266375546,0.10910461605132472,0.8158233586794241
1,0,66,67,1.0,0.014925373134328358,0.21422590985186382,0.6777439146298309
4,9,2,15,0.3076923076923077,0.8666666666666667,0.2581819538079078,0.7924831436547741
19,66,2,87,0.2235294117647059,0.9770114942528736,0.2864517232541478,0.798127642833756
2,60,3,65,0.03225806451612903,0.9538461538461539,0.280670407795413,0.7989233988019258
31,80,32,143,0.27927927927927926,0.7762237762237763,0.2915819404460761,0.7792543261527207
129,454,11,594,0.22126929674099485,0.9814814814814815,0.31087656904454336,0.7919934388918334
0,58,1,59,0.0,0.9830508474576272,0.294861194284774,0.7933151132947008
23,74,9,106,0.23711340206185566,0.9150943396226415,0.18587739457932476,0.9219106799358885
2,0,0,2,1.0,1.0,0.28477849348042367,0.9409582989835076
1,15,1,17,0.0625,0.9411764705882353,0.26177429179975137,0.9358390098885593
7,96,2,105,0.06796116504854369,0.9809523809523809,0.2668747347329535,0.9397113280465917
11,118,21,150,0.08527131782945736,0.86,0.2391593116686932,0.9516793600146236
13,46,4,63,0.22033898305084745,0.9365079365079365,0.23902640971295788,0.9452545678755458
4,24,3,31,0.14285714285714285,0.9032258064516129,0.259434572978264,0.9338509905889724
1,23,0,24,0.041666666666666664,1.0,0.23367897499671036,0.9496362846213753
30,74,13,117,0.28846153846153844,0.8888888888888888,0.13203062334835874,0.9337632687483594
16,92,2,110,0.14814814814814814,0.9818181818181818,0.14426607308380848,0.9395692274954948
28,95,3,126,0.22764227642276422,0.9761904761904762,0.16430373531896064,0.9388889553866512
82,302,33,417,0.21354166666666666,0.920863309352518,0.1825329019856273,0.9485360948179632
7,85,13,105,0.07608695652173914,0.8761904761904762,0.1619254696243261,0.9399193147726118
4,35,1,40,0.10256410256410256,0.975,0.1568730507788038,0.9455644760629343
0,12,2,14,0.0,0.8571428571428571,0.15092066982642285,0.9251563127976281
2,12,2,16,0.14285714285714285,0.875,0.13012004188293777,0.9231721858135012
27,225,15,267,0.10714285714285714,0.9438202247191011,0.1242621431678962,0.9177439062279182
32,124,15,171,0.20512820512820512,0.9122807017543859,0.12104584726867348,0.908613938451334
2,20,4,26,0.09090909090909091,0.8461538461538461,0.10352690787473408,0.8979411579943808
0,47,79,126,0.0,0.373015873015873,0.09265734265734278,0.8260590718265803
4,40,8,52,0.09090909090909091,0.8461538461538461,0.09099234099234112,0.807652478419987
10,172,23,205,0.054945054945054944,0.8878048780487805,0.09884163455592039,0.8120327671208332
12,151,2,165,0.0736196319018405,0.9878787878787879,0.08895056156230577,0.8281583082463743
16,130,4,150,0.1095890410958904,0.9733333333333334,0.08930001641273909,0.8323744666198359
5,110,2,117,0.043478260869565216,0.9829059829059829,0.06620716723293339,0.8424637924986357
45,172,6,223,0.2073732718894009,0.9730941704035875,0.08284490737297769,0.860598124534313
10,91,1,102,0.09900990099009901,0.9901960784313726,0.09698917894299183,0.9487667253079558
2,54,5,61,0.03571428571428571,0.9180327868852459,0.08910420677230536,0.9590351454124413
1,29,9,39,0.03333333333333333,0.7692307692307693,0.08601681797063085,0.9420959870098684
14,146,4,164,0.0875,0.975609756097561,0.08799972769893935,0.9403432681839788
16,110,14,140,0.12698412698412698,0.9,0.09048473996868743,0.9298670777077883
28,92,20,140,0.23333333333333334,0.8571428571428571,0.11760689317779717,0.9119009168844847
13,93,2,108,0.12264150943396226,0.9814814814814815,0.10550235568416308,0.9130991041813266
5,60,1,66,0.07692307692307693,0.9848484848484849,0.10234709510315991,0.912335162240914
4,123,5,132,0.031496062992125984,0.9621212121212122,0.1017444918571371,0.918633508703195
12,37,1,50,0.24489795918367346,0.98,0.13196800983575713,0.948743398813085
15,85,1,101,0.15,0.9900990099009901,0.14089658126432855,0.9508132922135749
3,26,1,30,0.10344827586206896,0.9666666666666667,0.13753431681832026,0.9603371017373845
8,78,10,96,0.09302325581395349,0.8958333333333334,0.11749002002983742,0.9658643126217382
15,39,1,55,0.2777777777777778,0.9818181818181818,0.13965234407895394,0.9659124126698383
0,4,59,63,0.0,0.06349206349206349,0.12866333308994293,0.834290066761778
5,194,9,208,0.02512562814070352,0.9567307692307693,0.12775327096831116,0.8335200034917148
15,205,12,232,0.06818181818181818,0.9482758620689655,0.1025081079680461,0.8289879837872813
31,108,12,151,0.22302158273381295,0.9205298013245033,0.11293976264430512,0.8190495254192117
5,53,7,65,0.08620689655172414,0.8923076923076924,0.110476708457113,0.8084268147965012
24,199,6,229,0.10762331838565023,0.9737991266375546,0.11256243168164111,0.8195647852685327
1,1,65,67,0.5,0.029850746268656716,0.14430846342767284,0.6835694373328864
4,9,2,15,0.3076923076923077,0.8666666666666667,0.1882645073837168,0.7983086663578297
19,66,2,87,0.2235294117647059,0.9770114942528736,0.2166079050442886,0.8012059127895589
1,61,3,65,0.016129032258064516,0.9538461538461539,0.20917179276946665,0.8020016687577286
29,82,32,143,0.26126126126126126,0.7762237762237763,0.21463460398767356,0.7813865223147677
127,462,5,594,0.21561969439728354,0.9915824915824916,0.23312214653703917,0.7955686364968818
0,58,1,59,0.0,0.9830508474576272,0.21774738676766053,0.7968903108997493
23,74,9,106,0.23711340206185566,0.9150943396226415,0.1801921584907828,0.92335368137889
2,0,0,2,1.0,1.0,0.2790932573918817,0.942401300426509
1,15,1,17,0.0625,0.9411764705882353,0.2560890557112094,0.9372820113315606
11,92,2,105,0.10679611650485436,0.9809523809523809,0.26904149631789365,0.9411543294895931
12,116,22,150,0.09375,0.8533333333333334,0.24511131613771348,0.952169980505244
13,46,4,63,0.22033898305084745,0.9365079365079365,0.24578550023107978,0.9443021869231648
4,24,3,31,0.14285714285714285,0.9032258064516129,0.2661936634963859,0.9328986096365914
1,23,0,24,0.041666666666666664,1.0,0.23441168298733492,0.9505886655737562
30,74,13,117,0.28846153846153844,0.8888888888888888,0.1327633313389833,0.9347156497007403
16,92,2,110,0.14814814814814814,0.9818181818181818,0.14499878107443304,0.9405216084478756
28,94,3,125,0.22950819672131148,0.976,0.16668996590424592,0.9398141254546785
84,300,33,417,0.21875,0.920863309352518,0.18354350964732455,0.9485088839336094
9,83,13,105,0.09782608695652174,0.8761904761904762,0.16604166734813514,0.9398921038882578
4,35,1,40,0.10256410256410256,0.975,0.16098924850261284,0.9455372651785805
0,12,2,14,0.0,0.8571428571428571,0.1550368675502319,0.9251291019132744
2,12,2,16,0.14285714285714285,0.875,0.13423623960674683,0.9231449749291475
26,226,15,267,0.10317460317460317,0.9438202247191011,0.12781144746766895,0.9177166953435646
32,124,15,171,0.20512820512820512,0.9122807017543859,0.1243285915257966,0.908613938451334
3,19,4,26,0.13636363636363635,0.8461538461538461,0.11255911100631609,0.8979411579943808
1,42,83,126,0.023255813953488372,0.3412698412698413,0.10190621486302562,0.8215239244342901
4,40,8,52,0.09090909090909091,0.8461538461538461,0.10024121319802395,0.8031173310276968
11,171,23,205,0.06043956043956044,0.8878048780487805,0.10887543611796116,0.807497619728543
12,151,2,165,0.0736196319018405,0.9878787878787879,0.09898436312434655,0.823623160854084
17,129,4,150,0.11643835616438356,0.9733333333333334,0.10087918498002944,0.8278393192275457
5,110,2,117,0.043478260869565216,0.9829059829059829,0.07778633580022376,0.8379286451063453
44,173,6,223,0.20276497695852536,0.9730941704035875,0.08727224159949361,0.8560629771420226
10,91,1,102,0.09900990099009901,0.9901960784313726,0.09809425403329512,0.9487667253079558
2,58,1,61,0.03333333333333333,0.9836065573770492,0.0898691458081869,0.9684028269112703
1,29,9,39,0.03333333333333333,0.7692307692307693,0.08599682765015446,0.9514636685086973
14,146,4,164,0.0875,0.975609756097561,0.08797973737846297,0.9497109496828078
15,111,14,140,0.11904761904761904,0.9,0.08835248921892516,0.9392347592066174
27,93,20,140,0.225,0.8571428571428571,0.11428416623755873,0.9212685983833137
12,94,2,108,0.11320754716981132,0.9814814814814815,0.10149024769631386,0.9224667856801557
5,60,1,66,0.07692307692307693,0.9848484848484849,0.09833498711531068,0.921702843739743
3,124,5,132,0.023622047244094488,0.9621212121212122,0.09694766053113371,0.918633508703195
12,37,1,50,0.24489795918367346,0.98,0.12717117850975374,0.9487433988130851
15,85,1,101,0.15,0.9900990099009901,0.13609974993832516,0.950813292213575
4,25,1,30,0.13793103448275862,0.9666666666666667,0.13879738071477368,0.9603371017373845
9,77,10,96,0.10465116279069768,0.8958333333333334,0.12160468968487334,0.9658643126217383
15,39,1,55,0.2777777777777778,0.9818181818181818,0.14511472262886854,0.9659124126698383
0,4,59,63,0.0,0.06349206349206349,0.13412571163985756,0.8342900667617782
4,195,9,208,0.020100502512562814,0.9567307692307693,0.13362263382106732,0.8335200034917147
17,204,11,232,0.07692307692307693,0.9525862068965517,0.10962622206955352,0.8296037473340794
34,105,12,151,0.2446043165467626,0.9205298013245033,0.12314112443337676,0.8196652889660099
4,54,7,65,0.06896551724137931,0.8923076923076924,0.1132889076846083,0.8090425783432992
23,200,6,229,0.1031390134529148,0.9737991266375546,0.11307288635063929,0.8201805488153308
1,1,65,67,0.5,0.029850746268656716,0.14481891809667105,0.6841852008796844
4,9,2,15,0.3076923076923077,0.8666666666666667,0.18877496205271502,0.7989244299046278
19,66,2,87,0.2235294117647059,0.9770114942528736,0.21783623480302117,0.8018216763363569
1,61,3,65,0.016129032258064516,0.9538461538461539,0.20915137127944797,0.8020016687577287
30,81,32,143,0.2702702702702703,0.7762237762237763,0.2128179360970919,0.7813865223147676
125,458,11,594,0.2144082332761578,0.9814814814814815,0.23359546695920314,0.7941256350538805
1,57,1,59,0.017241379310344827,0.9830508474576272,0.2213243763674074,0.7954473094567478
24,73,9,106,0.24742268041237114,0.9150943396226415,0.1852419021406033,0.9219106799358886
2,0,0,2,1.0,1.0,0.2841430010417022,0.9409582989835076
1,15,1,17,0.0625,0.9411764705882353,0.2611387993610299,0.9358390098885592
9,94,2,105,0.08737864077669903,0.9809523809523809,0.271317314863692,0.9397113280465916
11,117,22,150,0.0859375,0.8533333333333334,0.2449840619679391,0.9507269790622427
13,46,4,63,0.22033898305084745,0.9365079365079365,0.2458313119357519,0.9443021869231648
4,25,2,31,0.13793103448275862,0.9354838709677419,0.2630726912460967,0.937506904567467
1,23,0,24,0.041666666666666664,1.0,0.17122412924925642,0.9482213248662477
30,76,11,117,0.2830188679245283,0.905982905982906,0.14022682466704617,0.9347903114352343
19,88,2,109,0.17757009345794392,0.981651376146789,0.15666540944675247,0.9405724408007419
29,93,3,125,0.23770491803278687,0.976,0.17664809960050462,0.9401833830499821
88,297,32,417,0.22857142857142856,0.9232613908872902,0.1951335102937075,0.9503474851686894
7,85,13,105,0.07608695652173914,0.8761904761904762,0.16963943914746246,0.9423456403629705
4,35,1,40,0.10256410256410256,0.975,0.163883290534171,0.9482980213153515
0,13,1,14,0.0,0.9285714285714286,0.15793090958179004,0.9380939396826984
2,13,1,16,0.13333333333333333,0.9375,0.1365472617830479,0.9425963816851404
26,227,15,268,0.10276679841897234,0.9440298507462687,0.12586107677748054,0.9372218780564946
32,124,15,171,0.20512820512820512,0.9122807017543859,0.12120726064825457,0.9281191211642641
3,23,0,26,0.11538461538461539,1.0,0.10503771590728125,0.939081779608937
1,66,59,126,0.014925373134328358,0.5317460317460317,0.09630034685193686,0.8898754304025877
4,47,1,52,0.0784313725490196,0.9807692307692307,0.0928528139926393,0.8906996062267636
13,169,23,205,0.07142857142857142,0.8878048780487805,0.10305689562529237,0.8848758132949567
12,151,2,165,0.0736196319018405,0.9878787878787879,0.0945263668493648,0.8920727829919264
16,130,4,150,0.1095890410958904,0.9733333333333334,0.09550097294606738,0.8962589947900784
5,110,2,117,0.043478260869565216,0.9829059829059829,0.07240812376626168,0.9063483206688779
44,173,6,223,0.20276497695852536,0.9730941704035875,0.08489103256253452,0.9025046307265334
10,91,1,102,0.09900990099009901,0.9901960784313726,0.09690310797050176,0.967997494538725
2,58,1,61,0.03333333333333333,0.9836065573770492,0.09046053093968945,0.9684028269112704
1,29,9,39,0.03333333333333333,0.7692307692307693,0.08501835406894116,0.9514636685086975
14,146,4,164,0.0875,0.975609756097561,0.08700126379724964,0.9497109496828078
16,110,14,140,0.12698412698412698,0.9,0.08948627606699773,0.9392347592066174
30,91,19,140,0.24793388429752067,0.8642857142857143,0.11869422227099137,0.9222890065465791
13,93,2,108,0.12264150943396226,0.9814814814814815,0.10724801262462522,0.923487193843421
5,60,1,66,0.07692307692307693,0.9848484848484849,0.10409275204362207,0.9227232519030084
5,123,4,132,0.0390625,0.9696969696969697,0.10491120442457444,0.9207361679487114
11,38,1,50,0.22448979591836735,0.98,0.13221927050815072,0.9508460580586016
15,85,1,101,0.15,0.9900990099009901,0.14114784193672217,0.9529159514590914
5,24,1,30,0.1724137931034483,0.9666666666666667,0.14763779423948237,0.9624397609829008
9,83,4,96,0.09782608695652174,0.9583333333333334,0.1261938231907682,0.9758751351325607
16,37,1,54,0.3018867924528302,0.9814814814814815,0.1518002921934636,0.9758751351325606
0,4,59,63,0.0,0.06349206349206349,0.14081128120445263,0.8442527892245006
5,194,9,208,0.02512562814070352,0.9567307692307693,0.13882029951026742,0.8424004748721863
16,206,10,232,0.07207207207207207,0.9568965517241379,0.11704633896079666,0.8390999822613489
33,113,4,150,0.22602739726027396,0.9733333333333334,0.12790739571226437,0.8367048856088264
4,59,2,65,0.06349206349206349,0.9692307692307692,0.1123471486249237,0.8370711859751268
23,200,6,229,0.1031390134529148,0.9737991266375546,0.11310613812440842,0.8392805850185869
9,57,1,67,0.13636363636363635,0.9850746268656716,0.0894599729688093,0.8397938915020428
4,10,1,15,0.2857142857142857,0.9333333333333333,0.13027629949942154,0.9640569300507955
19,66,2,87,0.2235294117647059,0.9770114942528736,0.15861969715999333,0.9669541764825247
2,60,3,65,0.03225806451612903,0.9538461538461539,0.15293198179485862,0.9665184053570984
29,86,28,143,0.25217391304347825,0.8041958041958042,0.15666719833531634,0.9423559011945943
121,468,5,594,0.20543293718166383,0.9915824915824916,0.17694446600525926,0.9455490043876974
1,57,1,59,0.017241379310344827,0.9830508474576272,0.16467337541346352,0.9468706787905649
24,73,9,106,0.24742268041237114,0.9150943396226415,0.18053895313471133,0.9368734948987035
2,0,0,2,1.0,1.0,0.28257976946124197,0.946397304422513
1,15,1,17,0.0625,0.9411764705882353,0.25957556778056967,0.9412780153275647
8,95,2,105,0.07766990291262135,0.9809523809523809,0.2660629732657829,0.9451503334855971
13,116,21,150,0.10077519379844961,0.86,0.24443458480220737,0.9531223614576251
13,46,4,63,0.22033898305084745,0.9365079365079365,0.24656401992637647,0.9452545678755458
4,25,2,31,0.13793103448275862,0.9354838709677419,0.2638053992367213,0.9384592855198479
1,21,0,22,0.045454545454545456,1.0,0.24244138366809187,0.9472152886489438
28,63,16,107,0.3076923076923077,0.8504672897196262,0.14354028476699296,0.9258534728946046
20,67,2,89,0.22988505747126436,0.9775280898876404,0.16745243583431643,0.9310465613659483
27,72,3,102,0.2727272727272727,0.9705882352941176,0.19709670460901998,0.9298843943714908
84,258,34,376,0.24561403508771928,0.9095744680851063,0.21670823343107518,0.9390992580214759
7,76,13,96,0.08433734939759036,0.8645833333333334,0.1897953872411205,0.9294392499504509
4,28,1,33,0.125,0.9696969696969697,0.18724436683295725,0.9346340551452561
0,12,2,14,0.0,0.8571428571428571,0.18075086033945076,0.9142258918799501
1,7,2,10,0.125,0.8,0.15465195924054967,0.9070162790628605
23,190,15,228,0.107981220657277,0.9342105263157895,0.13723712540998004,0.9008280556954532
33,108,15,156,0.23404255319148937,0.9038461538461539,0.13171073690486815,0.8912934726314585
2,18,4,24,0.1,0.8333333333333334,0.11090873189233678,0.8804018819526337
1,40,81,122,0.024390243902439025,0.3360655737704918,0.10234485967874375,0.8048993448722278
3,37,8,48,0.075,0.8333333333333334,0.09520200253588662,0.7854188253917084
11,154,22,187,0.06666666666666667,0.8823529411764706,0.10472581205969614,0.7890202659679387
10,124,2,136,0.07462686567164178,0.9852941176470589,0.09752965001278782,0.8154908542032329
16,121,4,141,0.11678832116788321,0.9716312056737588,0.09878780722858871,0.8208366655400857
4,97,2,103,0.039603960396039604,0.9805825242718447,0.07101086540066731,0.8317990041723272
44,173,6,223,0.20276497695852536,0.9730941704035875,0.08569157639474236,0.8517648380395064
7,71,1,79,0.08974358974358974,0.9873417721518988,0.09502776865776388,0.9448042949511359
2,47,4,53,0.04081632653061224,0.9245283018867925,0.09014438673356563,0.9578321476016302
1,27,8,36,0.03571428571428571,0.7777777777777778,0.08572261802608265,0.9428928385446741
13,141,4,158,0.08441558441558442,0.9746835443037974,0.08712100641807445,0.9413770423527795
16,101,14,131,0.13675213675213677,0.8931297709923665,0.08997298007296782,0.9301625516840092
25,79,19,123,0.2403846153846154,0.8455284552845529,0.11865593078562149,0.9108691132572532
12,86,2,100,0.12244897959183673,0.98,0.10718221687609454,0.9118556603424549
5,59,1,65,0.078125,0.9846153846153847,0.10552241834129603,0.9114661764086672
4,109,5,118,0.035398230088495575,0.9576271186440678,0.10474840456385079,0.9161945788025637
10,36,1,47,0.21739130434782608,0.9787234042553191,0.13070226436864227,0.9449010968707839
15,84,1,100,0.15151515151515152,0.99,0.14028791681143757,0.9470891619702415
4,23,1,28,0.14814814814814814,0.9642857142857143,0.14191591843943918,0.9572542967264338
6,63,9,78,0.08695652173913043,0.8846153846153846,0.11999761934722705,0.9628381437736957
16,35,1,52,0.3137254901960784,0.9807692307692307,0.147322835147833,0.9629480338835857
0,1,59,60,0.0,0.016666666666666666,0.13616212086211874,0.8246696456051975
5,161,13,179,0.030120481927710843,0.9273743016759777,0.13540815683914947,0.8203478146097561
16,172,12,200,0.0851063829787234,0.94,0.11651031092927767,0.814815899716139
32,98,12,142,0.24615384615384617,0.9154929577464789,0.13003012444909118,0.8041720365370645
2,54,7,63,0.03571428571428571,0.8888888888888888,0.11396814410139657,0.7934010614803751
24,181,6,211,0.11707317073170732,0.9715639810426541,0.11827052252890755,0.8058222895414138
1,1,65,67,0.5,0.029850746268656716,0.14488116678661062,0.6699767917556174
4,9,1,14,0.3076923076923077,0.9285714285714286,0.18883721074265458,0.8002489005991549
18,49,2,69,0.26865671641791045,0.9710144927536232,0.222913815669826,0.806483213610247
2,58,3,63,0.03333333333333333,0.9523809523809523,0.2155176657204845,0.8082519210932403
30,80,32,142,0.2727272727272727,0.7746478873239436,0.2193138695166883,0.7881311967471637
121,458,11,590,0.20898100172711573,0.9813559322033898,0.24406625751852115,0.8013407743635209
1,51,1,53,0.019230769230769232,0.9811320754716981,0.23008877158981572,0.8027076449962417
23,62,9,94,0.27058823529411763,0.9042553191489362,0.19731566234611825,0.9276225839791387
1,1,0,2,0.5,1.0,0.2247881898186457,0.9378266656117917
1,15,1,17,0.0625,0.9411764705882353,0.1953372303303728,0.9335640910167363
9,83,2,94,0.09782608695652174,0.9787234042553191,0.20455048084797114,0.9373272984273601
12,109,21,142,0.09917355371900827,0.852112676056338,0.17975709241821908,0.9483936968177022
14,41,4,59,0.2545454545454545,0.9322033898305084,0.18626629996369606,0.9413719050501478
4,24,2,30,0.14285714285714285,0.9333333333333333,0.2039272104817494,0.9345435133160956
1,21,0,22,0.045454545454545456,1.0,0.23626669632244288,0.9505886655737564
28,63,16,107,0.3076923076923077,0.8504672897196262,0.13736559742134397,0.9292268498194173
15,72,2,89,0.1724137931034483,0.9775280898876404,0.15306756786469375,0.9344199382907608
28,71,3,102,0.2828282828282828,0.9705882352941176,0.1823759078526454,0.932939346053866
85,257,34,376,0.24853801169590642,0.9095744680851063,0.20459230155006725,0.9400214129231668
5,78,13,96,0.060240963855421686,0.8645833333333334,0.17929984844466743,0.9297464696125094
4,28,1,33,0.125,0.9696969696969697,0.17745255780427333,0.9346340551452562
0,12,2,14,0.0,0.8571428571428571,0.17095905131076683,0.9142258918799498
0,8,2,10,0.0,0.8,0.12700300735472286,0.9070162790628605
24,190,15,229,0.11214953271028037,0.9344978165938864,0.118393827298556,0.9008690971637529
33,108,15,156,0.23404255319148937,0.9038461538461539,0.11142443735044269,0.891334514099758
2,18,4,24,0.1,0.8333333333333334,0.09020472139388462,0.8804429234209333
1,37,84,122,0.02631578947368421,0.3114754098360656,0.08535826791077927,0.8014275057784664
3,37,8,48,0.075,0.8333333333333334,0.07821541076792213,0.7819469862979469
11,155,23,189,0.06626506024096386,0.8783068783068783,0.08768184794520269,0.7849704178928071
10,124,2,136,0.07462686567164178,0.9852941176470589,0.09834282875543722,0.8114410061281012
15,122,4,141,0.10948905109489052,0.9716312056737588,0.09796275995323867,0.8167457759966544
4,98,2,104,0.0392156862745098,0.9807692307692307,0.07013035039367015,0.8277347869856655
44,173,6,223,0.20276497695852536,0.9730941704035875,0.0848110613877452,0.8477006208528446
7,71,1,79,0.08974358974358974,0.9873417721518988,0.09387217571201742,0.9442529583265351
2,50,1,53,0.038461538461538464,0.9811320754716981,0.0886523954922372,0.9653670643463015
1,27,8,36,0.03571428571428571,0.7777777777777778,0.08428799913128318,0.9510057642707157
13,140,4,157,0.08496732026143791,0.9745222929936306,0.08576520692982548,0.9494669321773689
15,102,14,131,0.1282051282051282,0.8931297709923665,0.088438932231288,0.9382524415085983
25,80,19,124,0.23809523809523808,0.8467741935483871,0.11685029677710634,0.9191102933341923
13,85,2,100,0.1326530612244898,0.98,0.10683430881510125,0.920096840419394
5,59,1,65,0.078125,0.9846153846153847,0.10517451028030271,0.9197073564856062
4,110,5,119,0.03508771929824561,0.957983193277311,0.10469253611411802,0.9164003733149795
10,36,1,47,0.21739130434782608,0.9787234042553191,0.1306463959189095,0.9451068913831998
14,85,1,100,0.1414141414141414,0.99,0.13871022751215287,0.9473179923841096
4,24,1,29,0.14285714285714285,0.9655172413793104,0.14080337246244068,0.9576590595822444
7,62,9,78,0.10144927536231885,0.8846153846153846,0.12128252064345221,0.963064944020387
17,34,1,52,0.3333333333333333,0.9807692307692307,0.14995113094471554,0.9631748341302772
0,1,59,60,0.0,0.016666666666666666,0.1387904166590013,0.8248964458518888
4,162,13,179,0.024096385542168676,0.9273743016759777,0.13722022612241885,0.8205237470516984
16,172,12,200,0.0851063829787234,0.94,0.11832238021254705,0.8149918321580812
33,97,12,142,0.25384615384615383,0.9154929577464789,0.13438409627426312,0.804347968979007
2,54,7,63,0.03571428571428571,0.8888888888888888,0.11907797382528351,0.7934010614803751
23,181,6,210,0.11274509803921569,0.9714285714285714,0.12069166277912592,0.8058029453108304
1,1,65,67,0.5,0.029850746268656716,0.14450118658864972,0.6699574475250342
4,8,2,14,0.3333333333333333,0.8571428571428571,0.19212023420769736,0.7900254747359184
18,49,2,69,0.26865671641791045,0.9710144927536232,0.22705742433280332,0.7962597877470107
2,58,3,63,0.03333333333333333,0.9523809523809523,0.2196612743834619,0.798028495230004
31,78,32,141,0.28440366972477066,0.7730496453900709,0.22402663379469287,0.7776794506076599
121,458,11,590,0.20898100172711573,0.9813559322033898,0.24877902179652572,0.7908890282240172
1,51,1,53,0.019230769230769232,0.9811320754716981,0.23541983196674768,0.792275243087321
23,62,9,94,0.27058823529411763,0.9042553191489362,0.20264672272305015,0.9171901820702181
2,0,0,2,1.0,1.0,0.29788481796114535,0.9375983453355242
1,15,1,17,0.0625,0.9411764705882353,0.2684338584728725,0.9333357707404689
6,86,2,94,0.06521739130434782,0.9787234042553191,0.2729887238973031,0.9370989781510926
13,107,22,142,0.10833333333333334,0.8450704225352113,0.24783581869852633,0.9473876606003985
15,40,4,59,0.2727272727272727,0.9322033898305084,0.25694242884140595,0.9403658688328439
4,24,2,30,0.14285714285714285,0.9333333333333333,0.2746033393594593,0.9335374770987919
1,23,0,24,0.041666666666666664,1.0,0.23925429799944148,0.9505886655737561
27,73,17,117,0.27,0.8547008547008547,0.1349685837137272,0.9298316448167354
15,93,2,110,0.1388888888888889,0.9818181818181818,0.14588128212642562,0.9356376035638707
27,95,3,125,0.22131147540983606,0.976,0.16640150676888485,0.9349301205706734
88,295,34,417,0.2297650130548303,0.9184652278177458,0.18482862380551066,0.9432822959732086
5,87,13,105,0.05434782608695652,0.8761904761904762,0.15627298636999115,0.934665515927857
4,35,1,40,0.10256410256410256,0.975,0.15122056752446886,0.9403106772181796
0,12,2,14,0.0,0.8571428571428571,0.1452681865720879,0.9199025139528736
1,13,2,16,0.07142857142857142,0.875,0.11690083963331237,0.9228023918527514
24,229,15,268,0.09486166007905138,0.9440298507462687,0.11061123551762131,0.9174040588424781
31,125,15,171,0.1987179487179487,0.9122807017543859,0.10738358884735168,0.9083013019502476
1,21,4,26,0.045454545454545456,0.8461538461538461,0.08105352204731098,0.8979711045696904
1,40,85,126,0.024390243902439025,0.3253968253968254,0.07677386744952278,0.8192862973134546
4,40,8,52,0.09090909090909091,0.8461538461538461,0.07510886578452111,0.8008797039068613
13,169,23,205,0.07142857142857142,0.8878048780487805,0.08531294741717418,0.8052599926077074
12,151,2,165,0.0736196319018405,0.9878787878787879,0.08562595605621262,0.8213855337332484
15,131,4,150,0.10273972602739725,0.9733333333333334,0.08675139404883346,0.8255717455314006
5,110,2,117,0.043478260869565216,0.9829059829059829,0.06457429578477866,0.8356610714102002
45,172,6,223,0.2073732718894009,0.9730941704035875,0.08770554241832944,0.8537954034458776
10,90,1,101,0.1,0.9900990099009901,0.09850693614655244,0.948752858375044
4,52,5,61,0.07142857142857142,0.9180327868852459,0.0957240047921925,0.9590212784795297
0,30,9,39,0.0,0.7692307692307693,0.08551992315953945,0.9420821200769566
14,146,4,164,0.0875,0.975609756097561,0.08750283288784795,0.940329401251067
15,111,14,140,0.11904761904761904,0.9,0.08983253189073678,0.9298532107748765
29,91,20,140,0.24166666666666667,0.8571428571428571,0.11814516129032271,0.9118870499515729
13,93,2,108,0.12264150943396226,0.9814814814814815,0.10604062379668862,0.9130852372484147
5,60,2,67,0.07692307692307693,0.9701492537313433,0.1027439204999853,0.9102352720813224
4,122,6,132,0.031746031746031744,0.9545454545454546,0.09707498625962252,0.9154513674613521
12,36,2,50,0.25,0.96,0.13278927197390825,0.9427041147140994
14,86,1,101,0.14,0.9900990099009901,0.14028927197390823,0.9447740081145893
4,25,1,30,0.13793103448275862,0.9666666666666667,0.14298690275035675,0.9542978176383989
9,78,9,96,0.10344827586206896,0.90625,0.12324141834969991,0.9613131237608478
16,38,1,55,0.2962962962962963,0.9818181818181818,0.14804924504431907,0.9613612238089481
0,4,59,63,0.0,0.06349206349206349,0.13706023405530807,0.8318387680604794
5,190,13,208,0.02564102564102564,0.9375,0.13618809032602147,0.8294037031254143
17,204,12,233,0.07692307692307693,0.9484978540772532,0.11146281560074676,0.827760539422165
31,108,13,152,0.22302158273381295,0.9144736842105263,0.12332304170557717,0.8169569214663843
2,56,7,65,0.034482758620689655,0.8923076923076924,0.10854471658242447,0.8063342108436738
22,201,6,229,0.09865470852017937,0.9737991266375546,0.1078599212478688,0.8159840860776102
1,0,66,67,1.0,0.014925373134328358,0.20838902177696933,0.6778565419799168
3,11,1,15,0.21428571428571427,0.9333333333333333,0.23900126667492852,0.8021195805286696
19,66,2,87,0.2235294117647059,0.9770114942528736,0.2672710361211686,0.8077640797076516
2,60,3,65,0.03225806451612903,0.9538461538461539,0.26089032006303314,0.8085281225317803
33,77,32,142,0.3,0.7746478873239436,0.2718872368153456,0.7885530086908398
121,462,11,594,0.20754716981132076,0.9814814814814815,0.29661072412829287,0.8012921214299525
0,58,1,59,0.0,0.9830508474576272,0.28251719433969585,0.8026137958328201
24,73,9,106,0.24742268041237114,0.9150943396226415,0.17500614868432027,0.9312093624740075
2,0,0,2,1.0,1.0,0.287251046643504,0.9407331719978173
1,15,1,17,0.0625,0.9411764705882353,0.2642468449628317,0.9356138829028688
8,95,2,105,0.07766990291262135,0.9809523809523809,0.2707342504480449,0.9394862010609012
12,117,21,150,0.09302325581395349,0.86,0.2411661441357525,0.9516793600146237
14,45,4,63,0.23728813559322035,0.9365079365079365,0.24541485353316675,0.9452545678755457
4,25,2,31,0.13793103448275862,0.9354838709677419,0.2651192870307037,0.9384592855198478
1,23,0,24,0.041666666666666664,1.0,0.24960235483046686,0.9486839036689944
27,73,17,117,0.27,0.8547008547008547,0.14531664054475257,0.9279268829119737
18,90,2,110,0.16666666666666666,0.9818181818181818,0.16019759292570496,0.9337328416591087
27,95,3,125,0.22131147540983606,0.976,0.17794389246414205,0.9330253586659115
87,296,34,417,0.22715404699738903,0.9184652278177458,0.1957712985031391,0.9432822959732085
6,86,13,105,0.06521739130434782,0.8761904761904762,0.16634714859262223,0.9346655159278571
4,35,1,40,0.10256410256410256,0.975,0.15636862137271565,0.9403106772181796
0,12,2,14,0.0,0.8571428571428571,0.15041624042033472,0.9199025139528736
0,14,2,16,0.0,0.875,0.11184481184890614,0.9228023918527514
25,228,15,268,0.09881422924901186,0.9440298507462687,0.1021516065035269,0.9174040588424781
31,125,15,171,0.1987179487179487,0.9122807017543859,0.09892395983325727,0.9083013019502475
1,21,4,26,0.045454545454545456,0.8461538461538461,0.07296688818427961,0.8979711045696905
1,39,86,126,0.025,0.31746031746031744,0.06722154656937278,0.8181525104653821
4,40,8,52,0.09090909090909091,0.8461538461538461,0.06555654490437111,0.7997459170587887
11,171,23,205,0.06043956043956044,0.8878048780487805,0.07419076782430832,0.8041262057596349
11,152,2,165,0.06748466257668712,0.9878787878787879,0.0838314339066922,0.8202517468851759
17,129,4,150,0.11643835616438356,0.9733333333333334,0.08634916632317388,0.824437958683328
4,111,2,117,0.034782608695652174,0.9829059829059829,0.06292983203427437,0.8345272845621275
45,172,6,223,0.2073732718894009,0.9730941704035875,0.08606107866782516,0.8526616165978049
10,90,1,101,0.1,0.9900990099009901,0.09677536438211086,0.9487528583750439
2,54,5,61,0.03571428571428571,0.9180327868852459,0.08889039221142439,0.9590212784795294
1,29,9,39,0.03333333333333333,0.7692307692307693,0.08501807405339194,0.9420821200769566
14,146,4,164,0.0875,0.975609756097561,0.08787740797100808,0.9403294012510671
15,111,14,140,0.11904761904761904,0.9,0.0882501598114703,0.9298532107748765
29,91,20,140,0.24166666666666667,0.8571428571428571,0.11780502523590093,0.9118870499515729
13,93,2,108,0.12264150943396226,0.9814814814814815,0.10570048774226684,0.9130852372484147
6,59,2,67,0.09230769230769231,0.9701492537313433,0.10460158664336575,0.9102352720813226
3,123,6,132,0.023809523809523808,0.9545454545454546,0.1029009063712569,0.9154513674613523
12,36,2,50,0.25,0.96,0.13385328732363785,0.9427041147140995
16,84,1,101,0.16,0.9900990099009901,0.14421043018078072,0.9447740081145894
4,25,1,30,0.13793103448275862,0.9666666666666667,0.14690806095722922,0.9542978176383989
10,78,8,96,0.11363636363636363,0.9166666666666666,0.12861801766718592,0.9628012189989432
18,36,1,55,0.3333333333333333,0.9818181818181818,0.15871684965281035,0.9628493190470432
0,4,59,63,0.0,0.06349206349206349,0.14553003646599721,0.8333268632985745
5,190,13,208,0.02564102564102564,0.9375,0.14579167958478315,0.8308917983635097
18,203,12,233,0.08144796380090498,0.9484978540772532,0.1217128172706267,0.8292486346602601
30,110,13,153,0.21428571428571427,0.9150326797385621,0.12946791931144305,0.8185248732084848
3,55,7,65,0.05172413793103448,0.8923076923076924,0.11715264837548245,0.8079021625857742
23,200,6,229,0.1031390134529148,0.9737991266375546,0.11565302692070405,0.8160639425816152
1,0,66,67,1.0,0.014925373134328358,0.2108911221587993,0.677936398483922
4,10,1,15,0.2857142857142857,0.9333333333333333,0.25170744868941153,0.8021994370326748
19,66,2,87,0.2235294117647059,0.9770114942528736,0.2799772181356516,0.8078439362116567
2,60,3,65,0.03225806451612903,0.9538461538461539,0.27295008966639783,0.8086079790357853
33,78,32,143,0.2972972972972973,0.7762237762237763,0.28480888723948117,0.7887781356765302
123,460,11,594,0.2109777015437393,0.9814814814814815,0.3075593963270104,0.801517248415643
0,58,1,59,0.0,0.9830508474576272,0.2928252515480226,0.8028389228185105
24,73,9,106,0.24742268041237114,0.9150943396226415,0.18531420589264705,0.9314344894596981
2,0,0,2,1.0,1.0,0.2873550222191777,0.9409582989835076
1,15,1,17,0.0625,0.9411764705882353,0.2643508205385054,0.9358390098885592
8,95,2,105,0.07766990291262135,0.9809523809523809,0.2708382260237186,0.9397113280465916
13,116,21,150,0.10077519379844961,0.86,0.24276363980959745,0.9516793600146237
15,44,4,63,0.2542372881355932,0.9365079365079365,0.2489435807512909,0.9452545678755457
4,25,2,31,0.13793103448275862,0.9354838709677419,0.26864801424882784,0.9384592855198478
1,23,0,24,0.041666666666666664,1.0,0.24483289404746378,0.9496362846213753
29,72,16,117,0.2871287128712871,0.8632478632478633,0.14299413874336198,0.9301002650853557
19,89,2,110,0.17592592592592593,0.9818181818181818,0.15919784244706567,0.9359062238324911
25,97,3,125,0.20491803278688525,0.976,0.17321525905878438,0.9351987408392938
84,299,34,417,0.2193211488250653,0.9184652278177458,0.19115399460522228,0.9445032971942098
6,86,13,105,0.06521739130434782,0.8761904761904762,0.16172984469470536,0.9358865171488583
4,35,1,40,0.10256410256410256,0.975,0.15667742584918307,0.9415316784391808
0,12,2,14,0.0,0.8571428571428571,0.1507250448968021,0.9211235151738747
1,13,2,16,0.07142857142857142,0.875,0.11991073897641416,0.9228023918527514
25,228,15,268,0.09881422924901186,0.9440298507462687,0.10889478230828357,0.917404058842478
32,124,15,171,0.20512820512820512,0.9122807017543859,0.10892480692847213,0.9083013019502475
3,19,4,26,0.13636363636363635,0.8461538461538461,0.09707373371969656,0.8979711045696905
0,43,83,126,0.0,0.3412698412698413,0.08775696353336117,0.8215538710095996
4,40,8,52,0.09090909090909091,0.8461538461538461,0.08609196186835952,0.8031472776030063
12,170,23,205,0.06593406593406594,0.8878048780487805,0.09551111414465464,0.8075275663038527
12,151,2,165,0.0736196319018405,0.9878787878787879,0.09582412278369308,0.8236531074293937
12,134,4,150,0.0821917808219178,0.9733333333333334,0.09344948729410821,0.8278393192275457
4,111,2,117,0.034782608695652174,0.9829059829059829,0.06911440208945781,0.8379286451063453
45,172,6,223,0.2073732718894009,0.9730941704035875,0.07925863573599559,0.8560629771420226
10,90,1,101,0.1,0.9900990099009901,0.09354435002170988,0.9487528583750439
2,54,5,61,0.03571428571428571,0.9180327868852459,0.08565937785102341,0.9590212784795297
1,29,9,39,0.03333333333333333,0.7692307692307693,0.08100213033663305,0.9420821200769565
15,145,4,164,0.09375,0.975609756097561,0.08387789720779869,0.940329401251067
16,110,14,140,0.12698412698412698,0.9,0.0902768038024,0.9298532107748765
29,91,20,140,0.24166666666666667,0.8571428571428571,0.11983166922683064,0.9118870499515728
12,94,2,108,0.11320754716981132,0.9814814814814815,0.10637942283831783,0.913085237248415
6,60,1,67,0.09090909090909091,0.9850746268656716,0.10508072153961655,0.9123674682433693
3,123,6,132,0.023809523809523808,0.9545454545454546,0.1033800412675077,0.9175835636233992
11,38,1,50,0.22448979591836735,0.98,0.130688107351084,0.9476934537332893
16,84,1,101,0.16,0.9900990099009901,0.1401523930653697,0.9497633471337792
5,24,1,30,0.1724137931034483,0.9666666666666667,0.1466423453681299,0.9592871566575887
10,78,8,96,0.11363636363636363,0.9166666666666666,0.1283523020780866,0.967790558018133
17,37,1,55,0.3148148148148148,0.9818181818181818,0.15715334031308711,0.9678386580662329
0,4,59,63,0.0,0.06349206349206349,0.1441663273260741,0.8361840061557174
4,195,9,208,0.020100502512562814,0.9567307692307693,0.14363646714079395,0.8364961939679052
17,204,12,233,0.07692307692307693,0.9484978540772532,0.12255550728432389,0.831995887407513
30,110,13,153,0.21428571428571427,0.9150326797385621,0.13031060932514024,0.8212721259557375
5,53,7,65,0.08620689655172414,0.8923076923076924,0.11799533838917964,0.8106494153330269
24,199,6,229,0.10762331838565023,0.9737991266375546,0.11713633192479202,0.8188111953288679
1,1,65,67,0.5,0.029850746268656716,0.14359135837981848,0.6828158473932217
4,9,2,15,0.3076923076923077,0.8666666666666667,0.18754740233586245,0.7975550764181649
19,66,2,87,0.2235294117647059,0.9770114942528736,0.2166086750861686,0.800452322849894
1,61,3,65,0.016129032258064516,0.9538461538461539,0.2079238115625954,0.8012163656740227
31,80,32,143,0.27927927927927926,0.7762237762237763,0.2172086065616761,0.7813865223147677
122,461,11,594,0.20926243567753003,0.9814814814814815,0.23478796929393408,0.7941256350538802
0,58,1,59,0.0,0.9830508474576272,0.21941320952455548,0.7954473094567478
23,74,9,106,0.23711340206185566,0.9150943396226415,0.1818579812476777,0.9219106799358885
2,0,0,2,1.0,1.0,0.2807590801487766,0.9409582989835076
1,15,1,17,0.0625,0.9411764705882353,0.25775487846810435,0.9358390098885593
10,93,2,105,0.0970873786407767,0.9809523809523809,0.26932035652277747,0.9397113280465917
13,114,23,150,0.10236220472440945,0.8466666666666667,0.24404648872922466,0.9497745981098618
16,43,4,63,0.2711864406779661,0.9365079365079365,0.2528927751578584,0.9433498059707839
5,24,2,31,0.1724137931034483,0.9354838709677419,0.2775233170297796,0.936554523615086
1,23,0,24,0.041666666666666664,1.0,0.24483289404746378,0.9496362846213753
28,74,15,117,0.27450980392156865,0.8717948717948718,0.14119143746483076,0.931321266306357
18,90,2,110,0.16666666666666666,0.9818181818181818,0.15607238984578314,0.9371272250534922
26,96,3,125,0.21311475409836064,0.976,0.17126076664485548,0.9364197420602949
84,301,34,419,0.21818181818181817,0.918854415274463,0.1890367406708295,0.9457798966233134
6,86,13,105,0.06521739130434782,0.8761904761904762,0.15961259076031256,0.937163116577962
4,35,1,40,0.10256410256410256,0.975,0.1545601719147903,0.9428082778682845
0,12,2,14,0.0,0.8571428571428571,0.14860779096240934,0.9224001146029784
0,14,2,16,0.0,0.875,0.10939210468789953,0.9228579900608539
27,226,15,268,0.1067193675889328,0.9440298507462687,0.10082820481965184,0.9174596570505805
33,123,15,171,0.21153846153846154,0.9122807017543859,0.10060302016823768,0.90835690015835
2,20,4,26,0.09090909090909091,0.8461538461538461,0.08242120198641952,0.8979711045696905
1,44,81,126,0.022222222222222223,0.35714285714285715,0.07627903497468726,0.8238214447057448
4,40,8,52,0.09090909090909091,0.8461538461538461,0.0746140333096856,0.8054148512991516
13,169,23,205,0.07142857142857142,0.8878048780487805,0.08481811494233867,0.8097951399999976
13,150,2,165,0.07975460122699386,0.9878787878787879,0.0962116294033378,0.8259206811255387
16,131,3,150,0.10884353741496598,0.98,0.09651508223562824,0.8310592738760718
4,111,2,117,0.034782608695652174,0.9829059829059829,0.07126424611522691,0.8411485997548713
45,172,6,223,0.2073732718894009,0.9730941704035875,0.08790198625527121,0.8592829317905488
10,90,1,101,0.1,0.9900990099009901,0.09901309736638231,0.949705239327425
2,58,1,61,0.03333333333333333,0.9836065573770492,0.09078798914127408,0.9693413409307395
2,28,9,39,0.06666666666666667,0.7692307692307693,0.09010771703243055,0.9524021825281664
15,145,4,164,0.09375,0.975609756097561,0.09210705971428856,0.950649463702277
16,110,14,140,0.12698412698412698,0.9,0.09469857250988299,0.9392208922737055
28,92,20,140,0.23333333333333334,0.8571428571428571,0.12306296174383745,0.9212547314504018
12,94,2,108,0.11320754716981132,0.9814814814814815,0.10961071535532464,0.9224529187472438
6,60,1,67,0.09090909090909091,0.9850746268656716,0.10831201405662336,0.9217351497421983
3,125,4,132,0.0234375,0.9696969696969697,0.10689832358043287,0.9197480657879014
12,36,2,50,0.25,0.96,0.13308879977090907,0.9470008130406485
16,84,1,101,0.16,0.9900990099009901,0.1425530854851948,0.9490707064411384
5,24,1,30,0.1724137931034483,0.9666666666666667,0.14904303778795497,0.9585945159649479
10,77,9,96,0.11494252873563218,0.90625,0.13213006570256908,0.965609822087397
17,37,1,55,0.3148148148148148,0.9818181818181818,0.16093110393756957,0.9656579221354971
0,4,59,63,0.0,0.06349206349206349,0.14794409095055658,0.8340032702249817
4,195,9,208,0.020100502512562814,0.9567307692307693,0.14746737702377985,0.8321509558726673
17,204,12,233,0.07692307692307693,0.9484978540772532,0.12274210229850513,0.8305077921694177
30,111,12,153,0.2127659574468085,0.9215686274509803,0.13028009621947775,0.820717737533702
2,56,7,65,0.034482758620689655,0.8923076923076924,0.11057566272194082,0.8100950269109913
22,201,6,229,0.09865470852017937,0.9737991266375546,0.10824883126259043,0.8197449021449278
1,1,65,67,0.5,0.029850746268656716,0.1347038577176169,0.6837495542092814
3,11,1,15,0.21428571428571427,0.9333333333333333,0.16531610261557605,0.8080125927580342
19,66,2,87,0.2235294117647059,0.9770114942528736,0.1943773753658822,0.8109098391897633
2,60,3,65,0.03225806451612903,0.9538461538461539,0.1879966593077468,0.811673882013892
31,78,34,143,0.28440366972477066,0.7622377622377622,0.19823061820459853,0.788912329840575
123,460,11,594,0.2109777015437393,0.9814814814814815,0.22344418147931994,0.8016514425796879
1,57,1,59,0.017241379310344827,0.9830508474576272,0.21181370587791498,0.8029731169825552
22,75,9,106,0.2268041237113402,0.9150943396226415,0.17278572355096358,0.929436487461696
2,0,0,2,1.0,1.0,0.28503062151014724,0.9389602969855055
1,15,1,17,0.0625,0.9411764705882353,0.26202641982947494,0.9338410078905574
11,92,2,105,0.10679611650485436,0.9809523809523809,0.2726747129707215,0.9377133260485896
12,116,22,150,0.09375,0.8533333333333334,0.24543847443861136,0.9507269790622426
16,43,4,63,0.2711864406779661,0.9365079365079365,0.25403972288635807,0.9443021869231648
4,25,2,31,0.13793103448275862,0.9354838709677419,0.2712811021967029,0.937506904567467
1,23,0,24,0.041666666666666664,1.0,0.2472224413625755,0.9482533197470667
29,75,13,117,0.27884615384615385,0.8888888888888888,0.14420046334059752,0.9323803038740508
18,90,2,110,0.16666666666666666,0.9818181818181818,0.1590814157215499,0.938186262621186
27,95,3,125,0.22131147540983606,0.976,0.1799446526080549,0.937765209989607
82,304,33,419,0.21243523316062177,0.9212410501193318,0.1961248925282854,0.9476406919986061
7,85,13,105,0.07608695652173914,0.8761904761904762,0.16283861358983254,0.9396388471928873
3,36,1,40,0.07692307692307693,0.975,0.15341946131353743,0.9455912281452683
0,13,1,14,0.0,0.9285714285714286,0.14746708036115647,0.9353871465126152
0,15,1,16,0.0,0.9375,0.10763191552599163,0.9423315909570597
25,228,15,268,0.09881422924901186,0.9440298507462687,0.09793871018061237,0.9369332579467864
34,121,15,170,0.21935483870967742,0.9117647058823529,0.0976591906520183,0.9277567873585512
2,24,0,26,0.07692307692307693,1.0,0.07830031118951188,0.9390080659129322
0,65,61,126,0.0,0.5158730158730159,0.06743074597212058,0.8875341430104379
3,48,1,52,0.058823529411764705,0.9807692307692307,0.06484509632764741,0.8883583188346138
9,171,24,204,0.05,0.8823529411764706,0.07198795347050455,0.8817556777781911
11,152,2,165,0.06748466257668712,0.9878787878787879,0.08162861955288843,0.8889526474751609
16,131,3,150,0.10884353741496598,0.98,0.08306137786231042,0.8940912402256939
4,111,2,117,0.034782608695652174,0.9829059829059829,0.056693916431735394,0.9042542798004981
45,171,7,223,0.20833333333333334,0.968609865470852,0.07546681020462917,0.8997699748677627
10,90,1,101,0.1,0.9900990099009901,0.08975252449034346,0.9675165454431875
2,58,1,61,0.03333333333333333,0.9836065573770492,0.0861110679077104,0.9679218778157332
2,28,9,39,0.06666666666666667,0.7692307692307693,0.08849202028866279,0.9517615675377759
14,146,4,164,0.0875,0.975609756097561,0.09135135420627892,0.9500088487118862
16,110,14,140,0.12698412698412698,0.9,0.09394286700187335,0.9385802772833147
31,91,18,140,0.2540983606557377,0.8714285714285714,0.125273688710457,0.9226549327865418
13,93,2,108,0.12264150943396226,0.9814814814814815,0.1130319995819754,0.9244937350737745
5,61,1,67,0.07575757575757576,0.9850746268656716,0.10956879611877193,0.923775966068729
5,121,5,131,0.03968253968253968,0.9618320610687023,0.11047582559722999,0.9206653237389651
12,36,2,50,0.25,0.96,0.13666630178770617,0.9479180709917124
16,84,1,101,0.16,0.9900990099009901,0.14702344464484904,0.9499879643922023
5,24,1,30,0.1724137931034483,0.9666666666666667,0.1535133969476092,0.959511773916012
8,84,4,96,0.08695652173913043,0.9583333333333334,0.1296359913880939,0.9719267399024064
13,41,1,55,0.24074074074074073,0.9818181818181818,0.1465073101462051,0.9719748399505065
0,4,59,63,0.0,0.06349206349206349,0.1356847993236943,0.840320188039991
5,194,9,208,0.02512562814070352,0.9567307692307693,0.13360524053200343,0.8395914320631434
17,206,10,233,0.07623318385650224,0.9570815450643777,0.10878140965436087,0.8391745099294831
32,116,5,153,0.21621621621621623,0.9673202614379085,0.11681229768524891,0.8359204030061856
3,60,2,65,0.047619047619047616,0.9692307692307692,0.09898447690176308,0.836286703372486
20,203,6,229,0.08968609865470852,0.9737991266375546,0.0993744164611314,0.8384961024159462
9,57,1,67,0.13636363636363635,0.9850746268656716,0.08446340155011647,0.838961308851302
4,9,2,15,0.3076923076923077,0.8666666666666667,0.12841944550616044,0.9537005378762452
19,66,2,87,0.2235294117647059,0.9770114942528736,0.15676284316673222,0.9565977843079744
2,60,3,65,0.03225806451612903,0.9538461538461539,0.15048068326096462,0.9561355855625139
31,84,28,143,0.26956521739130435,0.8041958041958042,0.15810196914312005,0.9328320916707847
122,467,5,594,0.2071307300509338,0.9915824915824916,0.1808893523476752,0.9360251948638878
0,58,1,59,0.0,0.9830508474576272,0.1680770525398597,0.9373468692667554
22,75,9,106,0.2268041237113402,0.9150943396226415,0.18099712216096028,0.9273496853748939
2,0,0,2,1.0,1.0,0.27989822106205914,0.946397304422513
1,15,1,17,0.0625,0.9411764705882353,0.25689401938138684,0.9412780153275647
11,92,2,105,0.10679611650485436,0.9809523809523809,0.2675423125226334,0.9451503334855972
12,116,22,150,0.09375,0.8533333333333334,0.2424258528953042,0.952169980505244
16,43,4,63,0.2711864406779661,0.9365079365079365,0.25157666869916595,0.9443021869231648
4,25,2,31,0.13793103448275862,0.9354838709677419,0.2712811021967029,0.9375069045674669
1,21,0,22,0.045454545454545456,1.0,0.24788184497250731,0.9492906842851726
28,64,15,107,0.30434782608695654,0.8598130841121495,0.14850296298492968,0.9292639820154796
20,69,2,91,0.2247191011235955,0.978021978021978,0.17167712028830046,0.9345276259345857
28,71,3,102,0.2828282828282828,0.9705882352941176,0.19992310598109467,0.9333021357385072
82,262,37,381,0.23837209302325582,0.9028871391076115,0.22109570006638415,0.9395495942428138
6,77,13,96,0.07228915662650602,0.8645833333333334,0.18726687828575514,0.929889586171789
4,28,1,33,0.125,0.9696969696969697,0.18471585787759184,0.9350843913665942
0,12,2,14,0.0,0.8571428571428571,0.17822235138408535,0.914676228101288
1,7,2,10,0.125,0.8,0.152601233371663,0.9061315017995524
28,185,15,228,0.13145539906103287,0.9342105263157895,0.13927784736272547,0.8998727229843826
33,107,15,155,0.2357142857142857,0.9032258064516129,0.13254727634644017,0.8902495188640247
2,18,4,24,0.1,0.8333333333333334,0.11277983448597506,0.8803132608962708
1,41,80,122,0.023809523809523808,0.3442622950819672,0.10585417265497761,0.8059816840032183
3,37,8,48,0.075,0.8333333333333334,0.09871131551212045,0.7865011645226989
9,154,24,187,0.05521472392638037,0.8716577540106952,0.10659913321588908,0.7885747212181043
10,126,2,138,0.07352941176470588,0.9855072463768116,0.09924619203941851,0.8150757564147918
13,125,3,141,0.09420289855072464,0.9787234042553191,0.09392440625223163,0.8214347389775817
4,97,2,103,0.039603960396039604,0.9805825242718447,0.06590864549248217,0.8324856986661863
45,171,6,222,0.20833333333333334,0.972972972972973,0.08138483596867264,0.8524342186147061
7,71,1,79,0.08974358974358974,0.9873417721518988,0.09080398824496778,0.9443027153389821
2,46,5,53,0.041666666666666664,0.9056603773584906,0.08604208348306301,0.9546351501997189
2,26,8,36,0.07142857142857142,0.7777777777777778,0.08835834741194745,0.9412237250235879
12,142,4,158,0.07792207792207792,0.9746835443037974,0.0889858711487149,0.9396774818703
15,91,25,131,0.14150943396226415,0.8091603053435115,0.09574394763607767,0.9154541820257561
23,81,19,123,0.22115384615384615,0.8455284552845529,0.1216796456014786,0.8961607435990002
13,85,2,100,0.1326530612244898,0.98,0.1108681781573581,0.8971646046028612
7,57,1,65,0.109375,0.9846153846153847,0.11367266533684528,0.8967751206690734
3,112,4,119,0.02608695652173913,0.9663865546218487,0.11144699245899849,0.9054502888495531
11,35,2,48,0.2391304347826087,0.9583333333333334,0.13540440150957525,0.9312439396432038
16,83,1,100,0.16161616161616163,0.99,0.14736069918015862,0.9334320047426614
6,21,1,28,0.2222222222222222,0.9642857142857143,0.15889109750300978,0.9555927774486904
6,63,9,78,0.08695652173913043,0.8846153846153846,0.1397200511580504,0.9611766244959521
14,37,1,52,0.27450980392156865,0.9807692307692307,0.15998530011477596,0.9612865146058421
0,2,59,61,0.0,0.03278688524590164,0.14436030011477596,0.8253110146959161
4,168,9,181,0.023255813953488372,0.9502762430939227,0.14395585117645443,0.823009541620498
16,170,13,199,0.08602150537634409,0.9346733668341709,0.12208314697555946,0.819629546406332
33,100,11,144,0.24812030075187969,0.9236111111111112,0.1344408811378049,0.810145419422205
1,55,7,63,0.017857142857142856,0.8888888888888888,0.10524586979993644,0.7993744443655156
23,183,6,212,0.11165048543689321,0.9716981132075472,0.10877357889961682,0.8118148341643961
1,1,65,67,0.5,0.029850746268656716,0.14098646405367846,0.6759693363785998
4,9,1,14,0.3076923076923077,0.9285714285714286,0.18494250800972242,0.803938556853675
19,48,2,69,0.2835820895522388,0.9710144927536232,0.22213197595240103,0.806901163947918
2,58,3,63,0.03333333333333333,0.9523809523809523,0.2146050942319709,0.8094308190260296
33,77,32,142,0.3,0.7746478873239436,0.22201647983884526,0.7881503584850057
125,454,11,590,0.2158894645941278,0.9813559322033898,0.2503068115155574,0.8013599361013629
0,52,1,53,0.0,0.9811320754716981,0.2343567421674298,0.8027076449962417
19,66,9,94,0.2235294117647059,0.9042553191489362,0.1948609438481021,0.9276225839791387
2,0,0,2,1.0,1.0,0.293762042749201,0.9378266656117917
1,15,1,17,0.0625,0.9411764705882353,0.2621788870988811,0.9335640910167363
7,86,2,95,0.07526881720430108,0.9789473684210527,0.2681696705090194,0.9373592933081792
12,109,21,142,0.09917355371900827,0.852112676056338,0.23948017818316342,0.9484256916985213
17,38,4,59,0.3090909090909091,0.9322033898305084,0.25279467025413216,0.941403899930967
4,24,2,30,0.14285714285714285,0.9333333333333333,0.2732028335194383,0.9345755081969146
1,21,0,22,0.045454545454545456,1.0,0.24235293245465223,0.9494956646149835
28,64,15,107,0.30434782608695654,0.8598130841121495,0.14297405046707462,0.9294689623452905
17,72,2,91,0.19101123595505617,0.978021978021978,0.16133279846065404,0.9347326062643966
26,76,3,105,0.2549019607843137,0.9714285714285714,0.1880386264229069,0.9333720620467096
84,260,37,381,0.2441860465116279,0.9028871391076115,0.20942403464222833,0.9405917971637126
5,79,13,97,0.05952380952380952,0.865979381443299,0.17676520839986695,0.9305162892973357
4,28,1,33,0.125,0.9696969696969697,0.17491791775947288,0.9354038748300825
0,12,2,14,0.0,0.8571428571428571,0.16842441126596638,0.9149957115647764
1,7,2,10,0.125,0.8,0.14280329325354404,0.9064509852630408
28,185,15,228,0.13145539906103287,0.9342105263157895,0.13429531655439783,0.900192206447871
35,104,15,154,0.2517985611510791,0.9025974025974026,0.13385197374965005,0.8903591823291326
2,18,4,24,0.1,0.8333333333333334,0.11325396710513178,0.8804229243613787
1,42,79,122,0.023255813953488372,0.3524590163934426,0.10807282488080018,0.8070628722113992
3,38,8,49,0.07317073170731707,0.8367346938775511,0.10066864369613118,0.7880682613800537
10,156,22,188,0.060240963855421686,0.8829787234042553,0.10927449567547713,0.7917590994173962
11,127,2,140,0.07971014492753623,0.9857142857142858,0.10280451637941089,0.8182897116622943
14,125,3,142,0.10071942446043165,0.9788732394366197,0.09841366286503929,0.8246700992509843
4,98,2,104,0.0392156862745098,0.9807692307692307,0.0680446807398151,0.8358375032755312
45,171,6,222,0.20833333333333334,0.972972972972973,0.08352087121600558,0.8557860232240511
7,71,1,79,0.08974358974358974,0.9873417721518988,0.09301912490030577,0.9464835597609734
2,46,5,53,0.041666666666666664,0.9056603773584906,0.08851854418021286,0.9563300859725361
2,26,8,36,0.07142857142857142,0.7777777777777778,0.09011677383351994,0.9413013794544679
13,141,4,158,0.08441558441558442,0.9746835443037974,0.09078897947466971,0.9397255592529695
16,101,14,131,0.13675213675213677,0.8931297709923665,0.09593650980205615,0.927476492332362
24,82,19,125,0.22641509433962265,0.848,0.12267928238278657,0.9085094593653291
11,87,2,100,0.11224489795918367,0.98,0.10895236304362232,0.90951332036919
6,59,1,66,0.09230769230769231,0.9848484848484849,0.10931866340992269,0.9091571364687023
3,113,4,120,0.02586206896551724,0.9666666666666667,0.10706086373832992,0.9178723206555847
11,34,2,47,0.24444444444444444,0.9574468085106383,0.13177741702631177,0.9435393250459932
16,83,1,100,0.16161616161616163,0.99,0.1428060709121085,0.9457273901454508
5,22,1,28,0.18518518518518517,0.9642857142857143,0.14972507783111544,0.9558925249016433
6,63,10,79,0.08695652173913043,0.8734177215189873,0.12980242460247368,0.9595236279757844
15,37,1,53,0.28846153846153844,0.9811320754716981,0.15497623038852434,0.9596853530431698
0,2,59,61,0.0,0.03278688524590164,0.14178941720171118,0.8236765530999436
5,167,9,181,0.029069767441860465,0.9502762430939227,0.14224765984118878,0.8213350640181231
15,175,12,202,0.07894736842105263,0.9405940594059405,0.11860522040927565,0.8189275284317378
32,100,12,144,0.24242424242424243,0.9166666666666666,0.1301492319532872,0.8084513379555471
1,55,7,63,0.017857142857142856,0.8888888888888888,0.10624522590642402,0.7976803628988579
23,182,6,211,0.11219512195121951,0.9715639810426541,0.10985074022243675,0.8117012571165245
1,1,65,67,0.5,0.029850746268656716,0.14007052044221696,0.6758039243732329
4,9,1,14,0.3076923076923077,0.9285714285714286,0.18402656439826096,0.8037731448483082
19,48,2,69,0.2835820895522388,0.9710144927536232,0.2203854675568864,0.806735751942551
1,59,3,63,0.016666666666666666,0.9523809523809523,0.21148822444911697,0.8084195937961242
33,76,32,141,0.30275229357798167,0.7730496453900709,0.2201065174710797,0.7879028764708963
125,460,5,590,0.21367521367521367,0.9915254237288136,0.248080527587947,0.8025652385908855
0,52,1,53,0.0,0.9811320754716981,0.23205265302348707,0.803932109223606
19,66,9,94,0.2235294117647059,0.9042553191489362,0.19255685470415934,0.9288470482065032
2,0,0,2,1.0,1.0,0.2914579536052582,0.9390511298391563
1,15,1,17,0.0625,0.9411764705882353,0.2598747979549384,0.9347885552441008
8,86,2,96,0.0851063829787234,0.9791666666666666,0.26965190028523217,0.9386150858563457
11,111,20,142,0.09016393442622951,0.8591549295774648,0.23928213469212478,0.9509158407402591
17,38,4,59,0.3090909090909091,0.9322033898305084,0.25291294832293837,0.9424412644690726
4,24,2,30,0.14285714285714285,0.9333333333333333,0.2733211115882445,0.9356128727350205
1,23,0,24,0.041666666666666664,1.0,0.17212281563493528,0.9494956646149835
27,74,16,117,0.26732673267326734,0.8632478632478633,0.13888377744540206,0.9299596450789639
22,86,2,110,0.2037037037037037,0.9818181818181818,0.15905573511735974,0.9357656038260992
23,100,3,126,0.18699186991869918,0.9761904761904762,0.17189923387134862,0.9350853317172556
87,295,37,419,0.22774869109947643,0.9116945107398569,0.1909364484603627,0.9435632627817222
7,85,13,105,0.07608695652173914,0.8761904761904762,0.1630650935809017,0.9349464827363708
4,35,1,40,0.10256410256410256,0.975,0.15801267473537942,0.9405916440266934
0,12,2,14,0.0,0.8571428571428571,0.15206029378299846,0.9201834807613871
0,14,2,16,0.0,0.875,0.11387076054396027,0.9218623574402639
30,223,15,268,0.11857707509881422,0.9440298507462687,0.10170981360040464,0.9164640244299905
34,122,15,171,0.21794871794871795,0.9122807017543859,0.10613222046183589,0.9073340566534062
1,21,4,26,0.045454545454545456,0.8461538461538461,0.08009019965541718,0.8979711045696904
2,39,85,126,0.04878048780487805,0.3253968253968254,0.07618927555300845,0.8192862973134546
4,40,8,52,0.09090909090909091,0.8461538461538461,0.07452427388800678,0.8008797039068611
12,167,25,204,0.0670391061452514,0.8774509803921569,0.08410128905161414,0.803780864371047
11,152,2,165,0.06748466257668712,0.9878787878787879,0.093741955133998,0.819906405496588
12,134,4,150,0.0821917808219178,0.9733333333333334,0.08854405595158422,0.8240926172947401
3,112,2,117,0.02608695652173913,0.9829059829059829,0.06113523289058725,0.8341819431735397
45,171,6,222,0.20833333333333334,0.972972972972973,0.08440363115898553,0.8522989612905577
10,90,1,101,0.1,0.9900990099009901,0.09172070432971723,0.9472564162197241
4,52,5,61,0.07142857142857142,0.9180327868852459,0.08893777297535731,0.9575248363242099
2,28,9,39,0.06666666666666667,0.7692307692307693,0.08888456733555948,0.9420648061582974
16,143,4,163,0.10062893081761007,0.9754601226993865,0.09361946279854848,0.9402907111326686
14,112,14,140,0.1111111111111111,0.9,0.09775079569700466,0.9298145206564782
25,95,20,140,0.20833333333333334,0.8571428571428571,0.12378599238437525,0.9118483598331745
12,94,2,108,0.11320754716981132,0.9814814814814815,0.11019659436101499,0.9130638610486758
6,59,2,67,0.09230769230769231,0.9701492537313433,0.10909769326211387,0.9102138958815832
4,124,4,132,0.03125,0.9696969696969697,0.10335789734374654,0.9175944934261152
12,36,2,50,0.25,0.96,0.12954837353422272,0.9448472406788625
15,85,1,101,0.15,0.9900990099009901,0.13660138341742128,0.9469385102790915
5,24,1,30,0.1724137931034483,0.9666666666666667,0.1453589094163266,0.956462319802901
10,78,8,96,0.11363636363636363,0.9166666666666666,0.13183077088818806,0.9649657211634454
15,39,1,55,0.2777777777777778,0.9818181818181818,0.15534080383218327,0.9650138212115452
0,4,59,63,0.0,0.06349206349206349,0.1421539906453701,0.8354913654630768
4,195,9,208,0.020100502512562814,0.9567307692307693,0.14056120529002192,0.8336390511107625
17,204,12,233,0.07692307692307693,0.9484978540772532,0.11583593056474718,0.831995887407513
32,107,12,151,0.2302158273381295,0.9205298013245033,0.12729533447019425,0.8220574290394433
4,54,7,65,0.06896551724137931,0.8923076923076924,0.11251700934704155,0.8114347184167328
22,201,6,229,0.09865470852017937,0.9737991266375546,0.11037677290187238,0.8195964984125739
1,0,66,67,1.0,0.014925373134328358,0.21355137607647554,0.6814689543148805
4,9,1,14,0.3076923076923077,0.9285714285714286,0.2575074200325195,0.8050517207547898
21,64,2,87,0.24705882352941178,0.9770114942528736,0.28993003732064077,0.807948967186519
1,61,3,65,0.016129032258064516,0.9538461538461539,0.28124517379706754,0.8087130100106477
29,81,33,143,0.2636363636363636,0.7692307692307693,0.2860195361253867,0.7870988625686858
129,460,5,594,0.21901528013582344,0.9915824915824916,0.30745521653887875,0.8012809767507998
0,58,1,59,0.0,0.9830508474576272,0.2933616867502817,0.8026026511536674
19,78,9,106,0.1958762886597938,0.9150943396226415,0.17848687084453796,0.931198217794855
2,0,0,2,1.0,1.0,0.27738796974563684,0.941402299427508
1,15,1,17,0.0625,0.9411764705882353,0.2510224235271495,0.9362830103325598
7,96,2,105,0.06796116504854369,0.9809523809523809,0.2584270139257893,0.9401553284905921
12,115,22,149,0.09448818897637795,0.8523489932885906,0.23426298897436282,0.9520293604988523
17,42,4,63,0.288135593220339,0.9365079365079365,0.2441373194150079,0.9441615669167731
4,25,2,31,0.13793103448275862,0.9354838709677419,0.26384175291254486,0.9373662845610752
1,23,0,24,0.041666666666666664,1.0,0.24178807782000195,0.9504544373858368
27,74,16,117,0.26732673267326734,0.8632478632478633,0.1371204682018973,0.9309184178498173
21,87,2,110,0.19444444444444445,0.9818181818181818,0.15596967455110364,0.9367243765969525
24,99,3,126,0.1951219512195122,0.9761904761904762,0.17274853859494518,0.9360441044881089
87,295,37,419,0.22774869109947643,0.9116945107398569,0.19077513732344184,0.9435632627817222
6,86,13,105,0.06521739130434782,0.8761904761904762,0.16135098741292492,0.9349464827363708
4,35,1,40,0.10256410256410256,0.975,0.15629856856740262,0.9405916440266934
0,12,2,14,0.0,0.8571428571428571,0.15034618761502166,0.9201834807613872
0,14,2,16,0.0,0.875,0.11215665437598347,0.9218623574402639
30,223,15,268,0.11857707509881422,0.9440298507462687,0.10131845875517917,0.9164640244299906
35,121,15,171,0.22435897435897437,0.9122807017543859,0.1054951763465309,0.9073340566534062
1,21,4,26,0.045454545454545456,0.8461538461538461,0.0794531555401122,0.8979711045696905
2,42,82,126,0.045454545454545456,0.3492063492063492,0.07662989184728329,0.8226876578576723
4,40,8,52,0.09090909090909091,0.8461538461538461,0.07496489018228161,0.8042810644510789
13,166,25,204,0.07262569832402235,0.8774509803921569,0.08533998994285623,0.8071822249152645
11,152,2,165,0.06748466257668712,0.9878787878787879,0.0949806560252401,0.8233077660408057
15,131,4,150,0.10273972602739725,0.9733333333333334,0.09271817758646626,0.8274939778389577
4,111,2,117,0.034782608695652174,0.9829059829059829,0.06563583963456308,0.8375833037177574
45,171,6,222,0.20833333333333334,0.972972972972973,0.08890423790296136,0.8557003218347755
10,90,1,101,0.1,0.9900990099009901,0.09669644569516915,0.9472564162197242
4,52,5,61,0.07142857142857142,0.9180327868852459,0.09391351434080922,0.9575248363242098
1,29,9,39,0.03333333333333333,0.7692307692307693,0.08830031934213936,0.9420648061582975
16,143,4,163,0.10062893081761007,0.9754601226993865,0.09303521480512836,0.9402907111326685
14,112,14,140,0.1111111111111111,0.9,0.09423112695994462,0.9298145206564782
25,96,19,140,0.2066115702479339,0.8642857142857143,0.11877812146741343,0.9128687679964399
12,94,2,108,0.11320754716981132,0.9814814814814815,0.10518872344405314,0.9140842692119409
7,58,2,67,0.1076923076923077,0.9701492537313433,0.10628762454295425,0.9112343040448486
2,125,5,132,0.015748031496062992,0.9621212121212122,0.09833326169545305,0.9175326505071295
12,37,1,50,0.24489795918367346,0.98,0.12855677967407306,0.9476425406170197
16,84,1,101,0.16,0.9900990099009901,0.13703836098584304,0.9497338102172487
5,24,1,30,0.1724137931034483,0.9666666666666667,0.14579588698474838,0.9592576197410582
8,80,8,96,0.09090909090909091,0.9166666666666666,0.12926696136491364,0.9667406129383371
17,37,1,55,0.3148148148148148,0.9818181818181818,0.15806799959991416,0.9667887129864371
0,4,59,63,0.0,0.06349206349206349,0.14268338421529878,0.8372662572379685
4,195,9,208,0.020100502512562814,0.9567307692307693,0.14330516578908448,0.8364961939679053
17,204,12,233,0.07692307692307693,0.9484978540772532,0.11930875403757067,0.831995887407513
30,108,13,151,0.21739130434782608,0.9139072847682119,0.12750751180154582,0.8211113552456873
3,55,7,65,0.05172413793103448,0.8923076923076924,0.110266132491201,0.8104886446229769
23,200,6,229,0.1031390134529148,0.9737991266375546,0.11201326428317583,0.818650424618818
1,0,66,67,1.0,0.014925373134328358,0.2098968621667737,0.6805228805211246
4,9,1,14,0.3076923076923077,0.9285714285714286,0.2538529061228177,0.8041056469610339
21,64,2,87,0.24705882352941178,0.9770114942528736,0.2862755234109389,0.8070028933927631
1,61,3,65,0.016129032258064516,0.9538461538461539,0.27759065988736575,0.8077669362168918
30,81,32,143,0.2702702702702703,0.7762237762237763,0.2851447978762863,0.7880978635676866
125,464,5,594,0.21222410865874364,0.9915824915824916,0.3080733651231019,0.8022799777498008
0,58,1,59,0.0,0.9830508474576272,0.2933392203441141,0.8036016521526683
20,77,9,106,0.20618556701030927,0.9150943396226415,0.179937158488444,0.932197218793856
1,1,0,2,0.5,1.0,0.20740968596097148,0.9424013004265089
1,15,1,17,0.0625,0.9411764705882353,0.18104413974248407,0.9372820113315606
10,93,2,105,0.0970873786407767,0.9809523809523809,0.19260961779715724,0.9411543294895931
12,115,22,149,0.09448818897637795,0.8523489932885906,0.16749789189802974,0.9520293604988523
16,43,4,63,0.2711864406779661,0.9365079365079365,0.1759210821864901,0.944161566916773
4,25,2,31,0.13793103448275862,0.9354838709677419,0.19562551568402706,0.9373662845610752
2,22,0,24,0.08333333333333333,1.0,0.24801134989582257,0.9504544373858368
27,76,14,117,0.2621359223300971,0.8803418803418803,0.14260219594297932,0.9333604202918198
22,86,2,110,0.2037037037037037,0.9818181818181818,0.16277415361493697,0.939166379038955
25,98,3,126,0.2032520325203252,0.9761904761904762,0.17932749529259787,0.9384861069301114
84,296,39,419,0.22105263157894736,0.9069212410501193,0.19751358551816178,0.9453233695537622
6,86,13,105,0.06521739130434782,0.8761904761904762,0.16808943560764483,0.9367065895084108
4,35,1,40,0.10256410256410256,0.975,0.1630370167621226,0.9423517507987332
0,12,2,14,0.0,0.8571428571428571,0.15113225485736065,0.9219435875334271
0,14,2,16,0.0,0.875,0.1136842659530611,0.9211804617703014
30,224,15,269,0.11811023622047244,0.9442379182156134,0.10145662774117091,0.9158118526842202
37,119,15,171,0.23717948717948717,0.9122807017543859,0.10630340697819404,0.9066818849076358
2,20,4,26,0.09090909090909091,0.8461538461538461,0.08771147259678598,0.8980008284938826
2,42,82,126,0.045454545454545456,0.3492063492063492,0.08488820890395708,0.8227173817818645
4,40,8,52,0.09090909090909091,0.8461538461538461,0.0832232072389554,0.804310788375271
10,171,23,204,0.055248618784530384,0.8872549019607843,0.09111586706531691,0.8086125090635463
11,152,2,165,0.06748466257668712,0.9878787878787879,0.10075653314770076,0.8247380501890875
14,132,4,150,0.0958904109589041,0.9733333333333334,0.09758227239604815,0.8288945380630474
4,111,2,117,0.034782608695652174,0.9829059829059829,0.06866843261264315,0.838983863941847
46,170,6,222,0.21296296296296297,0.972972972972973,0.08610470004891058,0.8571008820588651
10,90,1,101,0.1,0.9900990099009901,0.09389690784111838,0.9486569764438139
2,54,5,61,0.03571428571428571,0.9180327868852459,0.08601193567043193,0.9589253965482994
2,28,9,39,0.06666666666666667,0.7692307692307693,0.08764308536787997,0.9420648061582975
17,142,4,163,0.1069182389937107,0.9754601226993865,0.09327645342745475,0.9402907111326685
14,112,14,140,0.1111111111111111,0.9,0.09545083916348433,0.9298145206564782
27,94,19,140,0.2231404958677686,0.8642857142857143,0.12235910875950097,0.9128687679964399
12,94,2,108,0.11320754716981132,0.9814814814814815,0.10810833507476501,0.9140842692119409
6,60,1,67,0.09090909090909091,0.9850746268656716,0.10680963377606371,0.9133665002068955
3,125,4,132,0.0234375,0.9696969696969697,0.10505580724545147,0.9207470977514275
12,37,1,50,0.24489795918367346,0.98,0.13051742046216672,0.9508569878613174
16,84,1,101,0.16,0.9900990099009901,0.1381005291773509,0.9529482574615467
4,25,1,30,0.13793103448275862,0.9666666666666667,0.141931946801872,0.9624720669853561
8,79,9,96,0.09195402298850575,0.90625,0.12319102210483444,0.9684669649445399
17,37,1,55,0.3148148148148148,0.9818181818181818,0.15199206033983495,0.9685150649926398
0,4,59,63,0.0,0.06349206349206349,0.13900504735282196,0.8368604130821244
4,191,13,208,0.020512820512820513,0.9375,0.1385872359975106,0.8322608459825573
17,204,13,234,0.07692307692307693,0.9444444444444444,0.1145908242459968,0.8271814809031922
31,107,13,151,0.2246376811594203,0.9139072847682119,0.12382477869734256,0.8162969487413667
3,55,7,65,0.05172413793103448,0.8923076923076924,0.11150950776138198,0.8056742381186561
24,199,6,229,0.10762331838565023,0.9737991266375546,0.11374797853240261,0.8153241133525925
1,0,66,67,1.0,0.014925373134328358,0.21163157641600047,0.6771965692548992
4,8,1,13,0.3333333333333333,0.9230769230769231,0.2592506240350481,0.7999944063384506
21,64,2,87,0.24705882352941178,0.9770114942528736,0.291614338751704,0.8056389055174326
2,60,3,65,0.03225806451612903,0.9538461538461539,0.28523362269356856,0.8069820068605339
31,78,34,143,0.28440366972477066,0.7622377622377622,0.2937716210600472,0.7853149322133268
122,467,5,594,0.2071307300509338,0.9915824915824916,0.31597256279146135,0.799497046395441
0,58,1,59,0.0,0.9830508474576272,0.3005978030220828,0.8008187207983085
19,78,9,106,0.1958762886597938,0.9150943396226415,0.18572298711633903,0.929414287439496
2,0,0,2,1.0,1.0,0.2809610823544343,0.9404032984285069
1,15,1,17,0.0625,0.9411764705882353,0.2545955361359469,0.9352840093335587
8,95,2,105,0.07766990291262135,0.9809523809523809,0.2610829416211601,0.9391563274915911
13,115,21,149,0.1015625,0.8590604026845637,0.23496277451762143,0.9529881332697057
16,43,4,63,0.2711864406779661,0.9365079365079365,0.24411359032148314,0.9451203396876263
4,25,2,31,0.13793103448275862,0.9354838709677419,0.2638180238190201,0.9383250573319284
1,23,0,24,0.041666666666666664,1.0,0.24067200639143052,0.9504544373858368
28,74,15,117,0.27450980392156865,0.8717948717948718,0.1370305498087975,0.9321394190708184
18,90,2,110,0.16666666666666666,0.9818181818181818,0.1519115021897499,0.9379453778179536
27,96,3,126,0.21951219512195122,0.9761904761904762,0.17217468679108272,0.93726510570911
84,296,39,419,0.22105263157894736,0.9069212410501193,0.19036077701664664,0.944102368332761
6,86,13,105,0.06521739130434782,0.8761904761904762,0.16093662710612971,0.9354855882874095
4,35,1,40,0.10256410256410256,0.975,0.15588420826060742,0.941130749577732
0,12,2,14,0.0,0.8571428571428571,0.14993182730822646,0.920722586312426
1,13,2,16,0.07142857142857142,0.875,0.12092022266636972,0.9211804617703014
28,226,15,269,0.11023622047244094,0.9442379182156134,0.11285873035290891,0.9158118526842202
36,121,14,171,0.22929936305732485,0.9181286549707602,0.11425689720081943,0.9075173067956894
2,20,4,26,0.09090909090909091,0.8461538461538461,0.09566496281941136,0.898836250381936
1,41,84,126,0.023809523809523808,0.3333333333333333,0.08974955317729363,0.8212852299737727
3,41,8,52,0.06818181818181818,0.8461538461538461,0.08483779826553874,0.8028786365671794
12,169,23,204,0.06629834254143646,0.8872549019607843,0.09430899005717251,0.8071803572554546
12,151,2,165,0.0736196319018405,0.9878787878787879,0.09462199869621095,0.8233058983809958
15,131,4,150,0.10273972602739725,0.9733333333333334,0.09355107091834756,0.8274623862549558
4,111,2,117,0.034782608695652174,0.9829059829059829,0.06576296315239433,0.8367162902457019
46,170,6,222,0.21296296296296297,0.972972972972973,0.08319923058866177,0.8548333083627201
10,90,1,101,0.1,0.9900990099009901,0.09408358433015837,0.9486569764438139
2,54,5,61,0.03571428571428571,0.9180327868852459,0.08944536540622516,0.9589253965482996
2,28,9,39,0.06666666666666667,0.7692307692307693,0.08949798313840089,0.9420648061582975
13,146,4,163,0.08176100628930817,0.9754601226993865,0.09066103662232484,0.9402907111326686
14,112,14,140,0.1111111111111111,0.9,0.09185694877714112,0.9298145206564781
27,94,19,140,0.2231404958677686,0.8642857142857143,0.11876521837315776,0.9128687679964397
11,95,2,108,0.10377358490566038,0.9814814814814815,0.10316673579354309,0.9140842692119409
7,59,1,67,0.10606060606060606,0.9850746268656716,0.10403253665934396,0.9133665002068955
4,124,4,132,0.03125,0.9696969696969697,0.10339478155730315,0.9207470977514275
11,38,1,50,0.22448979591836735,0.98,0.12594094287897467,0.9508569878613174
16,84,1,101,0.16,0.9900990099009901,0.13711794198050206,0.9529482574615465
4,25,1,30,0.13793103448275862,0.9666666666666667,0.14094935960502314,0.9624720669853561
8,80,8,96,0.09090909090909091,0.9166666666666666,0.12205915889664062,0.9699550601826351
16,38,1,55,0.2962962962962963,0.9818181818181818,0.14956240338101717,0.9700031602307352
0,3,59,62,0.0,0.04838709677419355,0.13441088822950203,0.8361906559319525
5,190,13,208,0.02564102564102564,0.9375,0.13360960617821996,0.8315910888323853
17,205,12,234,0.07657657657657657,0.9487179487179487,0.11247914627224985,0.8271222243635209
30,110,11,151,0.21428571428571427,0.9271523178807947,0.12023424831306619,0.8181298397892073
3,55,7,65,0.05172413793103448,0.8923076923076924,0.10791897737710558,0.8075071291664967
25,198,6,229,0.11210762331838565,0.9737991266375546,0.11094733914986199,0.8156689091623378
1,1,65,67,0.5,0.029850746268656716,0.1400478682503911,0.6796735612266913
4,9,1,14,0.3076923076923077,0.9285714285714286,0.18400391220643503,0.8054141800548678
21,64,2,87,0.24705882352941178,0.9770114942528736,0.21563502619049021,0.8110586792338497
1,61,3,65,0.016129032258064516,0.9538461538461539,0.20699966271641704,0.8117912799664505
30,81,32,143,0.2702702702702703,0.7762237762237763,0.2149974564284965,0.7902300597297336
123,466,5,594,0.20882852292020374,0.9915824915824916,0.23744093999837781,0.8044121739118477
0,58,1,59,0.0,0.9830508474576272,0.2214255652386084,0.8057338483147153
20,77,9,106,0.20618556701030927,0.9150943396226415,0.17945207481150977,0.9321972187938561
2,0,0,2,1.0,1.0,0.27835317371260865,0.942401300426509
1,15,1,17,0.0625,0.9411764705882353,0.25198762749412124,0.9372820113315606
9,94,2,105,0.08737864077669903,0.9809523809523809,0.2621661429967833,0.9411543294895931
12,116,21,149,0.09375,0.8590604026845637,0.23694896152960185,0.9529881332697057
16,43,4,63,0.2711864406779661,0.9365079365079365,0.24585723549499647,0.9451203396876263
4,25,2,31,0.13793103448275862,0.9354838709677419,0.2655616689925334,0.9383250573319284
1,23,0,24,0.041666666666666664,1.0,0.24138599398206534,0.9478622187693955
30,77,10,117,0.2803738317757009,0.9145299145299145,0.13858225566430832,0.9356522065593832
19,88,2,109,0.17757009345794392,0.981651376146789,0.1550208404440146,0.9414343359248909
26,96,3,125,0.21311475409836064,0.976,0.17164092052258223,0.941013283293312
86,299,34,419,0.22337662337662337,0.918854415274463,0.19045662862400464,0.9515538536846336
6,86,13,105,0.06521739130434782,0.8761904761904762,0.16345378621954104,0.9429370736392821
4,35,1,40,0.10256410256410256,0.975,0.15769763760624955,0.9488894545916631
0,13,1,14,0.0,0.9285714285714286,0.1517452566538686,0.93868537295901
1,14,1,16,0.06666666666666667,0.9375,0.12121566163829225,0.9419668137404508
29,225,15,269,0.1141732283464567,0.9442379182156134,0.1121589666223655,0.9366220340359972
36,120,15,171,0.23076923076923078,0.9122807017543859,0.11468103471820412,0.9275192771437666
2,24,0,26,0.07692307692307693,1.0,0.09375909951055461,0.9391115035331291
2,70,54,126,0.027777777777777776,0.5714285714285714,0.08841058329247319,0.8955740885671427
4,46,1,51,0.08,0.9803921568627451,0.08518714006902997,0.8963443966903919
11,169,23,203,0.06111111111111111,0.8866995073891626,0.09391729879918871,0.8903626936643539
11,152,2,165,0.06748466257668712,0.9878787878787879,0.09403415535776304,0.8975596633613236
15,131,4,150,0.10273972602739725,0.9733333333333334,0.09240079788361169,0.9017161512352836
4,111,2,117,0.034782608695652174,0.9829059829059829,0.06440270901595761,0.9118054771140833
46,170,6,222,0.21296296296296297,0.972972972972973,0.08383697845022704,0.9079444732530793
9,91,1,101,0.09,0.9900990099009901,0.09272586733911593,0.9677545358919962
2,58,1,61,0.03333333333333333,0.9836065573770492,0.08605920067244928,0.9682137359654683
1,29,9,39,0.03333333333333333,0.7692307692307693,0.0820909467041953,0.9514324876571265
4,155,4,163,0.025157232704402517,0.9754601226993865,0.07604417100815464,0.9496583926314976
14,102,24,140,0.1206896551724138,0.8285714285714286,0.07860844660029986,0.928978120522654
26,96,18,140,0.21311475409836064,0.8714285714285714,0.10408446737211534,0.913052776025881
12,94,2,108,0.11320754716981132,0.9814814814814815,0.0898336936873794,0.9142682772413823
6,59,1,66,0.09230769230769231,0.9848484848484849,0.09016336401704973,0.9135182022338816
4,124,4,132,0.03125,0.9696969696969697,0.08986574496943067,0.9115311182795844
12,37,1,50,0.24489795918367346,0.98,0.1200892629480507,0.9416410083894745
16,84,1,101,0.16,0.9900990099009901,0.13935251541885035,0.9437322779897036
5,24,1,30,0.1724137931034483,0.9666666666666667,0.1467416779804267,0.9634601691461662
8,83,5,96,0.08791208791208792,0.9479166666666666,0.12885558281095918,0.9743870398944656
16,38,1,55,0.2962962962962963,0.9818181818181818,0.15501111840045703,0.9744351399425656
0,3,59,62,0.0,0.04838709677419355,0.14182430521364384,0.8406549416462382
5,190,13,208,0.02564102564102564,0.9375,0.14102302316236176,0.836055374546671
17,206,11,234,0.07623318385650224,0.9529914529914529,0.11692805525848017,0.8321970106883072
31,117,3,151,0.20945945945945946,0.9801324503311258,0.12399369232411724,0.830773216464041
5,58,2,65,0.07936507936507936,0.9692307692307692,0.11070101893292168,0.8311395168303414
19,204,6,229,0.08520179372197309,0.9737991266375546,0.11031383404861957,0.8348370111118967
9,57,1,67,0.13636363636363635,0.9850746268656716,0.08746631120109671,0.8353022175472524
4,9,1,14,0.3076923076923077,0.9285714285714286,0.13142235515714068,0.9610428363754288
20,65,2,87,0.23529411764705882,0.9770114942528736,0.16137279687228825,0.9666873355544109
2,60,3,65,0.03225806451612903,0.9538461538461539,0.15509063696652065,0.966809435676511
33,82,28,143,0.28695652173913044,0.8041958041958042,0.16616164586361654,0.9416756290857506
121,468,5,594,0.20543293718166383,0.9915824915824916,0.18417133983741432,0.9448687322788538
0,58,1,59,0.0,0.9830508474576272,0.1719996550199896,0.9461904066817214
19,78,9,106,0.1958762886597938,0.9150943396226415,0.1805014624908692,0.93619322278986
2,0,0,2,1.0,1.0,0.2794025613919681,0.946397304422513
1,15,1,17,0.0625,0.9411764705882353,0.25471768744238826,0.9412780153275647
8,95,2,105,0.07766990291262135,0.9809523809523809,0.26120509292760147,0.9451503334855972
12,116,21,149,0.09375,0.8590604026845637,0.23360416125058286,0.9529881332697057
16,43,4,63,0.2711864406779661,0.9365079365079365,0.24299751889291174,0.9451203396876264
4,25,2,31,0.13793103448275862,0.9354838709677419,0.2627019523904487,0.9383250573319284
1,21,0,22,0.045454545454545456,1.0,0.2421743551809837,0.9488682549866992
28,72,15,115,0.28,0.8695652173913043,0.13931721232384087,0.9302347146140285
14,78,2,94,0.15217391304347827,0.9787234042553191,0.15212777133005204,0.9355985622807548
28,78,3,109,0.2641509433962264,0.9724770642201835,0.17450263728373724,0.9346742331092018
80,264,34,378,0.23255813953488372,0.91005291005291,0.1959188532031244,0.9429514093944266
5,80,13,98,0.058823529411764705,0.8673469387755102,0.1680026019568632,0.9330712668612229
4,28,1,33,0.125,0.9696969696969697,0.16545158154869993,0.9382660720560281
0,12,2,14,0.0,0.8571428571428571,0.1589580750551934,0.9178579087907218
0,9,2,11,0.0,0.8181818181818182,0.11895807505519342,0.9105174231893667
26,199,15,240,0.11555555555555555,0.9375,0.1137268811283473,0.9046283654386069
36,106,15,157,0.2535211267605634,0.9044585987261147,0.11220833589468117,0.8949114417965971
2,18,4,24,0.1,0.8333333333333334,0.09327145881826922,0.8839515022652289
2,44,77,123,0.043478260869565216,0.37398373983739835,0.091079277597955,0.81347104527407
3,38,8,49,0.07317073170731707,0.8367346938775511,0.08367509641328601,0.7944764344427245
11,156,22,189,0.0658682634730539,0.8835978835978836,0.093084848338008,0.7982557239362997
11,124,2,137,0.08148148148148149,0.9854014598540146,0.10472505997821964,0.822144244175185
14,126,4,144,0.1,0.9722222222222222,0.10250283775599743,0.8271045616355025
3,101,2,106,0.028846153846153848,0.9811320754716981,0.07040641305393892,0.8380579154563
46,170,6,222,0.21296296296296297,0.972972972972973,0.08654397919150505,0.85800643540482
6,76,1,83,0.07317073170731707,0.9879518072289156,0.09078576073975532,0.9457161593178939
2,47,5,54,0.04081632653061224,0.9074074074074074,0.08616370285736892,0.9558122612507305
2,27,8,37,0.06896551724137931,0.7837837837837838,0.0866061676814154,0.9415531041344306
4,150,4,158,0.025974025974025976,0.9746835443037974,0.07867653118035033,0.9400219733415424
15,102,14,131,0.1282051282051282,0.8931297709923665,0.08270583520965435,0.9287230517372773
24,81,20,125,0.22857142857142856,0.84,0.11123801731326502,0.9085613266698919
12,87,2,101,0.12121212121212122,0.9801980198019802,0.09813075420600192,0.9095934762168929
6,58,1,65,0.09375,0.9846153846153847,0.1010706496763852,0.90911684441496
4,112,4,120,0.034482758620689655,0.9666666666666667,0.10016585426068199,0.9175824528805683
10,36,1,47,0.21739130434782608,0.9787234042553191,0.12136953813303152,0.9454309700907876
16,83,1,100,0.16161616161616163,0.99,0.14074698608190803,0.9476190351902452
5,23,1,29,0.17857142857142858,0.9655172413793104,0.14794217184852237,0.95796010238838
6,67,8,81,0.0821917808219178,0.9012345679012346,0.12703079359859223,0.966707897802842
15,37,1,53,0.28846153846153844,0.9811320754716981,0.15092356749136618,0.9668413343270874
0,2,59,61,0.0,0.03278688524590164,0.13753071034850903,0.8308658344171613
5,161,13,179,0.030120481927710843,0.9273743016759777,0.13690752796379774,0.8252526394184916
17,175,11,203,0.08854166666666667,0.9458128078817734,0.11850043686648926,0.8205511256508421
29,100,13,142,0.2248062015503876,0.9084507042253521,0.12752758542852155,0.8089012262544638
2,55,7,64,0.03508771929824561,0.890625,0.10702991267520968,0.798202334628848
24,185,6,215,0.11483253588516747,0.9720930232558139,0.11169287768424536,0.8083249711080738
1,2,64,67,0.3333333333333333,0.04477611940298507,0.11810313409450177,0.6745598345268291
4,9,1,14,0.3076923076923077,0.9285714285714286,0.16205917805054573,0.8025290550019043
20,55,2,77,0.26666666666666666,0.974025974025974,0.19585149015611084,0.8091935796233323
2,59,3,64,0.03278688524590164,0.953125,0.18788652138171583,0.8102381784973647
33,76,32,141,0.30275229357798167,0.7730496453900709,0.19902167738565785,0.7908951700923245
121,466,5,592,0.2061328790459966,0.9915540540540541,0.2234567002067651,0.8053136063857609
0,53,1,54,0.0,0.9814814814814815,0.20705205222316977,0.8066548147037133
20,71,9,100,0.21978021978021978,0.91,0.19083017885843928,0.9302582262175726
2,0,0,2,1.0,1.0,0.28973127775953816,0.9404623078502257
1,15,1,17,0.0625,0.9411764705882353,0.26056461109287155,0.9357695216448344
9,84,2,95,0.0967741935483871,0.9789473684210527,0.26970565513608374,0.9394584314192704
11,109,22,142,0.09166666666666666,0.8450704225352113,0.23955056557732446,0.9497471138685764
15,44,4,63,0.2542372881355932,0.9365079365079365,0.24642262401869539,0.9418833827905594
4,24,2,30,0.14285714285714285,0.9333333333333333,0.2668307872840015,0.9350050759122526
1,21,0,22,0.045454545454545456,1.0,0.24405163423397455,0.9455195411497932
29,71,14,114,0.29,0.8771929824561403,0.14262306280540313,0.9279756815006702
18,74,2,94,0.1956521739130435,0.9787234042553191,0.1616448019358379,0.9333395291673965
28,80,3,111,0.25925925925925924,0.972972972972973,0.1889731011087973,0.9321996137417667
80,264,35,379,0.23255813953488372,0.9076517150395779,0.20890665592607305,0.9390070016045637
6,79,13,98,0.07058823529411765,0.8673469387755102,0.1826710769487194,0.92912685907136
4,28,1,33,0.125,0.9696969696969697,0.17407319335083576,0.9390835690280699
0,12,2,14,0.0,0.8571428571428571,0.1675796868573293,0.9186754057627636
0,9,2,11,0.0,0.8181818181818182,0.12615111542875784,0.9102452394378605
29,195,15,239,0.12946428571428573,0.9372384937238494,0.11669570282893531,0.9043188236476506
36,108,15,159,0.25,0.9056603773584906,0.115372951506184,0.8947027385598675
2,18,4,24,0.1,0.8333333333333334,0.09643607442977205,0.8840858268875468
1,46,76,123,0.02127659574468085,0.3821138211382114,0.0893915544941382,0.8147668100822184
3,38,8,49,0.07317073170731707,0.8367346938775511,0.08198737330946923,0.795772199250873
11,156,22,189,0.0658682634730539,0.8835978835978836,0.09139712523419119,0.7995514887444483
9,125,2,136,0.06716417910447761,0.9852941176470589,0.10099200796340228,0.8234246743823397
13,127,4,144,0.09285714285714286,0.9722222222222222,0.0957624161266676,0.8284223498821071
4,100,2,106,0.038461538461538464,0.9811320754716981,0.06554263590688737,0.8392040210411368
46,170,6,222,0.21296296296296297,0.972972972972973,0.08168020204445352,0.8591525409896568
6,76,1,83,0.07317073170731707,0.9879518072289156,0.08909365003911583,0.9457008247169003
2,47,5,54,0.04081632653061224,0.9074074074074074,0.08447159215672942,0.9557969266497368
3,26,8,37,0.10344827586206896,0.7837837837837838,0.08984016535516015,0.9415377695334369
3,151,4,158,0.01948051948051948,0.9746835443037974,0.08302821398030899,0.9400219733415424
15,102,14,131,0.1282051282051282,0.8931297709923665,0.08807792617287832,0.9287230517372772
24,81,20,125,0.22857142857142856,0.84,0.11523648190286262,0.9085613266698918
12,87,2,101,0.12121212121212122,0.9801980198019802,0.10212921879559951,0.9095934762168928
6,58,1,65,0.09375,0.9846153846153847,0.10506911426598278,0.9091168444149599
4,112,4,120,0.034482758620689655,0.9666666666666667,0.10416431885027957,0.9175824528805683
9,37,1,47,0.1956521739130435,0.9787234042553191,0.11733630428613306,0.9454309700907876
16,83,1,100,0.16161616161616163,0.99,0.13764139601979625,0.9476190351902452
5,23,1,29,0.17857142857142858,0.9655172413793104,0.14483658178641057,0.9579601023883801
7,64,10,81,0.09859154929577464,0.8765432098765432,0.1262680276041743,0.963180560942172
15,37,1,53,0.28846153846153844,0.9811320754716981,0.1501608014969482,0.9633139974664173
0,2,59,61,0.0,0.03278688524590164,0.13676794435409104,0.8273384975564912
5,163,13,181,0.02976190476190476,0.9281767955801105,0.1360935366599789,0.8218399445441261
17,175,11,203,0.08854166666666667,0.9458128078817734,0.12079203562478223,0.8171384307764766
31,98,12,141,0.24031007751937986,0.9148936170212766,0.13203402361095626,0.8064089474938018
2,55,7,64,0.03508771929824561,0.890625,0.11153635085764439,0.795710055868186
27,182,6,215,0.1291866028708134,0.9720930232558139,0.11590707279693566,0.8093600292080819
1,1,65,67,0.5,0.029850746268656716,0.14612685301671588,0.6734626964647903
3,10,1,14,0.23076923076923078,0.9285714285714286,0.17909388598374884,0.8014319169398655
20,55,2,77,0.26666666666666666,0.974025974025974,0.21293742339871485,0.807981799574989
2,59,3,64,0.03278688524590164,0.953125,0.20497245462431984,0.8090263984490212
31,77,33,141,0.28703703703703703,0.7659574468085106,0.21164773455541372,0.7877498027043405
126,461,5,592,0.21465076660988075,0.9915540540540541,0.23729959845707585,0.8021682389977768
0,53,1,54,0.0,0.9814814814814815,0.2188443694755311,0.8035094473157293
21,70,9,100,0.23076923076923078,0.91,0.18038283101399263,0.9292450549916355
2,0,0,2,1.0,1.0,0.29027294090410255,0.9394491366242885
1,15,1,17,0.0625,0.9411764705882353,0.2611062742374359,0.9347563504188974
10,83,2,95,0.10752688172043011,0.9789473684210527,0.2717834165909399,0.9384452601933334
10,111,21,142,0.08264462809917356,0.852112676056338,0.24258450102838802,0.9507531500858801
15,44,4,63,0.2542372881355932,0.9365079365079365,0.24823971838920408,0.9428894190078633
4,24,2,30,0.14285714285714285,0.9333333333333333,0.2686478816545102,0.9360111121295563
1,23,0,24,0.041666666666666664,1.0,0.24881655330402075,0.9505886655737562
28,75,14,117,0.27184466019417475,0.8803418803418803,0.14479436190318856,0.9334946484797391
18,90,2,110,0.16666666666666666,0.9818181818181818,0.15967531428414095,0.9393006072268744
28,95,3,126,0.22764227642276422,0.9761904761904762,0.1810999390713042,0.9386203351180308
86,296,36,418,0.225130890052356,0.9138755980861244,0.19665019911200624,0.9463168491303343
6,86,13,105,0.06521739130434782,0.8761904761904762,0.16722604920148934,0.9377000690849828
4,35,1,40,0.10256410256410256,0.975,0.1572475219815828,0.9433452303753054
0,12,2,14,0.0,0.8571428571428571,0.15129514102920183,0.9229370671099993
1,13,2,16,0.07142857142857142,0.875,0.12266427120554424,0.9221739413468736
30,222,15,267,0.11904761904761904,0.9438202247191011,0.11586155011710884,0.9167456617612906
34,121,15,170,0.21935483870967742,0.9117647058823529,0.11467763044381075,0.9075419802887016
1,21,4,26,0.045454545454545456,0.8461538461538461,0.0890095812155521,0.8978674442983762
2,39,85,126,0.04878048780487805,0.3253968253968254,0.08666145214419926,0.8191826370421402
4,40,8,52,0.09090909090909091,0.8461538461538461,0.0849964504791976,0.8007760436355469
11,172,23,206,0.060109289617486336,0.8883495145631068,0.09358349185312423,0.8052341375527253
11,152,2,165,0.06748466257668712,0.9878787878787879,0.09302007630285503,0.8213596786782665
15,131,4,150,0.10273972602739725,0.9733333333333334,0.09069037729996621,0.8255758370517282
3,112,2,117,0.02608695652173913,0.9829059829059829,0.06308067984454645,0.8357388766265325
46,170,6,222,0.21296296296296297,0.972972972972973,0.08701045377432037,0.8538558947435507
9,91,1,101,0.09,0.9900990099009901,0.09289895551648066,0.9488133496727171
3,53,5,61,0.05357142857142857,0.9180327868852459,0.08756500375395747,0.9590817697772026
2,29,8,39,0.06451612903225806,0.7948717948717948,0.08819455224178199,0.9457278098213011
3,157,4,164,0.01875,0.975609756097561,0.08123245758796956,0.9439750909954113
15,111,14,140,0.11904761904761904,0.9,0.08356215659085839,0.933498900519221
25,96,19,140,0.2066115702479339,0.8642857142857143,0.10935138712317193,0.9165531478591827
12,94,2,108,0.11320754716981132,0.9814814814814815,0.09510061343843597,0.9177686490746838
6,59,2,67,0.09230769230769231,0.9701492537313433,0.09543028376810629,0.9149186839075913
4,124,4,132,0.03125,0.9696969696969697,0.09224150825790221,0.9222992814521235
11,38,1,50,0.22448979591836735,0.98,0.11509488924163212,0.9487461678990098
15,85,1,101,0.15,0.9900990099009901,0.13384488924163213,0.9508160612994996
5,24,1,30,0.1724137931034483,0.9666666666666667,0.14146862839246485,0.9603398708233092
8,78,10,96,0.09302325581395349,0.8958333333333334,0.12524172633046765,0.9648466735443977
17,37,1,55,0.3148148148148148,0.9818181818181818,0.15404276456546814,0.9648947735924978
0,4,59,63,0.0,0.06349206349206349,0.14085595137865498,0.8353723178440291
6,193,9,208,0.03015075376884422,0.9567307692307693,0.14069891620277558,0.8335200034917147
17,204,11,232,0.07692307692307693,0.9525862068965517,0.11961795634630552,0.8296037473340794
32,107,12,151,0.2302158273381295,0.9205298013245033,0.1310773602517526,0.8196652889660099
2,61,2,65,0.031746031746031744,0.9692307692307692,0.11098196577212165,0.8200315893323102
26,197,6,229,0.11659192825112108,0.9737991266375546,0.11434891897743131,0.8311695598043417
1,1,65,67,0.5,0.029850746268656716,0.14080394543245775,0.6951742118686954
3,10,2,15,0.23076923076923078,0.8666666666666667,0.17377097839949074,0.8099134408936387
21,64,2,87,0.24705882352941178,0.9770114942528736,0.20475784550814327,0.8128106873253679
1,61,3,65,0.016129032258064516,0.9538461538461539,0.19607298198457004,0.8129906797467397
31,79,32,142,0.2818181818181818,0.7746478873239436,0.2034447469102918,0.7921504063180882
123,464,5,592,0.20954003407155025,0.9915540540540541,0.2288438900996516,0.795339447007129
0,58,1,59,0.0,0.9830508474576272,0.21218790034949145,0.7966611214099965
21,76,9,106,0.21649484536082475,0.9150943396226415,0.1716871639724664,0.923124491889137
2,0,0,2,1.0,1.0,0.28157727386257625,0.9421721109367561
1,15,1,17,0.0625,0.9411764705882353,0.2552117276440889,0.9370528218418078
7,96,2,105,0.06796116504854369,0.9809523809523809,0.2626163180427287,0.9409251399998403
12,117,21,150,0.09302325581395349,0.86,0.23564561432783898,0.9531182989535625
15,44,4,63,0.2542372881355932,0.9365079365079365,0.242030936336988,0.9452545678755457
5,22,3,30,0.18518518518518517,0.9,0.2684859627920145,0.9333901610958849
1,23,0,24,0.041666666666666664,1.0,0.1767374244852216,0.9515410465261372
28,75,14,117,0.27184466019417475,0.8803418803418803,0.14414380451296083,0.9344470294321202
17,91,2,110,0.1574074074074074,0.9818181818181818,0.1577020055711619,0.9402529881792553
27,96,3,126,0.21951219512195122,0.9761904761904762,0.17519126506847255,0.9395727160704118
84,298,36,418,0.2198952879581152,0.9138755980861244,0.19341806444710435,0.9463168491303343
7,85,13,105,0.07608695652173914,0.8761904761904762,0.16554670956764336,0.9377000690849828
4,35,1,40,0.10256410256410256,0.975,0.15556818234773684,0.9433452303753054
0,12,2,14,0.0,0.8571428571428571,0.14961580139535588,0.9229370671099993
1,13,2,16,0.07142857142857142,0.875,0.12098493157169828,0.9221739413468735
31,221,15,267,0.12301587301587301,0.9438202247191011,0.1160718552300505,0.9167456617612906
34,121,15,170,0.21935483870967742,0.9117647058823529,0.11604937574258281,0.9075419802887016
1,21,4,26,0.045454545454545456,0.8461538461538461,0.09112926967064428,0.897867444298376
2,49,75,126,0.0392156862745098,0.40476190476190477,0.08586194534961152,0.8305205055228659
4,40,8,52,0.09090909090909091,0.8461538461538461,0.08419694368460984,0.8121139121162725
9,172,25,206,0.049723756906077346,0.8786407766990292,0.09130033752833519,0.8151850434814399
10,153,2,165,0.06134969325153374,0.9878787878787879,0.08986049778875838,0.8313105846069809
14,132,4,150,0.0958904109589041,0.9733333333333334,0.08598543178061994,0.8355267429804428
4,111,2,117,0.034782608695652174,0.9829059829059829,0.059617970350044916,0.8456897825552471
46,170,6,222,0.21296296296296297,0.972972972972973,0.08354774427981884,0.8638068006722651
9,91,1,101,0.09,0.9900990099009901,0.09080264624060316,0.9474263871207059
3,53,5,61,0.05357142857142857,0.9180327868852459,0.08546869447807996,0.9576948072251916
2,29,8,39,0.06451612903225806,0.7948717948717948,0.08758189049610578,0.945727809821301
3,157,4,164,0.01875,0.975609756097561,0.08149622003160097,0.9439750909954114
15,111,14,140,0.11904761904761904,0.9,0.08480439261570309,0.933498900519221
24,96,20,140,0.2,0.8571428571428571,0.10840687708775278,0.9155327396959173
11,95,2,108,0.10377358490566038,0.9814814814814815,0.09280839450813815,0.9167482409114186
6,59,2,67,0.09230769230769231,0.9701492537313433,0.09313806483780848,0.9138982757443262
4,124,4,132,0.03125,0.9696969696969697,0.08994928932760439,0.9212788732888582
11,38,1,50,0.22448979591836735,0.98,0.11280267031133429,0.9477257597357446
16,84,1,101,0.16,0.9900990099009901,0.13298124173990572,0.9497956531362345
3,26,1,30,0.10344827586206896,0.9666666666666667,0.13075276414196998,0.959319462660044
9,76,11,96,0.10588235294117647,0.8854166666666666,0.11730738599070947,0.9633585783063026
16,38,1,55,0.2962962962962963,0.9818181818181818,0.14481063047508602,0.9634066783544025
0,4,59,63,0.0,0.06349206349206349,0.13162381728827285,0.8338842226059339
4,191,13,208,0.020512820512820513,0.9375,0.13008993450439008,0.8292846555063668
17,204,11,232,0.07692307692307693,0.9525862068965517,0.10900897464792002,0.8253683993487313
33,106,12,151,0.23741007194244604,0.9205298013245033,0.12006755635398372,0.8154299409806619
4,59,2,65,0.06349206349206349,0.9692307692307692,0.11435952601541152,0.8157962413469623
23,200,6,229,0.1031390134529148,0.9737991266375546,0.11396762037423128,0.828422307057089
1,1,65,67,0.5,0.029850746268656716,0.14306814947476038,0.6924269591214427
3,11,1,15,0.21428571428571427,0.9333333333333333,0.17368039437271957,0.8166899976701955
21,64,2,87,0.24705882352941178,0.9770114942528736,0.20604410908937545,0.8223344968491774
1,61,3,65,0.016129032258064516,0.9538461538461539,0.19735924556580223,0.8225144892705492
32,79,32,143,0.2882882882882883,0.7762237762237763,0.20462756218663689,0.8018993428275881
124,463,5,592,0.21124361158432708,0.9915540540540541,0.2257349261998174,0.8050883835166288
0,58,1,59,0.0,0.9830508474576272,0.21100078142082954,0.8064100579194964
21,77,9,107,0.21428571428571427,0.9158878504672897,0.1701844548902173,0.9329867870907295
2,0,0,2,1.0,1.0,0.28242935284940096,0.9425105966145392
1,15,1,17,0.0625,0.9411764705882353,0.2560638066309136,0.9373913075195909
8,95,2,105,0.07766990291262135,0.9809523809523809,0.26485535958156453,0.9412636256776233
15,114,21,150,0.11627906976744186,0.86,0.2402826140785865,0.9532316576456551
16,43,4,63,0.2711864406779661,0.9365079365079365,0.2488458753776778,0.9453679265676384
5,24,2,31,0.1724137931034483,0.9354838709677419,0.273476417249599,0.9385726442119405
1,23,0,24,0.041666666666666664,1.0,0.1755257600492765,0.9505886655737562
29,76,12,117,0.2761904761904762,0.8974358974358975,0.14355297093363023,0.9359366509217415
19,89,2,110,0.17592592592592593,0.9818181818181818,0.15975667463733395,0.9417426096688768
26,97,3,126,0.21138211382113822,0.9761904761904762,0.17608449394881417,0.9410623375600332
81,304,33,418,0.21038961038961038,0.9210526315789473,0.19174369631898,0.9497841420713115
7,85,13,105,0.07608695652173914,0.8761904761904762,0.16629364894557225,0.9411673620259601
4,35,1,40,0.10256410256410256,0.975,0.15631512172566572,0.9468125233162825
0,12,2,14,0.0,0.8571428571428571,0.15036274077328476,0.9264043600509764
1,13,2,16,0.07142857142857142,0.875,0.12111104009301266,0.9231992318458483
30,222,15,267,0.11904761904761904,0.9438202247191011,0.11298556768182595,0.9177709522602653
37,118,15,170,0.23870967741935484,0.9117647058823529,0.11688950533871403,0.9085672707876763
1,21,4,26,0.045454545454545456,0.8461538461538461,0.09332735320513334,0.8978674442983762
3,52,71,126,0.05454545454545454,0.4365079365079365,0.09024999577994983,0.835055652915156
4,40,8,52,0.09090909090909091,0.8461538461538461,0.08858499411494815,0.8166490595085627
10,173,23,206,0.0546448087431694,0.8883495145631068,0.09639139536397236,0.8211071534257413
12,151,2,165,0.0736196319018405,0.9878787878787879,0.0967044040030108,0.8372326945512825
13,133,4,150,0.08904109589041095,0.9733333333333334,0.09241775783769535,0.841448852924744
3,112,2,117,0.02608695652173913,0.9829059829059829,0.062043083423750256,0.8516118924995484
46,170,6,222,0.21296296296296297,0.972972972972973,0.08597285735352418,0.8697289106165665
9,91,1,101,0.09,0.9900990099009901,0.09103779241845925,0.9488133496727171
3,53,5,61,0.05357142857142857,0.9180327868852459,0.08570384065593604,0.9590817697772026
2,29,8,39,0.06451612903225806,0.7948717948717948,0.087114029268663,0.9457278098213011
3,157,4,164,0.01875,0.975609756097561,0.07927551042554294,0.9439750909954113
16,110,14,140,0.12698412698412698,0.9,0.08469594343893094,0.933498900519221
27,95,18,140,0.22131147540983606,0.8714285714285714,0.11258516042294478,0.917573556022448
12,94,2,108,0.11320754716981132,0.9814814814814815,0.09833438673820884,0.918789057237949
7,59,1,67,0.10606060606060606,0.9850746268656716,0.10062875903258113,0.9180712882329036
4,124,4,132,0.03125,0.9696969696969697,0.09743998352237705,0.9254518857774355
12,37,1,50,0.24489795918367346,0.98,0.12320881640115068,0.951898772224322
16,84,1,101,0.16,0.9900990099009901,0.1433873878297221,0.953968665624812
5,24,1,30,0.1724137931034483,0.9666666666666667,0.14987734013248227,0.9634924751486215
8,79,9,96,0.09195402298850575,0.90625,0.13139770407229226,0.9684669649445398
16,38,1,55,0.2962962962962963,0.9818181818181818,0.1575532396617901,0.9685150649926398
0,4,59,63,0.0,0.06349206349206349,0.14240172451027497,0.8368604130821244
5,190,13,208,0.02564102564102564,0.9375,0.14160044245899292,0.8322608459825572
18,204,11,233,0.08108108108108109,0.9527896995708155,0.1181980313014797,0.8283736602069595
35,104,12,151,0.2517985611510791,0.9205298013245033,0.13131211146591956,0.81843520183889
3,55,7,65,0.05172413793103448,0.8923076923076924,0.11407073215557474,0.8078124912161793
26,197,6,229,0.11659192825112108,0.9737991266375546,0.11759043290737693,0.8174623664501157
1,2,64,67,0.3333333333333333,0.04477611940298507,0.12288143819838224,0.6835992146765163
3,11,1,15,0.21428571428571427,0.9333333333333333,0.1534936830963414,0.8078622532252692
21,64,2,87,0.24705882352941178,0.9770114942528736,0.18512479708039659,0.8135067524042511
1,61,3,65,0.016129032258064516,0.9538461538461539,0.17584593296282278,0.8136576744435852
32,78,33,143,0.2909090909090909,0.7692307692307693,0.18143315149968162,0.7920435270016231
126,461,5,592,0.21465076660988075,0.9915540540540541,0.2047083841680882,0.8062215786796748
0,58,1,59,0.0,0.9830508474576272,0.18805239441792804,0.8075432530825423
21,77,9,107,0.21428571428571427,0.9158878504672897,0.1710455916968396,0.9319877860917286
1,1,0,2,0.5,1.0,0.2118619182274519,0.9415115956155381
1,15,1,17,0.0625,0.9411764705882353,0.1854963720089645,0.9363923065205898
10,93,2,105,0.0970873786407767,0.9809523809523809,0.19706185006363766,0.9402646246786223
12,118,20,150,0.09230769230769231,0.8666666666666667,0.16869022169200926,0.9541840385980361
16,43,4,63,0.2711864406779661,0.9365079365079365,0.1767667465588786,0.9463203075200193
5,24,2,31,0.1724137931034483,0.9354838709677419,0.2013972884307998,0.9395250251643213
1,23,0,24,0.041666666666666664,1.0,0.24202822310346367,0.9505886655737562
29,76,12,117,0.2761904761904762,0.8974358974358975,0.138626862559246,0.9359366509217415
15,93,2,110,0.1388888888888889,0.9818181818181818,0.1495395609719444,0.9417426096688768
26,97,3,126,0.21138211382113822,0.9761904761904762,0.16586738028342465,0.9410623375600332
82,303,33,418,0.21298701298701297,0.9210526315789473,0.18189764016750512,0.9497841420713115
6,86,13,105,0.06521739130434782,0.8761904761904762,0.15489479776304146,0.9411673620259601
4,35,1,40,0.10256410256410256,0.975,0.1498423789175192,0.9468125233162825
0,12,2,14,0.0,0.8571428571428571,0.14388999796513824,0.9264043600509765
1,13,2,16,0.07142857142857142,0.875,0.1146382972848661,0.9231992318458483
30,222,15,267,0.11904761904761904,0.9438202247191011,0.11180383016468472,0.9177709522602653
37,118,15,170,0.23870967741935484,0.9117647058823529,0.1157077678215728,0.9085672707876762
2,24,0,26,0.07692307692307693,1.0,0.09627006266958192,0.9198454662763981
2,41,83,126,0.046511627906976744,0.3412698412698413,0.09359781075567176,0.8434282327163073
4,40,8,52,0.09090909090909091,0.8461538461538461,0.09193280909067011,0.825021639309714
10,173,23,206,0.0546448087431694,0.8883495145631068,0.09973921033969431,0.8294797332268925
12,151,2,165,0.0736196319018405,0.9878787878787879,0.10005221897873275,0.8456052743524337
12,134,4,150,0.0821917808219178,0.9733333333333334,0.09478709923220399,0.8498214327258954
4,111,2,117,0.034782608695652174,0.9829059829059829,0.06565466084310362,0.8599844723006996
46,170,6,222,0.21296296296296297,0.972972972972973,0.08508893027737306,0.8561234684396958
9,91,1,101,0.09,0.9900990099009901,0.09130155486209067,0.948813349672717
2,54,5,61,0.03571428571428571,0.9180327868852459,0.0834165826914042,0.9590817697772028
1,30,8,39,0.03225806451612903,0.7948717948717948,0.08021847637325559,0.945727809821301
3,157,4,164,0.01875,0.975609756097561,0.07237995753013551,0.9439750909954114
16,110,14,140,0.12698412698412698,0.9,0.07877886412473682,0.933498900519221
24,96,20,140,0.2,0.8571428571428571,0.1023813485967865,0.9155327396959173
12,94,2,108,0.11320754716981132,0.9814814814814815,0.08813057491205055,0.9167482409114186
8,58,1,67,0.12121212121212122,0.9850746268656716,0.09258944937092502,0.916030471906373
3,125,4,132,0.0234375,0.9696969696969697,0.09083562284031278,0.923411069450905
11,38,1,50,0.22448979591836735,0.98,0.11829729875491825,0.9498579558977914
16,84,1,101,0.16,0.9900990099009901,0.13847587018348967,0.9519278492982812
5,24,1,30,0.1724137931034483,0.9666666666666667,0.14496582248624984,0.9614516588220907
7,79,10,96,0.08139534883720931,0.8958333333333334,0.1280223008915655,0.9669788697064446
16,38,1,55,0.2962962962962963,0.9818181818181818,0.15417783648106334,0.9670269697545446
0,4,59,63,0.0,0.06349206349206349,0.136861819165046,0.8353723178440291
4,191,13,208,0.020512820512820513,0.9375,0.13644400780973467,0.830772750744462
15,207,11,233,0.06756756756756757,0.9527896995708155,0.11402654661676327,0.8268855649688643
34,105,12,151,0.2446043165467626,0.9205298013245033,0.12611287755201506,0.8169471066007948
4,54,7,65,0.06896551724137931,0.8923076923076924,0.11133455242886235,0.8063243959780841
26,197,6,229,0.11659192825112108,0.9737991266375546,0.11636263520227831,0.8174623664501157
1,2,64,67,0.3333333333333333,0.04477611940298507,0.12165364049328362,0.6835992146765163
3,10,2,15,0.23076923076923078,0.8666666666666667,0.15462067346031658,0.7983384437014596
20,65,2,87,0.23529411764705882,0.9770114942528736,0.1853037159080649,0.8039829428804415
1,61,3,65,0.016129032258064516,0.9538461538461539,0.17795535372099305,0.8041338649197755
31,79,33,143,0.2818181818181818,0.7692307692307693,0.18327162018833865,0.7825197174778135
124,463,5,592,0.21124361158432708,0.9915540540540541,0.20359706223733115,0.7966977691558652
0,58,1,59,0.0,0.9830508474576272,0.186941072487171,0.7980194435587327
21,77,9,107,0.21428571428571427,0.9158878504672897,0.16993426976608259,0.9224639765679191
1,1,0,2,0.5,1.0,0.20839580822762102,0.9415115956155382
1,15,1,17,0.0625,0.9411764705882353,0.1837109342780412,0.9363923065205899
10,93,2,105,0.0970873786407767,0.9809523809523809,0.1952764123327144,0.9402646246786223
13,116,21,150,0.10077519379844961,0.86,0.1694131283298955,0.9532316576456552
15,44,4,63,0.2542372881355932,0.9365079365079365,0.17555508212293353,0.9453679265676385
5,24,2,31,0.1724137931034483,0.9354838709677419,0.20018562399485473,0.9385726442119405
2,22,0,24,0.08333333333333333,1.0,0.184582319998114,0.9482533197470666
30,77,10,117,0.2803738317757009,0.9145299145299145,0.15320715310892843,0.9360433075370544
22,86,2,110,0.2037037037037037,0.9818181818181818,0.1733791107808861,0.9418492662841897
28,95,3,126,0.22764227642276422,0.9761904761904762,0.1920745511915114,0.9414554245369645
86,294,37,417,0.22631578947368422,0.9112709832134293,0.20787645263934587,0.9499066112736918
5,87,13,105,0.05434782608695652,0.8761904761904762,0.1740819862361838,0.9419047664679729
4,35,1,40,0.10256410256410256,0.975,0.1683258376228923,0.9478571474203539
0,13,1,14,0.0,0.9285714285714286,0.1564210757181304,0.9376530657877008
1,14,1,16,0.06666666666666667,0.9375,0.1258914807025541,0.9409345065691416
28,224,15,267,0.1111111111111111,0.9438202247191011,0.11266396747504089,0.9355062269835586
36,119,15,170,0.23225806451612904,0.9117647058823529,0.113323365774093,0.9263025455109696
2,24,0,26,0.07692307692307693,1.0,0.09198154969543482,0.9389781193376227
2,69,55,126,0.028169014084507043,0.5634920634920635,0.0882417194093706,0.8943069175235635
4,47,1,52,0.0784313725490196,0.9807692307692307,0.08479418655007302,0.8951310933477394
10,172,23,205,0.054945054945054944,0.8878048780487805,0.09264348011365231,0.8893073004159325
11,152,2,165,0.06748466257668712,0.9878787878787879,0.09276033667222668,0.8965042701129022
14,132,4,150,0.0958904109589041,0.9733333333333334,0.0905859509361971,0.9007204284863641
3,112,2,117,0.02608695652173913,0.9829059829059829,0.06113293550842711,0.9108834680611683
46,170,6,222,0.21296296296296297,0.972972972972973,0.08056720494269655,0.9070224642001644
9,91,1,101,0.09,0.9900990099009901,0.08940020293062412,0.967966313687154
1,59,1,61,0.016666666666666666,0.9836065573770492,0.0805766735188594,0.9683716460596994
2,29,8,39,0.06451612903225806,0.7948717948717948,0.08194396981703127,0.95509549132013
3,157,4,164,0.01875,0.975609756097561,0.07498187516321883,0.9533427724942405
15,111,14,140,0.11904761904761904,0.9,0.07829004774732097,0.9428665820180501
27,93,20,140,0.225,0.8571428571428571,0.10670619681564396,0.9249004211947464
12,94,2,108,0.11320754716981132,0.9814814814814815,0.092455423130908,0.9261159224102474
7,59,1,67,0.10606060606060606,0.9850746268656716,0.0947497954252803,0.9253981534052019
5,123,4,132,0.0390625,0.9696969696969697,0.09794920018718505,0.923411069450905
12,37,1,50,0.24489795918367346,0.98,0.1237180330659587,0.9498579558977914
16,84,1,101,0.16,0.9900990099009901,0.1438966044945301,0.9519278492982813
5,24,1,30,0.1724137931034483,0.9666666666666667,0.15152034364536288,0.9614516588220908
10,82,4,96,0.10869565217391304,0.9583333333333334,0.13490543681306472,0.975907441135016
17,37,1,55,0.3148148148148148,0.9818181818181818,0.16370647504806524,0.9759555411831161
0,4,59,63,0.0,0.06349206349206349,0.14855495989655007,0.8443008892726007
5,194,9,208,0.02512562814070352,0.9567307692307693,0.14656397820236486,0.8424485749202864
13,209,11,233,0.05855855855855856,0.9527896995708155,0.11994406382734846,0.8385613891446885
36,108,7,151,0.25,0.9536423841059603,0.1328012066844913,0.8333532997453984
5,53,7,65,0.08620689655172414,0.8923076923076924,0.12048593574853071,0.8227305891226878
24,199,6,229,0.10762331838565023,0.9737991266375546,0.12033274520735031,0.824939988166148
8,58,1,67,0.12121212121212122,0.9850746268656716,0.09267521754982265,0.8254051946015036
3,10,2,15,0.23076923076923078,0.8666666666666667,0.12564225051685562,0.940144423626447
22,63,2,87,0.25882352941176473,0.9770114942528736,0.15902766498415005,0.9430416700581762
1,61,3,65,0.016129032258064516,0.9538461538461539,0.15296630408407955,0.9431925920975103
35,79,29,143,0.30701754385964913,0.7972027972027972,0.1611116674926008,0.9208440796827728
123,464,5,592,0.20954003407155025,0.9915540540540541,0.17873068713829024,0.9350221313608243
0,58,1,59,0.0,0.9830508474576272,0.16335592736891164,0.9363438057636919
23,75,9,107,0.23469387755102042,0.9158878504672897,0.17956760684589726,0.926459980563923
2,0,0,2,1.0,1.0,0.2894577167360071,0.9455075996115421
1,15,1,17,0.0625,0.9411764705882353,0.26141149824861215,0.9403883105165939
10,93,2,105,0.0970873786407767,0.9809523809523809,0.2729769763032853,0.9442606286746262
13,116,21,150,0.10077519379844961,0.86,0.24351378343739968,0.9532316576456551
15,44,4,63,0.2542372881355932,0.9365079365079365,0.24989910544654872,0.9453679265676385
4,25,2,31,0.13793103448275862,0.9354838709677419,0.2696035389440857,0.9385726442119405
2,20,0,22,0.09090909090909091,1.0,0.25695765951205257,0.9492593559643705
29,64,14,107,0.3118279569892473,0.8691588785046729,0.15864736765337367,0.9305677671793237
16,71,2,89,0.1839080459770115,0.9775280898876404,0.17599137422151817,0.9357608556506675
26,77,3,106,0.2524271844660194,0.9716981132075472,0.19822751578117995,0.9347252477630238
86,251,40,377,0.2551928783382789,0.8938992042440318,0.21829019863512608,0.9396887155725333
4,79,13,96,0.04819277108433735,0.8645833333333334,0.1836164386601613,0.9300287075015082
4,28,1,33,0.125,0.9696969696969697,0.18106541825199804,0.9352235126963134
0,12,2,14,0.0,0.8571428571428571,0.16807840526498505,0.9148153494310074
0,9,2,11,0.0,0.8181818181818182,0.12353155426652115,0.9075329122420283
24,187,15,226,0.11374407582938388,0.9336283185840708,0.1135081299597172,0.9012615163415182
35,105,15,155,0.25,0.9032258064516129,0.11316138932171442,0.8914797582335275
3,17,4,24,0.15,0.8333333333333334,0.09813383527338888,0.8828274909605707
1,40,81,122,0.024390243902439025,0.3360655737704918,0.0947334742474034,0.8073249538801647
3,37,8,48,0.075,0.8333333333333334,0.08759061710454626,0.7878444343996452
8,157,23,188,0.048484848484848485,0.8776595744680851,0.09451702403095319,0.7907753940175349
10,124,2,136,0.07462686567164178,0.9852941176470589,0.10517800484118774,0.8146485796554266
12,125,4,141,0.08759124087591241,0.9716312056737588,0.10144188556212039,0.820077563525382
3,98,2,103,0.0297029702970297,0.9805825242718447,0.0699708813188389,0.8311285232139864
46,170,6,222,0.21296296296296297,0.972972972972973,0.0789655903135479,0.8510770431625063
6,72,1,79,0.07692307692307693,0.9873417721518988,0.08647028074506759,0.9441165000741361
1,47,5,53,0.020833333333333332,0.9056603773584906,0.07873218550697236,0.9544489349348727
1,27,8,36,0.03571428571428571,0.7777777777777778,0.07690781939689197,0.9401801068362573
3,152,4,159,0.01935483870967742,0.9748427672955975,0.06901181554518278,0.9386870567860486
15,101,15,131,0.12931034482758622,0.8854961832061069,0.07497168753827901,0.9263820535763841
27,78,19,124,0.2571428571428571,0.8467741935483871,0.10746309994482581,0.9072665777587473
11,87,2,100,0.11224489795918367,0.98,0.09307480494428588,0.9082704387626084
7,57,1,65,0.109375,0.9846153846153847,0.0977107939552749,0.9078809548288204
3,112,4,119,0.02608695652173913,0.9663865546218487,0.09846131155361859,0.9165561230093002
11,35,1,47,0.2391304347826087,0.9787234042553191,0.12752076142052188,0.9452626410775204
16,83,1,100,0.16161616161616163,0.99,0.14784380755001963,0.9474279600352923
5,22,1,28,0.18518518518518517,0.9642857142857143,0.15582592760110517,0.958683607332379
5,62,11,78,0.07462686567164178,0.8589743589743589,0.12975221453378868,0.9604264881075179
16,35,1,52,0.3137254901960784,0.9807692307692307,0.15853515628191656,0.9605363782174079
0,1,59,60,0.0,0.016666666666666666,0.14291015628191656,0.8222579899390198
5,166,9,180,0.029239766081871343,0.95,0.1433605576476497,0.8199170535644699
14,174,11,199,0.07446808510638298,0.9447236180904522,0.11983736483676033,0.8150599412552032
32,95,13,140,0.25196850393700787,0.9071428571428571,0.13274484231116693,0.8032232065613255
2,54,7,63,0.03571428571428571,0.8888888888888888,0.11139185667246701,0.7924522315046362
24,179,6,209,0.11822660098522167,0.9712918660287081,0.11762039028869271,0.8084975896552576
1,2,64,67,0.3333333333333333,0.04477611940298507,0.12042151073687195,0.6747842880315081
3,11,1,15,0.21428571428571427,0.9333333333333333,0.15103375563483115,0.8057366689838891
19,48,2,69,0.2835820895522388,0.9710144927536232,0.18736837327345507,0.8087387393772639
0,60,3,63,0.0,0.9523809523809523,0.17673007540111466,0.8098326442759066
37,73,32,142,0.33636363636363636,0.7746478873239436,0.188786522890633,0.7909047914446334
123,461,5,589,0.2106164383561644,0.9915110356536503,0.2137725446966157,0.8055650981253135
0,52,1,53,0.0,0.9811320754716981,0.19688303027015544,0.806970842331455
22,64,9,95,0.2558139534883721,0.9052631578947369,0.1858088331494467,0.929897562115991
1,1,0,2,0.5,1.0,0.22662515968005895,0.9394213716398004
1,15,1,17,0.0625,0.9411764705882353,0.19504200402973912,0.935158797044745
9,84,2,95,0.0967741935483871,0.9789473684210527,0.20886688882236584,0.9389539993361881
14,107,21,142,0.11570247933884298,0.852112676056338,0.17734386639025249,0.9500203977265301
16,39,4,59,0.2909090909090909,0.9322033898305084,0.18881424532638486,0.9415478768946527
4,24,2,30,0.14285714285714285,0.9333333333333333,0.20922240859169097,0.9347194851606005
1,21,0,22,0.045454545454545456,1.0,0.23584100396644522,0.9505886655737562
28,65,14,107,0.3010752688172043,0.8691588785046729,0.13599461379747443,0.9318970767887096
19,68,2,89,0.21839080459770116,0.9775280898876404,0.15826472874000316,0.9370901652600531
28,75,3,106,0.27184466019417475,0.9716981132075472,0.19016486743625838,0.935768127010791
86,250,40,376,0.25595238095238093,0.8936170212765957,0.2145478764538189,0.9405705586217333
4,79,13,96,0.04819277108433735,0.8645833333333334,0.18269163794044332,0.9302956153110757
4,28,1,33,0.125,0.9696969696969697,0.18084434730004925,0.9351832008438227
0,12,2,14,0.0,0.8571428571428571,0.17435084080654278,0.9147750375785165
0,9,2,11,0.0,0.8181818181818182,0.1313400881183707,0.9074926003895373
25,190,15,230,0.11627906976744186,0.9347826086956522,0.11675269742833369,0.9013861030763961
35,104,15,154,0.2517985611510791,0.9025974025974026,0.11388896899360572,0.8915145729892326
2,18,4,24,0.1,0.8333333333333334,0.09161005742897989,0.8829026175687665
1,41,80,122,0.023809523809523808,0.3442622950819672,0.08812673638972081,0.8085710406757142
3,37,8,48,0.075,0.8333333333333334,0.08098387924686366,0.7890905211951946
15,151,23,189,0.09036144578313253,0.8783068783068783,0.0938926572158826,0.7921139527900548
10,124,2,136,0.07462686567164178,0.9852941176470589,0.10455363802611714,0.8159871384279463
13,124,4,141,0.0948905109489051,0.9716312056737588,0.10149812962346903,0.821251223710533
3,99,2,104,0.029411764705882353,0.9807692307692307,0.06972858727415521,0.8324186277350799
47,169,6,222,0.2175925925925926,0.972972972972973,0.086527529073097,0.8523671476835999
6,72,1,79,0.07692307692307693,0.9873417721518988,0.09411517951789031,0.9442356444078758
1,47,5,53,0.020833333333333332,0.9056603773584906,0.08637708427979508,0.9545680792686125
0,28,8,36,0.0,0.7777777777777778,0.07346830631077615,0.940206779193027
3,152,4,159,0.01935483870967742,0.9748427672955975,0.06557230245906695,0.9387137291428181
17,100,14,131,0.1452991452991453,0.8931297709923665,0.07277353593767269,0.9274992384740477
26,80,19,125,0.24528301886792453,0.848,0.10361228653225016,0.9085322055070147
11,87,2,100,0.11224489795918367,0.98,0.08856261587033458,0.9095360665108758
7,57,1,65,0.109375,0.9846153846153847,0.09319860488132359,0.909146582577088
3,112,4,119,0.02608695652173913,0.9663865546218487,0.09394912247966727,0.9178217507575679
11,35,1,47,0.2391304347826087,0.9787234042553191,0.1281106131628971,0.9465282688257879
15,84,1,100,0.15151515151515152,0.99,0.14699065784939339,0.9486935877835597
4,23,1,28,0.14814814814814814,0.9642857142857143,0.1473976582563938,0.9588587225397524
7,62,9,78,0.10144927536231885,0.8846153846153846,0.12684998061273586,0.9640894917705215
14,38,1,53,0.2692307692307692,0.9811320754716981,0.1492765336515338,0.9642512168379069
0,1,59,60,0.0,0.016666666666666666,0.1336515336515338,0.8259728285595187
5,166,9,180,0.029239766081871343,0.95,0.13410193501726694,0.8236318921849689
14,174,11,199,0.07446808510638298,0.9447236180904522,0.11057874220637756,0.8187747798757021
35,95,11,141,0.2692307692307692,0.9219858156028369,0.12739525902289436,0.8090584678189645
2,54,7,63,0.03571428571428571,0.8888888888888888,0.11133327867519974,0.7982874927622751
21,182,6,209,0.10344827586206896,0.9712918660287081,0.11161885017516404,0.8106698472498929
1,2,64,67,0.3333333333333333,0.04477611940298507,0.1207763593326732,0.676904710668648
3,11,1,15,0.21428571428571427,0.9333333333333333,0.15138860423063236,0.807857091621029
19,48,2,69,0.2835820895522388,0.9710144927536232,0.18772322186925633,0.8108591620144038
1,59,3,63,0.016666666666666666,0.9523809523809523,0.17946587637786826,0.8119530669130467
35,74,32,141,0.3211009174311927,0.7730496453900709,0.18687589754935732,0.7906764711683658
124,460,5,589,0.21232876712328766,0.9915110356536503,0.2121065377506433,0.805336777849046
0,53,1,54,0.0,0.9814814814814815,0.19732821262749062,0.8067924371994424
23,63,9,95,0.26744186046511625,0.9052631578947369,0.18791514507488818,0.9297191569839782
2,0,0,2,1.0,1.0,0.30016004303407184,0.9392429665077877
1,15,1,17,0.0625,0.9411764705882353,0.268576887383752,0.9349803919127323
9,84,2,95,0.0967741935483871,0.9789473684210527,0.28002081979542637,0.9387755942041752
14,108,20,142,0.11475409836065574,0.8591549295774648,0.2505427027853497,0.9510763490880886
16,39,4,59,0.2909090909090909,0.9322033898305084,0.2617684633261787,0.9426038282562113
4,24,2,30,0.14285714285714285,0.9333333333333333,0.2821766265914848,0.9357255213779043
1,23,0,24,0.041666666666666664,1.0,0.2339129158733086,0.9505886655737562
27,76,14,117,0.2621359223300971,0.8803418803418803,0.12850376192046534,0.9334946484797391
16,92,2,110,0.14814814814814814,0.9818181818181818,0.14073921165591505,0.9393006072268744
27,95,3,125,0.22131147540983606,0.976,0.16680728650641868,0.938593124233677
88,285,45,418,0.2359249329758713,0.8923444976076556,0.188329231527335,0.9432137667490564
6,86,13,105,0.06521739130434782,0.8761904761904762,0.15890508161681804,0.9345969867037051
4,34,1,39,0.10526315789473684,0.9743589743589743,0.15423824210424356,0.9401505729024525
0,12,2,14,0.0,0.8571428571428571,0.14828586115186257,0.9197424096371464
0,14,2,16,0.0,0.875,0.110837872247563,0.9189792838740206
27,226,15,268,0.1067193675889328,0.9440298507462687,0.10491947502481794,0.9135809508637472
34,123,14,171,0.21656050955414013,0.9181286549707602,0.10424076561686138,0.9053136158595702
1,21,4,26,0.045454545454545456,0.8461538461538461,0.07703071025667198,0.8987149513661689
1,42,83,126,0.023255813953488372,0.3412698412698413,0.0710361992065492,0.8222977178060781
4,40,8,52,0.09090909090909091,0.8461538461538461,0.06898561820859979,0.8039826994910599
15,165,25,205,0.08333333333333333,0.8780487804878049,0.08089038011336168,0.8069692599689094
11,152,2,165,0.06748466257668712,0.9878787878787879,0.09053104619574556,0.8230948010944505
14,132,4,150,0.0958904109589041,0.9733333333333334,0.08898405239145572,0.8272810128926027
4,112,2,118,0.034482758620689655,0.9830508474576272,0.06297294511524854,0.8365556118192979
47,169,6,222,0.2175925925925926,0.972972972972973,0.08756409470639813,0.8546726299363162
9,91,1,101,0.09,0.9900990099009901,0.09709897842732836,0.9473625111693375
2,54,5,61,0.03571428571428571,0.9180327868852459,0.0892140062566419,0.957630931273823
2,29,8,39,0.06451612903225806,0.7948717948717948,0.08652583421363114,0.9457485047572501
3,157,4,164,0.01875,0.975609756097561,0.0795637395598187,0.9439957859313607
16,110,14,140,0.12698412698412698,0.9,0.0840056989919934,0.9335195954551702
26,93,21,140,0.2184873949579832,0.85,0.11029207561160677,0.914512331532652
12,94,2,108,0.11320754716981132,0.9814814814814815,0.09537992626549514,0.9157278327481532
6,59,2,67,0.09230769230769231,0.9701492537313433,0.09570959659516547,0.9128778675810608
3,123,6,132,0.023809523809523808,0.9545454545454546,0.09400891632305663,0.9180939629610906
12,37,1,50,0.24489795918367346,0.98,0.11977774920183028,0.944540849407977
15,85,1,101,0.15,0.9900990099009901,0.13852774920183025,0.946610742808467
4,25,1,30,0.13793103448275862,0.9666666666666667,0.14009159313020622,0.9561345523322765
10,77,9,96,0.11494252873563218,0.90625,0.12529946938415606,0.9641702666179908
15,39,1,55,0.2777777777777778,0.9818181818181818,0.1488095023281513,0.9642183666660908
0,4,59,63,0.0,0.06349206349206349,0.1356226891413381,0.8346959109176222
5,194,9,208,0.02512562814070352,0.9567307692307693,0.13581070404579235,0.8350080987298101
16,206,12,234,0.07207207207207207,0.9487179487179487,0.11112129160127786,0.8305392342609456
34,106,12,152,0.24285714285714285,0.9210526315789473,0.12438659772372684,0.8206754659292252
3,60,2,65,0.047619047619047616,0.9692307692307692,0.11148488531462526,0.8210417662955256
22,200,6,228,0.0990990990990991,0.9736842105263158,0.10922153822369196,0.830675224942142
1,1,65,67,0.5,0.029850746268656716,0.1409675699697237,0.6946798770064957
3,11,1,15,0.21428571428571427,0.9333333333333333,0.17157981486768287,0.8189429155552485
19,65,3,87,0.2261904761904762,0.9655172413793104,0.200303364589079,0.820198125862183
0,62,3,65,0.0,0.9538461538461539,0.1900073542930687,0.8209307265947837
33,76,32,141,0.30275229357798167,0.7730496453900709,0.19856380439604565,0.7997874428535157
124,463,5,592,0.21124361158432708,0.9915540540540541,0.22193874210537132,0.8029764835425562
0,58,1,59,0.0,0.9830508474576272,0.20778172794835711,0.8043145745327437
23,74,9,106,0.23711340206185566,0.9150943396226415,0.17022649967147938,0.9307779450118844
2,0,0,2,1.0,1.0,0.2824713976306631,0.940301754535694
1,15,1,17,0.0625,0.9411764705882353,0.2590870438891665,0.9368245015655404
5,98,2,105,0.04854368932038835,0.9809523809523809,0.26602185664922195,0.9406968197235727
11,118,21,150,0.08527131782945736,0.86,0.23495314582800417,0.9531182989535625
16,43,4,63,0.2711864406779661,0.9365079365079365,0.24351640712709546,0.9452545678755458
4,25,2,31,0.13793103448275862,0.9354838709677419,0.2632208406246324,0.9384592855198479
1,23,0,24,0.041666666666666664,1.0,0.2339859906313373,0.9505886655737564
27,76,14,117,0.2621359223300971,0.8803418803418803,0.128576836678494,0.9334946484797392
17,91,2,110,0.1574074074074074,0.9818181818181818,0.14213503773669509,0.9393006072268744
27,94,3,124,0.2231404958677686,0.9758064516129032,0.16707743867203512,0.9385654744640919
83,288,48,419,0.22371967654986524,0.8854415274463007,0.18574835592002253,0.9421999783849919
4,88,13,105,0.043478260869565216,0.8761904761904762,0.15563992345344707,0.9335831983396405
4,34,1,39,0.10526315789473684,0.9743589743589743,0.15097308394087253,0.9391367845383881
0,12,2,14,0.0,0.8571428571428571,0.14502070298849157,0.9187286212730819
0,14,2,16,0.0,0.875,0.107572714084192,0.9179654955099561
27,226,15,268,0.1067193675889328,0.9440298507462687,0.10033156553869561,0.9125671624996828
33,123,15,171,0.21153846153846154,0.9122807017543859,0.09867413206308033,0.9034920553770374
2,20,4,26,0.09090909090909091,0.8461538461538461,0.07970119125725542,0.8978795294781153
1,38,87,126,0.02564102564102564,0.30952380952380953,0.0771530147960355,0.8169271485257344
4,40,8,52,0.09090909090909091,0.8461538461538461,0.07510243379808608,0.7986121302107161
14,166,25,205,0.07777777777777778,0.8780487804878049,0.08621354490919718,0.8015986906885658
11,152,2,165,0.06748466257668712,0.9878787878787879,0.09585421099158106,0.8177242318141069
12,134,4,150,0.0821917808219178,0.9733333333333334,0.09235027002486462,0.821910443612259
5,111,2,118,0.04310344827586207,0.9830508474576272,0.0682881252730647,0.8320204644270077
47,169,6,222,0.2175925925925926,0.972972972972973,0.08638576837070779,0.850137482544026
9,91,1,101,0.09,0.9900990099009901,0.09557990756484698,0.9473625111693373
1,55,5,61,0.017857142857142856,0.9180327868852459,0.08514391498599727,0.957630931273823
1,30,8,39,0.03225806451612903,0.7948717948717948,0.07864109880576173,0.9457485047572503
3,157,4,164,0.01875,0.975609756097561,0.07167900415194929,0.9439957859313607
15,111,14,140,0.11904761904761904,0.9,0.07694412389847805,0.9335195954551702
27,94,19,140,0.2231404958677686,0.8642857142857143,0.10266370212589325,0.9165531478591827
11,95,2,108,0.10377358490566038,0.9814814814814815,0.08640384388490295,0.9177686490746837
7,58,2,67,0.1076923076923077,0.9701492537313433,0.08893131641237546,0.9149186839075913
3,125,4,132,0.0234375,0.9696969696969697,0.08972851028992648,0.9222992814521234
11,38,1,50,0.22448979591836735,0.98,0.11719018620453196,0.9487461678990099
17,83,1,101,0.17,0.9900990099009901,0.13879732906167483,0.9508160612994997
3,26,1,30,0.10344827586206896,0.9666666666666667,0.1365688514637391,0.9603398708233092
10,77,9,96,0.11494252873563218,0.90625,0.12111199901629104,0.9663347687824928
16,38,1,55,0.2962962962962963,0.9818181818181818,0.14861524350066757,0.966382868830593
0,4,59,63,0.0,0.06349206349206349,0.1332306281160522,0.8368604130821244
5,194,9,208,0.02512562814070352,0.9567307692307693,0.13347178927900985,0.8350080987298101
16,207,11,234,0.07174887892376682,0.9529914529914529,0.1116516582797812,0.8311497348714462
33,106,13,152,0.23741007194244604,0.9144736842105263,0.12128166855727349,0.8203461169156657
3,60,2,65,0.047619047619047616,0.9692307692307692,0.11330606452255616,0.820712417281966
21,201,6,228,0.0945945945945946,0.9736842105263158,0.11039921678812223,0.8303458759285826
1,1,65,67,0.5,0.029850746268656716,0.13949974588865133,0.6943505279929362
3,11,1,15,0.21428571428571427,0.9333333333333333,0.1701119907866105,0.8186135665416889
19,65,3,87,0.2261904761904762,0.9655172413793104,0.19883554050800661,0.8198687768486234
0,62,3,65,0.0,0.9538461538461539,0.1885857006617542,0.8199908769707235
32,77,32,141,0.29357798165137616,0.7730496453900709,0.19660968776302992,0.7997874428535157
126,461,5,592,0.21465076660988075,0.9915540540540541,0.22047136190457753,0.8029764835425562
0,58,1,59,0.0,0.9830508474576272,0.206957848391064,0.8043145745327437
22,75,9,106,0.2268041237113402,0.9150943396226415,0.16792986606411262,0.9307779450118844
2,0,0,2,1.0,1.0,0.2801747640232963,0.940301754535694
1,15,1,17,0.0625,0.9411764705882353,0.25679041028179966,0.9368245015655404
4,99,2,105,0.038834951456310676,0.9809523809523809,0.26233826048984404,0.9406968197235727
11,118,21,150,0.08527131782945736,0.86,0.2325801656581414,0.9531182989535625
16,43,4,63,0.2711864406779661,0.9365079365079365,0.2406566905250107,0.9452545678755458
4,25,2,31,0.13793103448275862,0.9354838709677419,0.2603611240225477,0.9384592855198479
2,22,0,24,0.08333333333333333,1.0,0.24474660330226108,0.9524934274785181
29,73,15,117,0.28431372549019607,0.8717948717948718,0.14250570694371764,0.9341784091634998
15,93,2,110,0.1388888888888889,0.9818181818181818,0.15341840535641607,0.939984367910635
27,94,3,124,0.2231404958677686,0.9758064516129032,0.17419991863572282,0.9392492351478525
85,285,49,419,0.22972972972972974,0.883054892601432,0.1906607633408423,0.9406380293290094
5,87,13,105,0.05434782608695652,0.8761904761904762,0.16452643341137604,0.932021249283658
4,34,1,39,0.10526315789473684,0.9743589743589743,0.15985959389880153,0.9375748354824055
0,12,2,14,0.0,0.8571428571428571,0.1479548319940396,0.9171666722170994
0,14,2,16,0.0,0.875,0.10733858549544019,0.9176245476749748
28,226,15,269,0.11023622047244094,0.9442379182156134,0.10324534715023333,0.9122559385888936
36,120,15,171,0.23076923076923078,0.9122807017543859,0.10433516642187078,0.9031808314662483
1,21,4,26,0.045454545454545456,0.8461538461538461,0.07801014009684445,0.8979092534023074
1,44,81,126,0.022222222222222223,0.35714285714285715,0.07342076811616813,0.8237595935383618
4,40,8,52,0.09090909090909091,0.8461538461538461,0.07137018711821871,0.8054445752233435
13,168,24,205,0.0718232044198895,0.8829268292682927,0.08163064489248864,0.8091279998126915
12,151,2,165,0.0736196319018405,0.9878787878787879,0.09214773516418014,0.8252535409382327
12,134,4,150,0.0821917808219178,0.9733333333333334,0.08814138664267683,0.8294100288121927
3,113,2,118,0.02586206896551724,0.9830508474576272,0.05886893495643204,0.8395200496269414
47,169,6,222,0.2175925925925926,0.972972972972973,0.08346008454758162,0.8576370677439595
9,91,1,101,0.09,0.9900990099009901,0.0931426242301213,0.9480593752808356
2,54,5,61,0.03571428571428571,0.9180327868852459,0.08525765205943488,0.9583277953853214
2,29,8,39,0.06451612903225806,0.7948717948717948,0.08421378414691608,0.9457485047572503
3,157,4,164,0.01875,0.975609756097561,0.07637526530379601,0.9439957859313607
16,109,15,140,0.128,0.8928571428571429,0.08291929661495061,0.9324991872919048
24,97,19,140,0.19834710743801653,0.8642857142857143,0.10756001639673622,0.9155327396959173
12,94,2,108,0.11320754716981132,0.9814814814814815,0.09264786705062462,0.9167482409114186
7,59,1,67,0.10606060606060606,0.9850746268656716,0.0949422393449969,0.916030471906373
3,125,4,132,0.0234375,0.9696969696969697,0.09318841281438466,0.923411069450905
12,37,1,50,0.24489795918367346,0.98,0.11895724569315831,0.9498579558977914
16,84,1,101,0.16,0.9900990099009901,0.1391358171217297,0.9519278492982812
5,24,1,30,0.1724137931034483,0.9666666666666667,0.14548064470793662,0.962472066985356
10,78,8,96,0.11363636363636363,0.9166666666666666,0.13337910987912907,0.9699550601826351
15,39,1,55,0.2777777777777778,0.9818181818181818,0.15688914282312427,0.970003160230735
0,4,59,63,0.0,0.06349206349206349,0.1417376276716091,0.8383485083202197
5,194,9,208,0.02512562814070352,0.9567307692307693,0.14197878883456677,0.8364961939679053
16,207,11,234,0.07174887892376682,0.9529914529914529,0.11724320594029439,0.8326378301095415
34,106,12,152,0.24285714285714285,0.9210526315789473,0.12907994063417194,0.822774061777821
3,55,7,65,0.05172413793103448,0.8923076923076924,0.11183856132382711,0.8121513511551105
21,201,6,228,0.0945945945945946,0.9736842105263158,0.1091183086035744,0.8202967145636316
1,2,64,67,0.3333333333333333,0.04477611940298507,0.11705481654008232,0.6864335627900323
4,10,1,15,0.2857142857142857,0.9333333333333333,0.15787114307069455,0.810696601338785
19,66,2,87,0.2235294117647059,0.9770114942528736,0.18621454073126634,0.8135938477705142
2,60,3,65,0.03225806451612903,0.9538461538461539,0.1805729958158895,0.8137159478926144
32,78,32,142,0.2909090909090909,0.7746478873239436,0.18743755982331065,0.7928009844276138
127,460,5,592,0.21635434412265758,0.9915540540540541,0.21095616070782824,0.8069790361056655
0,58,1,59,0.0,0.9830508474576272,0.19744264719431473,0.8083171270958528
23,74,9,106,0.23711340206185566,0.9150943396226415,0.1836969427269608,0.9326483014129465
2,0,0,2,1.0,1.0,0.2857377590534914,0.9421721109367562
1,15,1,17,0.0625,0.9411764705882353,0.2627335573728191,0.9370528218418077
5,98,2,105,0.04854368932038835,0.9809523809523809,0.26506007520199903,0.9409251399998403
12,117,21,150,0.09302325581395349,0.86,0.23679067018840796,0.9531182989535626
15,44,4,63,0.2542372881355932,0.9365079365079365,0.24220251933311307,0.9452545678755457
4,25,2,31,0.13793103448275862,0.9354838709677419,0.26190695283065,0.9384592855198478
1,23,0,24,0.041666666666666664,1.0,0.23377952254942577,0.9505886655737562
28,75,14,117,0.27184466019417475,0.8803418803418803,0.12975733114859359,0.9334946484797391
18,90,2,110,0.16666666666666666,0.9818181818181818,0.14463828352954597,0.9393006072268744
27,95,3,125,0.22131147540983606,0.976,0.1693193958280385,0.938593124233677
82,281,57,420,0.22589531680440772,0.8642857142857143,0.18608627940253308,0.9392053691316363
5,87,13,105,0.05434782608695652,0.8761904761904762,0.15995194947306682,0.9305885890862848
4,34,1,39,0.10526315789473684,0.9743589743589743,0.15528510996049225,0.9361421752850323
0,12,2,14,0.0,0.8571428571428571,0.1493327290081113,0.9157340120197262
1,13,2,16,0.07142857142857142,0.875,0.12070185918445368,0.9149708862566005
26,228,15,269,0.10236220472440945,0.9442379182156134,0.11151550747841696,0.9096022771705191
36,120,15,171,0.23076923076923078,0.9122807017543859,0.11286661538690192,0.9004995202782886
3,23,0,26,0.11538461538461539,1.0,0.09707937232693156,0.9198872753803294
1,45,80,126,0.021739130434782608,0.36507936507936506,0.09242098723376388,0.8468714023644563
4,40,8,52,0.09090909090909091,0.8461538461538461,0.09037040623581447,0.8285563840494381
14,166,24,204,0.07777777777777778,0.8823529411764706,0.10148151734692558,0.8321578246256686
10,153,2,165,0.06134969325153374,0.9878787878787879,0.10004167760734876,0.8482833657512098
14,133,3,150,0.09523809523809523,0.98,0.09902394768073244,0.8533922345775506
4,112,2,118,0.034482758620689655,0.9830508474576272,0.07098302308808371,0.8635022553922994
47,169,6,222,0.2175925925925926,0.972972972972973,0.08558416268922331,0.8596412515312956
9,91,1,101,0.09,0.9900990099009901,0.09533571548425437,0.9489297722200992
2,54,5,61,0.03571428571428571,0.9180327868852459,0.08745074331356792,0.9591981923245848
2,29,8,39,0.06451612903225806,0.7948717948717948,0.08555622206420795,0.9467008857096312
3,157,4,164,0.01875,0.975609756097561,0.07947055159970313,0.9449481668837416
19,107,14,140,0.15079365079365079,0.9,0.08740705953621107,0.9335195954551702
24,97,19,140,0.19834710743801653,0.8642857142857143,0.11081625222440063,0.9165531478591827
11,95,2,108,0.10377358490566038,0.9814814814814815,0.09455639398341031,0.9177686490746837
6,60,1,67,0.09090909090909091,0.9850746268656716,0.09468626411328043,0.9170508800696383
3,125,4,132,0.0234375,0.9696969696969697,0.0929324375826682,0.9244314776141703
11,38,1,50,0.22448979591836735,0.98,0.1157858185663981,0.9508783640610566
16,84,2,102,0.16,0.9803921568627451,0.13596438999496951,0.9515615641703687
5,24,1,30,0.1724137931034483,0.9666666666666667,0.13905298175351202,0.9610853736941783
10,78,8,96,0.11363636363636363,0.9166666666666666,0.12695144692470445,0.9685683668914571
15,39,1,55,0.2777777777777778,0.9818181818181818,0.15180918876357838,0.9686164669395573
0,4,59,63,0.0,0.06349206349206349,0.1388221757765654,0.8369618150290418
5,194,9,208,0.02512562814070352,0.9567307692307693,0.13906333693952302,0.8351095006767274
15,207,12,234,0.06756756756756757,0.9487179487179487,0.11664587574655164,0.830640636207863
34,107,11,152,0.24113475177304963,0.9276315789473685,0.128236554571273,0.8231034107913805
3,55,7,65,0.05172413793103448,0.8923076923076924,0.11099517526092818,0.8124807001686699
23,199,6,228,0.1036036036036036,0.9736842105263158,0.10956192382767675,0.8206260635771914
1,2,64,67,0.3333333333333333,0.04477611940298507,0.11749843176418469,0.6867629118035917
4,10,1,15,0.2857142857142857,0.9333333333333333,0.15831475829479694,0.8110259503523446
20,65,2,87,0.23529411764705882,0.9770114942528736,0.18833882822427625,0.8139231967840738
3,59,3,65,0.04838709677419355,0.9538461538461539,0.18559876096807998,0.8146557975166745
33,76,33,142,0.30275229357798167,0.7676056338028169,0.19440126694021312,0.79179494821031
126,461,5,592,0.21465076660988075,0.9915540540540541,0.21767649960861973,0.8059729998883617
0,58,1,59,0.0,0.9830508474576272,0.20287598480810493,0.8073110908785489
23,74,9,106,0.23711340206185566,0.9150943396226415,0.18913028034075094,0.9316422651956427
2,0,0,2,1.0,1.0,0.2911710966672816,0.9411660747194522
1,15,1,17,0.0625,0.9411764705882353,0.2664862227177017,0.936046785624504
8,95,2,105,0.07766990291262135,0.9809523809523809,0.27066948073747715,0.9399191037825364
15,116,19,150,0.11450381679389313,0.8733333333333333,0.24377684119689308,0.9550230608583244
14,45,4,63,0.23728813559322035,0.9365079365079365,0.2470107510516559,0.9471593297803078
4,25,2,31,0.13793103448275862,0.9354838709677419,0.2667151845491928,0.9403640474246099
1,23,0,24,0.041666666666666664,1.0,0.24249735218000829,0.9491166557917033
29,76,12,117,0.2761904761904762,0.8974358974358975,0.13909599163579062,0.9344646411396885
18,90,2,110,0.16666666666666666,0.9818181818181818,0.15397694401674303,0.9402705998868239
26,96,3,125,0.21311475409836064,0.976,0.17674141733647808,0.939849547255245
81,277,62,420,0.22625698324022347,0.8523809523809524,0.19135428034954424,0.939024536399839
5,87,13,105,0.05434782608695652,0.8761904761904762,0.16015721654378479,0.9310226915941201
4,34,1,39,0.10526315789473684,0.9743589743589743,0.1547866472634411,0.9368834974549259
0,13,1,14,0.0,0.9285714285714286,0.14883426631106014,0.9266794158222728
1,14,1,16,0.06666666666666667,0.9375,0.11890229352194448,0.9324028590457161
27,226,15,268,0.1067193675889328,0.9440298507462687,0.11033839365369678,0.9270045260354427
36,120,15,171,0.23076923076923078,0.9122807017543859,0.11286046174953537,0.9179017691432121
2,24,0,26,0.07692307692307693,1.0,0.09152704656137159,0.9389902045173618
2,69,55,126,0.028169014084507043,0.5634920634920635,0.08778721627530738,0.8943190027033028
4,47,1,52,0.0784313725490196,0.9807692307692307,0.08395410408306204,0.8952347536190538
12,168,24,204,0.06666666666666667,0.8823529411764706,0.09347791360687159,0.8886321125626313
12,151,2,165,0.0736196319018405,0.9878787878787879,0.09447119435475355,0.8958290822596009
15,132,3,150,0.10204081632653061,0.98,0.09380282988869611,0.900967675010134
4,112,2,118,0.034482758620689655,0.9830508474576272,0.06576190529604738,0.9110776958248827
46,170,6,222,0.21296296296296297,0.972972972972973,0.0851961747303168,0.9072166919638789
9,91,1,101,0.09,0.9900990099009901,0.09402917271824437,0.9681605414508684
3,57,1,61,0.05,0.9836065573770492,0.08996754806838443,0.9685658738234139
1,30,8,39,0.03225806451612903,0.7948717948717948,0.08505203347545047,0.9560685672084601
3,157,4,164,0.01875,0.975609756097561,0.0772135146323304,0.9543158483825707
19,107,14,140,0.15079365079365079,0.9,0.08417820527049043,0.9428872769539992
25,95,20,140,0.20833333333333334,0.8571428571428571,0.10901400165801096,0.9249004211947464
11,95,2,108,0.10377358490566038,0.9814814814814815,0.09341551907839629,0.9261159224102476
6,60,1,67,0.09090909090909091,0.9850746268656716,0.09354538920826642,0.925398153405202
3,125,4,132,0.0234375,0.9696969696969697,0.08975074635112357,0.923411069450905
11,38,1,50,0.22448979591836735,0.98,0.11721242226572905,0.9498579558977914
18,82,2,102,0.18,0.9803921568627451,0.14024813655144333,0.9505411560071034
5,24,1,30,0.1724137931034483,0.9666666666666667,0.14333672830998584,0.960064965530913
10,82,4,96,0.10869565217391304,0.9583333333333334,0.12910277385864008,0.9745207478438381
14,40,1,55,0.25925925925925924,0.9818181818181818,0.15131501305201134,0.9745688478919382
0,4,59,63,0.0,0.06349206349206349,0.13832800006499837,0.8429141959814227
5,194,9,208,0.02512562814070352,0.9567307692307693,0.138569161227956,0.8410618816291083
16,207,11,234,0.07174887892376682,0.9529914529914529,0.11674903022872736,0.8372035177707445
33,107,11,151,0.2357142857142857,0.9271523178807947,0.12470821390219675,0.8295978264876087
4,54,7,65,0.06896551724137931,0.8923076923076924,0.10992988877904404,0.8189751158648981
25,197,6,228,0.11261261261261261,0.9736842105263158,0.11048945455600111,0.8211680983210385
8,58,1,67,0.12121212121212122,0.9850746268656716,0.0907684348349814,0.8216333047563941
4,9,2,15,0.3076923076923077,0.8666666666666667,0.13472447879102534,0.9363725337813376
20,65,2,87,0.23529411764705882,0.9770114942528736,0.16474854872050468,0.9392697802130667
2,60,3,65,0.03225806451612903,0.9538461538461539,0.15910700380512785,0.9393918803351669
37,76,29,142,0.3274336283185841,0.795774647887324,0.17220976703431332,0.9206236417646709
125,462,5,592,0.21294718909710392,0.9915540540540541,0.19277857729941686,0.9348016934427227
0,58,1,59,0.0,0.9830508474576272,0.17669106121190076,0.9361397844329099
24,73,9,106,0.24742268041237114,0.9150943396226415,0.19472114109765076,0.9261426005410486
2,0,0,2,1.0,1.0,0.2936222399987497,0.9451902195886676
1,15,1,17,0.0625,0.9411764705882353,0.2689373660491698,0.9400709304937193
5,98,2,105,0.04854368932038835,0.9809523809523809,0.2712638838783497,0.9439432486517517
14,115,21,150,0.10852713178294573,0.86,0.23999152723040137,0.9531182989535625
14,45,4,63,0.23728813559322035,0.9365079365079365,0.24346880530127518,0.9452545678755457
4,25,2,31,0.13793103448275862,0.9354838709677419,0.2631732387988121,0.9384592855198479
1,21,0,22,0.045454545454545456,1.0,0.2428741956967764,0.942848968966423
29,63,16,108,0.31521739130434784,0.8518518518518519,0.14504810874025467,0.9216849478024017
18,70,2,90,0.20454545454545456,0.9777777777777777,0.16534031653246248,0.9269137059723365
27,74,3,104,0.26732673267326734,0.9711538461538461,0.1989215548406251,0.9258003456484499
82,210,90,382,0.2808219178082192,0.7643979057591623,0.21999135262275166,0.9134194993587252
4,79,13,96,0.04819277108433735,0.8645833333333334,0.18791499524518945,0.9037594912877003
4,28,1,33,0.125,0.9696969696969697,0.18379411612431032,0.9142088120818487
0,13,1,14,0.0,0.9285714285714286,0.17730060963080382,0.9040047304491956
1,7,2,10,0.125,0.8,0.15012669658732555,0.8965973230417882
25,189,15,229,0.11682242990654206,0.9344978165938864,0.1375948359246238,0.8904144714440895
35,105,15,155,0.25,0.9032258064516129,0.13511958839987132,0.8807104657723418
2,22,0,24,0.08333333333333333,1.0,0.10690693347488762,0.9143679078067473
1,42,79,122,0.023255813953488372,0.3524590163934426,0.10334451102762346,0.8412072911010485
3,37,8,48,0.075,0.8333333333333334,0.09620165388476633,0.821726771620529
9,155,24,188,0.054878048780487805,0.8723404255319149,0.10404137513912172,0.8136937711863128
10,124,2,136,0.07462686567164178,0.9852941176470589,0.0968452130922134,0.8401643594216068
11,127,3,141,0.07971014492753623,0.9787234042553191,0.09154345809521258,0.8464823005160973
6,95,2,103,0.0594059405940594,0.9805825242718447,0.06431573532293536,0.8575332602047018
46,170,6,222,0.21296296296296297,0.972972972972973,0.08283425384145386,0.8536722563436979
6,72,1,79,0.07692307692307693,0.9873417721518988,0.09050100569425223,0.9443697928806202
2,46,5,53,0.041666666666666664,0.9056603773584906,0.08573910093234748,0.9547022277413569
2,26,8,36,0.07142857142857142,0.7777777777777778,0.08810346131064513,0.9411932780621945
3,151,4,158,0.01948051948051948,0.9746835443037974,0.08022541185477051,0.9396774818703
18,99,14,131,0.15384615384615385,0.8931297709923665,0.0908162702717159,0.9274498199755925
24,82,18,124,0.22641509433962265,0.8548387096774194,0.11467472080679635,0.9094864178906745
11,87,2,100,0.11224489795918367,0.98,0.10028642580625646,0.9104902788945356
7,58,1,66,0.1076923076923077,0.9848484848484849,0.10468203020186084,0.9101340949940478
3,112,4,119,0.02608695652173913,0.9663865546218487,0.10245635732401406,0.9188092631745277
9,37,1,47,0.1956521739130435,0.9787234042553191,0.12020258625036721,0.9475157812427479
17,82,2,101,0.1717171717171717,0.9801980198019802,0.14195067942703182,0.948303563456774
5,23,1,29,0.17857142857142858,0.9655172413793104,0.1454828615306425,0.9586446306549089
9,60,9,78,0.13043478260869565,0.8846153846153846,0.13177138842622435,0.9628984413603324
14,38,1,53,0.2692307692307692,0.9811320754716981,0.1541979414650223,0.9630601664277177
0,1,59,60,0.0,0.016666666666666666,0.13881332608040692,0.8247484781160297
6,166,9,181,0.03488372093023256,0.9502762430939227,0.14007000671019168,0.8224470050406116
15,174,12,201,0.07936507936507936,0.9402985074626866,0.12345756463191108,0.8169577340702354
33,95,12,140,0.2578125,0.9142857142857143,0.1357568972437437,0.8075416904250546
3,54,7,64,0.05263157894736842,0.890625,0.11776549015459224,0.7968427987994389
26,179,6,211,0.12682926829268293,0.9715639810426541,0.11725041668087617,0.8092640268604774
1,1,65,67,0.5,0.029850746268656716,0.15021744964790912,0.6733666941171856
4,9,2,15,0.3076923076923077,0.8666666666666667,0.19417349360395306,0.7947952655457572
19,49,2,70,0.27941176470588236,0.9714285714285714,0.22910607128618876,0.7978170267364213
1,59,3,63,0.016666666666666666,0.9523809523809523,0.2201491551864155,0.7995430902961734
35,75,32,142,0.3181818181818182,0.7746478873239436,0.22877334349810383,0.7795948293016348
128,456,5,589,0.2191780821917808,0.9915110356536503,0.2525657011044485,0.7940071201092991
0,52,1,53,0.0,0.9811320754716981,0.23444723420549374,0.7953739907420198
24,62,9,95,0.27906976744186046,0.9052631578947369,0.20288577241147382,0.9204329066886027
2,0,0,2,1.0,1.0,0.3017868713125727,0.9394805257362216
1,15,1,17,0.0625,0.9411764705882353,0.2707994763545895,0.935158797044745
5,88,2,95,0.053763440860215055,0.9789473684210527,0.2760990155250964,0.9389539993361881
15,106,20,141,0.12396694214876033,0.8581560283687943,0.2483540332346596,0.9508837337711666
15,40,4,59,0.2727272727272727,0.9322033898305084,0.25600391759687274,0.9424112129392892
4,24,2,30,0.14285714285714285,0.9333333333333333,0.27641208086217883,0.9355828212052372
1,21,0,22,0.045454545454545456,1.0,0.24984452192675488,0.9502814459116979
29,65,14,108,0.30851063829787234,0.8703703703703703,0.15106032739787947,0.9317629273931792
13,75,2,90,0.14772727272727273,0.9777777777777777,0.16323565207320417,0.936991685563114
26,76,3,105,0.2549019607843137,0.9714285714285714,0.18716755493143486,0.9356311413454269
108,261,12,381,0.2926829268292683,0.968503937007874,0.20904584680405455,0.9511317037751231
4,79,13,96,0.04819277108433735,0.8645833333333334,0.17718960829067903,0.9408567604644655
4,28,1,33,0.125,0.9696969696969697,0.1746385878825158,0.9460515656592708
0,12,2,14,0.0,0.8571428571428571,0.16814508138900927,0.9256434023939647
1,7,2,10,0.125,0.8,0.14192927591788465,0.9155904923410547
24,190,15,229,0.11214953271028037,0.9344978165938864,0.1368467416297429,0.9094076407433559
36,104,15,155,0.2571428571428571,0.9032258064516129,0.13716686968096337,0.8996643886037904
2,22,0,24,0.08333333333333333,1.0,0.1072597848958298,0.9041638261740941
1,41,80,122,0.023809523809523808,0.3442622950819672,0.10377646385657072,0.8298322492810418
2,38,8,48,0.05,0.8333333333333334,0.09306217814228501,0.8103517298005223
11,155,22,188,0.06626506024096386,0.8829787234042553,0.10252861531956557,0.8140425678378648
11,123,2,136,0.08208955223880597,0.9852941176470589,0.0963985513536807,0.840513156073159
10,127,4,141,0.072992700729927,0.9716312056737588,0.09080471821363022,0.8458179259417122
3,98,2,103,0.0297029702970297,0.9805825242718447,0.058313305807083445,0.8568688856303168
46,170,6,222,0.21296296296296297,0.972972972972973,0.07683182432560197,0.8530078817693129
6,72,1,79,0.07692307692307693,0.9873417721518988,0.08441947477039527,0.9448763784935889
2,46,5,53,0.041666666666666664,0.9056603773584906,0.08322899857991907,0.9552088133543256
2,26,8,36,0.07142857142857142,0.7777777777777778,0.08396664303529158,0.9401801068362575
3,151,4,158,0.01948051948051948,0.9746835443037974,0.0750224954983935,0.938664310644363
18,99,14,131,0.15384615384615385,0.8931297709923665,0.08657298880071163,0.9274498199755925
23,82,20,125,0.21904761904761905,0.84,0.11362222433651012,0.9073666022224718
11,87,2,100,0.11224489795918367,0.98,0.09923392933597021,0.9083704632263329
7,59,1,67,0.10606060606060606,0.9850746268656716,0.10339643349847438,0.9080465853283004
2,113,4,119,0.017391304347826087,0.9663865546218487,0.09992852459578286,0.9167217535087803
10,36,1,47,0.21739130434782608,0.9787234042553191,0.12078034358424783,0.9454282715770004
16,83,2,101,0.16161616161616163,0.9801980198019802,0.14108543531791098,0.9462160537910265
4,24,1,29,0.14285714285714285,0.9655172413793104,0.13951557660519512,0.9565571209891613
10,59,9,78,0.14492753623188406,0.8846153846153846,0.1289269933458044,0.9629307473627877
15,37,1,53,0.28846153846153844,0.9811320754716981,0.1541007991318551,0.963092472430173
0,1,59,60,0.0,0.016666666666666666,0.13894928398033995,0.8247484781160296
6,161,13,180,0.03592814371257485,0.9277777777777778,0.14159740388958977,0.8192329385668765
16,173,12,201,0.08465608465608465,0.9402985074626866,0.12263522964791242,0.8137436675965004
34,95,12,141,0.26356589147286824,0.9148936170212766,0.1371994767702991,0.8044144671992571
3,54,7,64,0.05263157894736842,0.890625,0.12431011049747416,0.7937155755736415
26,180,6,212,0.1262135922330097,0.9716981132075472,0.1216366899262064,0.8061559653725218
1,1,65,67,0.5,0.029850746268656716,0.1518564701459866,0.6702586326292301
4,9,2,15,0.3076923076923077,0.8666666666666667,0.19581251410203057,0.7916872040578016
20,48,2,70,0.29411764705882354,0.9714285714285714,0.23269672886578038,0.7979230317222007
1,59,3,63,0.016666666666666666,0.9523809523809523,0.22298395486729208,0.7996490952819528
35,75,32,142,0.3181818181818182,0.7746478873239436,0.2307862301114278,0.7796139910394767
129,455,5,589,0.2208904109589041,0.9915110356536503,0.2548232061130758,0.794026281847141
0,52,1,53,0.0,0.9811320754716981,0.23679269293693153,0.7953739907420198
24,62,9,95,0.27906976744186046,0.9052631578947369,0.2052312311429116,0.9204329066886027
2,0,0,2,1.0,1.0,0.30413233004401047,0.9394805257362216
1,15,1,17,0.0625,0.9411764705882353,0.2710440947498928,0.935158797044745
3,90,2,95,0.03225806451612903,0.9789473684210527,0.27327143729981607,0.9389539993361881
16,104,21,141,0.13333333333333333,0.851063829787234,0.24686451089288966,0.9498705625452295
15,40,4,59,0.2727272727272727,0.9322033898305084,0.2542697768597994,0.9413980417133521
4,22,3,29,0.15384615384615385,0.896551724137931,0.2762477988378214,0.9293151343799567
1,23,0,24,0.041666666666666664,1.0,0.24610528435377818,0.9505886655737564
29,74,14,117,0.2815533980582524,0.8803418803418803,0.1434700555049571,0.9334946484797392
18,90,2,110,0.16666666666666666,0.9818181818181818,0.15835100788590947,0.9393006072268744
26,97,3,126,0.21138211382113822,0.9761904761904762,0.17745275230141191,0.9386203351180308
108,299,12,419,0.26535626535626533,0.9713603818615751,0.19653465510424492,0.9545289610982558
4,88,13,105,0.043478260869565216,0.8761904761904762,0.16400491513161625,0.9459121810529043
4,35,1,40,0.10256410256410256,0.975,0.15895249628609395,0.951557342343227
0,12,2,14,0.0,0.8571428571428571,0.153000115333713,0.9311491790779208
2,12,2,16,0.14285714285714285,0.875,0.13318636459069733,0.9303860533147951
27,227,15,269,0.1062992125984252,0.9442379182156134,0.12456244258094855,0.9250174442287139
35,121,15,171,0.22435897435897437,0.9122807017543859,0.12641627980063944,0.9158874764521296
1,25,0,26,0.038461538461538464,1.0,0.09400274738710701,0.9199788504719046
1,41,84,126,0.023809523809523808,0.3333333333333333,0.0911929278071011,0.8424278300637412
3,41,8,52,0.06818181818181818,0.8461538461538461,0.08628117289534619,0.8240212366571479
10,171,25,206,0.055248618784530384,0.8786407766990292,0.09417383272170768,0.8270923680223152
11,152,2,165,0.06748466257668712,0.9878787878787879,0.08340633553878542,0.8432179091478564
13,133,4,150,0.08904109589041095,0.9733333333333334,0.08094089029478338,0.8473743970218165
4,112,2,118,0.034482758620689655,0.9830508474576272,0.053815716617885576,0.8574844178365651
46,170,6,222,0.21296296296296297,0.972972972972973,0.07874449154666051,0.8536234139755613
9,92,1,102,0.0891089108910891,0.9901960784313726,0.08807297541545556,0.947460948989567
3,53,5,61,0.05357142857142857,0.9180327868852459,0.08598577689968559,0.9577293690940527
4,27,8,39,0.12903225806451613,0.7948717948717948,0.09652629679682644,0.9457623716901621
3,157,4,164,0.01875,0.975609756097561,0.08956420214301397,0.9440096528642724
19,107,14,140,0.15079365079365079,0.9,0.09838599570061966,0.933533462388082
24,96,20,140,0.2,0.8571428571428571,0.122031315897664,0.915546606628829
10,96,2,108,0.09433962264150944,0.9814814814814815,0.10508512442317063,0.9167621078443303
7,58,2,67,0.1076923076923077,0.9701492537313433,0.10773989539477329,0.913898275744326
3,125,4,132,0.0234375,0.9696969696969697,0.1034350484559978,0.921278873288858
11,38,1,50,0.22448979591836735,0.98,0.11707183957797652,0.9477257597357446
15,85,2,102,0.15,0.9803921568627451,0.13582183957797653,0.9484089598450566
4,25,1,30,0.13793103448275862,0.9666666666666667,0.13398432296213478,0.957932769368866
11,76,9,96,0.12643678160919541,0.90625,0.12347529176344842,0.964948075491315
14,40,1,55,0.25925925925925924,0.9818181818181818,0.1470352398516984,0.9649961755394152
0,3,59,62,0.0,0.04838709677419355,0.131650624467083,0.8333158674026794
6,189,13,208,0.03076923076923077,0.9375,0.1326980145769731,0.8287163003031123
17,205,11,233,0.07657657657657657,0.9527896995708155,0.111567554671003,0.8248291145275145
33,106,12,151,0.23741007194244604,0.9205298013245033,0.12405470780563817,0.8162773494506228
3,60,2,65,0.047619047619047616,0.9692307692307692,0.11115299539653659,0.8166436498169232
22,199,6,227,0.09954751131221719,0.973568281938326,0.10731167106839683,0.8262605472366841
1,1,65,67,0.5,0.029850746268656716,0.14170320545993123,0.6902651993010377
4,10,1,15,0.2857142857142857,0.9333333333333333,0.18251953199054347,0.8166860902380576
23,62,2,87,0.27058823529411763,0.9770114942528736,0.21677938977981306,0.8223305894170396
2,60,3,65,0.03225806451612903,0.9538461538461539,0.21044817377117767,0.8224815114563737
35,75,32,142,0.3181818181818182,0.7746478873239436,0.22198699466251653,0.8016412380277221
129,458,5,592,0.21976149914821125,0.9915540540540541,0.24657877345239707,0.804830278716763
0,58,1,59,0.0,0.9830508474576272,0.2323577004077946,0.8061849309338059
22,75,9,106,0.2268041237113402,0.9150943396226415,0.19332971808084318,0.9326483014129465
2,0,0,2,1.0,1.0,0.29537053440737376,0.9421721109367562
1,15,1,17,0.0625,0.9411764705882353,0.2656436436510713,0.9370528218418077
9,94,2,105,0.08737864077669903,0.9809523809523809,0.27351801168829554,0.9409251399998403
18,111,21,150,0.13953488372093023,0.86,0.24799702105102586,0.9531182989535626
16,43,4,63,0.2711864406779661,0.9365079365079365,0.25534344126956227,0.9452545678755457
4,24,2,30,0.14285714285714285,0.9333333333333333,0.2757516045348684,0.9381520658577894
1,23,0,24,0.041666666666666664,1.0,0.24596046792989198,0.9515410465261372
28,74,15,117,0.27450980392156865,0.8717948717948718,0.14231901134725894,0.9332260282111189
19,89,2,110,0.17592592592592593,0.9818181818181818,0.15852271505096266,0.9390319869582541
27,96,3,126,0.21951219512195122,0.9761904761904762,0.1787858996522955,0.9383517148494105
112,295,12,419,0.2751842751842752,0.9713603818615751,0.19941662028301613,0.9533079598772547
5,87,13,105,0.05434782608695652,0.8761904761904762,0.1684396753414433,0.9446911798319031
4,35,1,40,0.10256410256410256,0.975,0.16338725649592106,0.9503363411222256
0,12,2,14,0.0,0.8571428571428571,0.15743487554354005,0.9299281778569196
2,12,2,16,0.14285714285714285,0.875,0.1386273525343364,0.9303860533147951
26,228,15,269,0.10236220472440945,0.9442379182156134,0.12811824950554832,0.9250174442287138
34,122,15,171,0.21794871794871795,0.9122807017543859,0.12789489562365786,0.9158874764521296
1,25,0,26,0.038461538461538464,1.0,0.09407736180612403,0.9199788504719045
1,42,83,126,0.023255813953488372,0.3412698412698413,0.08963564578705716,0.8435616169118137
3,41,8,52,0.06818181818181818,0.8461538461538461,0.08472389087530223,0.8251550235052204
11,170,25,206,0.06077348066298342,0.8786407766990292,0.09340581668429988,0.8282261548703878
11,152,2,165,0.06748466257668712,0.9878787878787879,0.08263831950137761,0.844351695995929
13,133,4,150,0.08904109589041095,0.9733333333333334,0.08073530395366356,0.848508183869889
4,112,2,118,0.034482758620689655,0.9830508474576272,0.05452588119251666,0.8586182046846378
46,170,6,222,0.21296296296296297,0.972972972972973,0.07945465612129159,0.8547572008236338
9,92,1,102,0.0891089108910891,0.9901960784313726,0.08886224139809171,0.947460948989567
2,54,5,61,0.03571428571428571,0.9180327868852459,0.08422402247415849,0.9577293690940526
2,29,8,39,0.06451612903225806,0.7948717948717948,0.084758686526912,0.9457623716901619
3,157,4,164,0.01875,0.975609756097561,0.07779659187309955,0.9440096528642724
19,107,14,140,0.15079365079365079,0.9,0.08661838543070524,0.933533462388082
26,94,20,140,0.21666666666666667,0.8571428571428571,0.11264465800870196,0.915546606628829
12,94,2,108,0.11320754716981132,0.9814814814814815,0.09839388432396601,0.9167621078443303
7,58,2,67,0.1076923076923077,0.9701492537313433,0.10104865529556868,0.913898275744326
3,125,4,132,0.0234375,0.9696969696969697,0.09929482876495643,0.921278873288858
11,38,1,50,0.22448979591836735,0.98,0.12214820974868633,0.9477257597357446
17,83,1,101,0.17,0.9900990099009901,0.1437553526058292,0.9497956531362345
4,25,1,30,0.13793103448275862,0.9666666666666667,0.14191783598998745,0.959319462660044
11,76,9,96,0.12643678160919541,0.90625,0.1290278524103487,0.9663347687824929
15,39,1,55,0.2777777777777778,0.9818181818181818,0.15253788535434393,0.9663828688305929
0,3,59,62,0.0,0.04838709677419355,0.13715326996972851,0.8347025606938574
6,189,13,208,0.03076923076923077,0.9375,0.13820066007961862,0.8301029935942903
18,204,11,233,0.08108108108108109,0.9527896995708155,0.11771370081714916,0.8262158078186924
33,106,12,151,0.23741007194244604,0.9205298013245033,0.12734371109464146,0.8162773494506228
4,59,2,65,0.06349206349206349,0.9692307692307692,0.116709572381685,0.8166436498169232
21,201,6,228,0.0945945945945946,0.9736842105263158,0.11216068852245631,0.8262771084635397
1,1,65,67,0.5,0.029850746268656716,0.14390672026848805,0.6902817605278934
4,10,1,15,0.2857142857142857,0.9333333333333333,0.18472304679910032,0.8167026514649133
23,62,2,87,0.27058823529411763,0.9770114942528736,0.21898290458836986,0.8223471506438952
2,60,3,65,0.03225806451612903,0.9538461538461539,0.21200818793623386,0.8224980726832294
35,75,33,143,0.3181818181818182,0.7692307692307693,0.2235470088275727,0.8008839252412673
127,460,5,592,0.21635434412265758,0.9915540540540541,0.24538447748908615,0.804072965930308
0,58,1,59,0.0,0.9830508474576272,0.23187096397557266,0.8054110569204953
22,75,9,106,0.2268041237113402,0.9150943396226415,0.19284298164862124,0.931874427399636
2,0,0,2,1.0,1.0,0.29488379797515185,0.9413982369234455
1,15,1,17,0.0625,0.9411764705882353,0.2651569072188493,0.9362789478284972
8,95,2,105,0.07766990291262135,0.9809523809523809,0.27164431270406253,0.9401512659865296
17,112,21,150,0.13178294573643412,0.86,0.24501590235472195,0.9531182989535626
16,43,4,63,0.2711864406779661,0.9365079365079365,0.2528490590054803,0.9452545678755457
4,25,2,31,0.13793103448275862,0.9354838709677419,0.27255349250301725,0.9384592855198478
1,23,0,24,0.041666666666666664,1.0,0.2431865428258698,0.9515410465261372
28,73,16,117,0.27722772277227725,0.8632478632478633,0.13993336036476656,0.9320050269901178
17,91,2,110,0.1574074074074074,0.9818181818181818,0.15349156142296763,0.9378109857372529
26,97,3,126,0.21138211382113822,0.9761904761904762,0.17536723094249224,0.9371307136284094
111,296,12,419,0.2727272727272727,0.9713603818615751,0.1956469512222125,0.9520869586562534
6,86,13,105,0.06521739130434782,0.8761904761904762,0.1662228013116956,0.943470178610902
4,35,1,40,0.10256410256410256,0.975,0.1611703824661733,0.9491153399012245
0,12,2,14,0.0,0.8571428571428571,0.15521800151379234,0.9287071766359184
2,12,2,16,0.14285714285714285,0.875,0.13602220438305884,0.930386053314795
29,225,15,269,0.1141732283464567,0.9442379182156134,0.1298458930886373,0.9250174442287139
36,120,15,171,0.23076923076923078,0.9122807017543859,0.13261548122407912,0.9158874764521295
2,24,0,26,0.07692307692307693,1.0,0.10464345325205114,0.9199788504719046
1,45,80,126,0.021739130434782608,0.36507936507936506,0.09843227312782755,0.8469629774560314
3,41,8,52,0.06818181818181818,0.8461538461538461,0.09352051821607264,0.8285563840494381
9,174,23,206,0.04918032786885246,0.8883495145631068,0.10054627934019443,0.8330144779666168
13,150,2,165,0.07975460122699386,0.9878787878787879,0.09153163053588743,0.8491400190921577
15,131,4,150,0.10273972602739725,0.9733333333333334,0.08989827306173608,0.8532965069661177
7,109,2,118,0.0603448275862069,0.9830508474576272,0.06555192974987552,0.8634065277808665
46,170,6,222,0.21296296296296297,0.972972972972973,0.08498619918414496,0.8595455239198627
9,92,1,102,0.0891089108910891,0.9901960784313726,0.0946104535350459,0.948847911541578
3,53,5,61,0.05357142857142857,0.9180327868852459,0.09252325501927593,0.9591163316460637
1,30,8,39,0.03225806451612903,0.7948717948717948,0.09010578882602974,0.9457623716901619
2,158,4,164,0.0125,0.975609756097561,0.0804979886507449,0.9440096528642724
19,107,14,140,0.15079365079365079,0.9,0.08736283504592397,0.933533462388082
28,92,20,140,0.23333333333333334,0.8571428571428571,0.1120754787240849,0.915546606628829
12,94,2,108,0.11320754716981132,0.9814814814814815,0.09782470503934894,0.9167621078443303
8,58,1,67,0.12121212121212122,0.9850746268656716,0.10241087794235353,0.916030471906373
3,125,4,132,0.0234375,0.9696969696969697,0.09810603100357802,0.923411069450905
11,38,1,50,0.22448979591836735,0.98,0.1255677069181835,0.9498579558977914
17,83,1,101,0.17,0.9900990099009901,0.1480677069181835,0.9519278492982812
5,24,1,30,0.1724137931034483,0.9666666666666667,0.151156298676726,0.9614516588220907
11,77,8,96,0.125,0.9166666666666666,0.1356801082005355,0.9699550601826351
15,39,1,55,0.2777777777777778,0.9818181818181818,0.15919014114453073,0.970003160230735
0,3,59,62,0.0,0.04838709677419355,0.14187412382851342,0.8361906559319525
6,189,13,208,0.03076923076923077,0.9375,0.14292151393840352,0.8315910888323854
17,205,11,233,0.07657657657657657,0.9527896995708155,0.1217910540324334,0.8277039030567878
33,106,12,151,0.23741007194244604,0.9205298013245033,0.1314210643099257,0.8177654446887181
3,55,7,65,0.05172413793103448,0.8923076923076924,0.11417968499958087,0.8071427340660076
25,197,6,228,0.11261261261261261,0.9736842105263158,0.11241005822995409,0.8152880974745288
1,2,64,67,0.3333333333333333,0.04477611940298507,0.12034656616646204,0.6814249457009293
5,9,1,15,0.35714285714285715,0.9333333333333333,0.17136697432972733,0.8078458366379493
23,62,2,87,0.27058823529411763,0.9770114942528736,0.2056268321189969,0.8134903358169312
2,60,3,65,0.03225806451612903,0.9538461538461539,0.19929561611036153,0.8136412578562652
35,75,33,143,0.3181818181818182,0.7692307692307693,0.2108344370017004,0.7920271104143033
131,456,5,592,0.2231686541737649,0.9915540540540541,0.2353265107506619,0.8062051620923548
0,58,1,59,0.0,0.9830508474576272,0.2192389946631458,0.8075432530825422
23,74,9,106,0.23711340206185566,0.9150943396226415,0.20549329019579185,0.931874427399636
2,0,0,2,1.0,1.0,0.2973300248896694,0.9413982369234455
1,15,1,17,0.0625,0.9411764705882353,0.2676031341333669,0.9362789478284972
8,95,2,105,0.07766990291262135,0.9809523809523809,0.2740905396185801,0.9401512659865296
17,113,20,150,0.13076923076923078,0.8666666666666667,0.24731731284535327,0.9540706799059435
16,43,4,63,0.2711864406779661,0.9365079365079365,0.25417699663166776,0.9462069488279268
4,25,2,31,0.13793103448275862,0.9354838709677419,0.2738814301292047,0.9394116664722288
1,23,0,24,0.041666666666666664,1.0,0.24208764172696867,0.9515410465261372
28,73,16,117,0.27722772277227725,0.8632478632478633,0.13883445926586546,0.9320050269901177
20,88,2,110,0.18518518518518517,0.9818181818181818,0.1563609142923205,0.9378109857372529
27,96,3,126,0.21951219512195122,0.9761904761904762,0.17939802399767552,0.9371307136284094
113,294,12,419,0.27764127764127766,0.9713603818615751,0.2014786460782976,0.9520869586562534
5,87,13,105,0.05434782608695652,0.8761904761904762,0.17050170113672478,0.9434701786109019
4,35,1,40,0.10256410256410256,0.975,0.16544928229120254,0.9491153399012245
0,12,2,14,0.0,0.8571428571428571,0.15949690133882152,0.9287071766359184
2,12,2,16,0.14285714285714285,0.875,0.14030110420808808,0.9303860533147951
30,224,15,269,0.11811023622047244,0.9442379182156134,0.13071896864170054,0.9250174442287139
38,118,15,171,0.24358974358974358,0.9122807017543859,0.1341586184228137,0.9158874764521296
1,25,0,26,0.038461538461538464,1.0,0.09999008425427955,0.9199788504719046
2,43,81,126,0.044444444444444446,0.35714285714285715,0.0985753154482064,0.8458291906079589
4,40,8,52,0.09090909090909091,0.8461538461538461,0.09691031378320474,0.8274225972013655
10,173,23,206,0.0546448087431694,0.8883495145631068,0.10471671503222893,0.831880691118544
13,150,2,165,0.07975460122699386,0.9878787878787879,0.09570206622792192,0.8480062322440851
12,134,4,150,0.0821917808219178,0.9733333333333334,0.0905708583138427,0.8521627201180452
5,111,2,118,0.04310344827586207,0.9830508474576272,0.0619299589832882,0.8622727409327939
46,170,6,222,0.21296296296296297,0.972972972972973,0.08685873391206313,0.85841173707179
9,92,1,102,0.0891089108910891,0.9901960784313726,0.09323937197586951,0.948847911541578
3,53,5,61,0.05357142857142857,0.9180327868852459,0.08790542021334632,0.9591163316460637
2,29,8,39,0.06451612903225806,0.7948717948717948,0.08931560882607327,0.9457623716901619
2,158,4,164,0.0125,0.975609756097561,0.07970780865078843,0.9440096528642724
19,107,14,140,0.15079365079365079,0.9,0.08950807578960743,0.933533462388082
26,94,20,140,0.21666666666666667,0.8571428571428571,0.11430282127400808,0.915546606628829
13,93,2,108,0.12264150943396226,0.9814814814814815,0.10139975648415085,0.9167621078443303
7,59,1,67,0.10606060606060606,0.9850746268656716,0.10382142722265328,0.916030471906373
3,124,5,132,0.023622047244094488,0.9621212121212122,0.09954294417589127,0.9223288183686539
10,39,1,50,0.20408163265306123,0.98,0.11948087326457742,0.9487757048155404
17,83,1,101,0.17,0.9900990099009901,0.14198087326457742,0.9508455982160303
5,24,1,30,0.1724137931034483,0.9666666666666667,0.14506946502311993,0.9603694077398398
11,76,9,96,0.12643678160919541,0.90625,0.13217948144348118,0.9673847138622887
15,39,1,55,0.2777777777777778,0.9818181818181818,0.1543418054925977,0.9674328139103887
0,3,59,62,0.0,0.04838709677419355,0.13919029034108252,0.8336203096116063
6,189,13,208,0.03076923076923077,0.9375,0.14021131655895916,0.8301029935942902
18,204,11,233,0.08108108108108109,0.9527896995708155,0.1226398091915334,0.8262158078186924
34,105,12,151,0.2446043165467626,0.9205298013245033,0.13329756869821377,0.8162773494506228
2,57,6,65,0.03389830508474576,0.9076923076923077,0.11350964183839914,0.8078524410257144
23,199,6,228,0.1036036036036036,0.9736842105263158,0.11024775926617172,0.817485899672331
1,2,64,67,0.3333333333333333,0.04477611940298507,0.11818426720267965,0.6836227478987315
4,10,1,15,0.2857142857142857,0.9333333333333333,0.1590005937332919,0.8100436388357514
25,60,2,87,0.29411764705882354,0.9770114942528736,0.19662179606037658,0.8156881380147334
2,60,3,65,0.03225806451612903,0.9538461538461539,0.18964707940824058,0.8158390600540674
35,74,34,143,0.3211009174311927,0.7622377622377622,0.20057516524887342,0.7932259116131044
137,450,5,592,0.23339011925042588,0.9915540540540541,0.22907399584397056,0.8052061610933539
0,58,1,59,0.0,0.9830508474576272,0.2142734810434558,0.8065442520835412
23,74,9,106,0.23711340206185566,0.9150943396226415,0.20052777657610182,0.930875426400635
2,0,0,2,1.0,1.0,0.30256859290263244,0.9403992359244445
1,15,1,17,0.0625,0.9411764705882353,0.2694803576085148,0.9352799468294961
6,97,2,105,0.05825242718446602,0.9809523809523809,0.2731938379897058,0.9391522649875286
17,113,20,150,0.13076923076923078,0.8666666666666667,0.24600359703799698,0.9540706799059436
16,43,4,63,0.2711864406779661,0.9365079365079365,0.25140307152764557,0.9462069488279267
4,25,2,31,0.13793103448275862,0.9354838709677419,0.2711075050251825,0.9394116664722288
1,23,0,24,0.041666666666666664,1.0,0.24899212817625058,0.9482533197470667
30,74,13,117,0.28846153846153844,0.8888888888888888,0.1473437765278989,0.9323803038740508
20,88,2,110,0.18518518518518517,0.9818181818181818,0.16487023155435396,0.9381862626211861
25,97,3,125,0.20491803278688525,0.976,0.18492764637644354,0.9377652099896071
111,298,10,419,0.2713936430317848,0.9761336515513126,0.20362732855689925,0.9554824922031749
7,85,13,105,0.07608695652173914,0.8761904761904762,0.17293845221584897,0.9474806473974561
4,35,1,40,0.10256410256410256,0.975,0.1671823036025575,0.9534330283498369
0,13,1,14,0.0,0.9285714285714286,0.16122992265017655,0.9432289467171839
2,13,1,16,0.13333333333333333,0.9375,0.13906875048900438,0.9501733911616285
31,223,15,269,0.1220472440944882,0.9442379182156134,0.13004904461890482,0.9448047820755471
37,119,15,171,0.23717948717948717,0.9122807017543859,0.13465782381784797,0.9357020251833166
2,24,0,26,0.07692307692307693,1.0,0.10687631437374681,0.9391115035331291
1,68,57,126,0.014492753623188406,0.5476190476190477,0.09807714253109671,0.8921727280229249
4,47,1,52,0.0784313725490196,0.9807692307692307,0.09462960967179915,0.8929969038471007
10,172,23,205,0.054945054945054944,0.8878048780487805,0.10247890323537844,0.8871731109152938
12,151,2,165,0.0736196319018405,0.9878787878787879,0.0939483744594509,0.8943700806122636
14,133,3,150,0.09523809523809523,0.98,0.09011849605139474,0.8994789494386045
5,111,2,118,0.04310344827586207,0.9830508474576272,0.062393347636591164,0.9095889702533533
46,170,6,222,0.21296296296296297,0.972972972972973,0.0818276170708606,0.9057279663923493
9,92,1,102,0.0891089108910891,0.9901960784313726,0.09248706810913213,0.9689532565083958
2,58,1,61,0.03333333333333333,0.9836065573770492,0.0860444910783198,0.9693585888809413
0,31,8,39,0.0,0.7948717948717948,0.07819519751474051,0.956082434141372
2,158,4,164,0.0125,0.975609756097561,0.0694638215287633,0.9543297153154823
19,107,14,140,0.15079365079365079,0.9,0.07740032946527124,0.942901143886911
28,92,20,140,0.23333333333333334,0.8571428571428571,0.10457602733062428,0.9249142881276581
13,93,2,108,0.12264150943396226,0.9814814814814815,0.09167296254076704,0.9261297893431594
7,58,1,66,0.1076923076923077,0.9848484848484849,0.09432773351236969,0.9253658474027467
4,124,4,132,0.03125,0.9696969696969697,0.09403011446475064,0.9233787634484497
11,38,1,50,0.22448979591836735,0.98,0.1261000853102317,0.9498256498953362
17,83,1,101,0.17,0.9900990099009901,0.1486000853102317,0.9518955432958262
5,24,1,30,0.1724137931034483,0.9666666666666667,0.1516886770687742,0.9614193528196356
12,80,4,96,0.13043478260869565,0.9583333333333334,0.13698888410811166,0.9758751351325607
15,39,1,55,0.2777777777777778,0.9818181818181818,0.1591512081572282,0.9759232351806608
0,3,59,62,0.0,0.04838709677419355,0.1437665927726128,0.8421430368843336
6,193,9,208,0.03015075376884422,0.9567307692307693,0.14360955759673338,0.8402907225320192
20,203,10,233,0.08968609865470852,0.9570815450643777,0.12435188655906784,0.837016657541216
34,114,3,151,0.22972972972972974,0.9801324503311258,0.13288470509188638,0.8355928633169496
2,56,7,65,0.034482758620689655,0.8923076923076924,0.11318027159434943,0.824970152694239
26,196,6,228,0.11711711711711711,0.9736842105263158,0.11127774795269536,0.8271631351503793
8,58,1,67,0.12121212121212122,0.9850746268656716,0.088911225586173,0.827628341585735
4,9,2,15,0.3076923076923077,0.8666666666666667,0.13286726954221695,0.9445254229989455
25,60,2,87,0.29411764705882354,0.9770114942528736,0.1705768257264997,0.9474226694306748
3,59,3,65,0.04838709677419355,0.9538461538461539,0.16467696831499756,0.946960470685214
36,77,29,142,0.3185840707964602,0.795774647887324,0.17737044561024476,0.9206236417646709
139,448,5,592,0.23679727427597955,0.9915540540540541,0.20627251927528617,0.9348016934427227
0,58,1,59,0.0,0.9830508474576272,0.18954150254426946,0.9361397844329101
23,74,9,106,0.23711340206185566,0.9150943396226415,0.20609882837994584,0.9261426005410486
2,0,0,2,1.0,1.0,0.30499992728104475,0.9451902195886677
1,15,1,17,0.0625,0.9411764705882353,0.27191169198692705,0.9400709304937191
6,97,2,105,0.05825242718446602,0.9809523809523809,0.2733210249026803,0.9439432486517517
16,114,20,150,0.12307692307692308,0.8666666666666667,0.24539143237131783,0.9540706799059436
16,43,4,63,0.2711864406779661,0.9365079365079365,0.2503041704287445,0.9462069488279268
4,25,2,31,0.13793103448275862,0.9354838709677419,0.2700086039262814,0.9394116664722288
1,21,0,22,0.045454545454545456,1.0,0.24576004387879183,0.9502653921816743
29,65,14,108,0.30851063829787234,0.8703703703703703,0.14697584934991645,0.9317468736631558
19,68,2,89,0.21839080459770116,0.9775280898876404,0.16924596429244518,0.9369399621344995
25,76,3,104,0.24752475247524752,0.9711538461538461,0.19999834828660498,0.9358266018106127
111,258,12,381,0.3008130081300813,0.968503937007874,0.22206571181738313,0.9504418523690816
4,79,13,96,0.04819277108433735,0.8645833333333334,0.18739195184241836,0.9407818442980567
4,28,1,33,0.125,0.9696969696969697,0.18484093143425512,0.945976649492862
0,12,2,14,0.0,0.8571428571428571,0.17834742494074862,0.9255684862275558
0,9,1,10,0.0,0.9,0.13427447661248113,0.92980129046036
29,185,15,229,0.13551401869158877,0.9344978165938864,0.12243493576875077,0.9236541085612523
36,103,15,154,0.2589928057553957,0.9025974025974026,0.12407322909448623,0.9138603309103317
2,22,0,24,0.08333333333333333,1.0,0.09300470412352223,0.9183597684806355
1,40,81,122,0.024390243902439025,0.3360655737704918,0.08960434309753675,0.8428572314002295
3,37,8,48,0.075,0.8333333333333334,0.08246148595467961,0.8233767119197101
11,155,22,188,0.06626506024096386,0.8829787234042553,0.09192792313196016,0.8270675499570527
10,123,2,135,0.07518796992481203,0.9851851851851852,0.10266906169264758,0.8392368621263647
12,125,4,141,0.08759124087591241,0.9716312056737588,0.0958229505761224,0.844541631994918
5,96,2,103,0.04950495049504951,0.9805825242718447,0.06589611411035866,0.8556823636626955
46,170,6,222,0.21296296296296297,0.972972972972973,0.08441463262887718,0.8518213598016916
6,72,1,79,0.07692307692307693,0.9873417721518988,0.09191932306039687,0.9448608167133211
2,46,5,53,0.041666666666666664,0.9056603773584906,0.08715741829849212,0.9551932515740579
2,27,8,37,0.06896551724137931,0.7837837837837838,0.08754319786998004,0.9410225459139906
2,152,4,158,0.012987012987012988,0.9746835443037974,0.07865734687886587,0.9395223115023638
19,97,15,131,0.16379310344827586,0.8854961832061069,0.08954332724634638,0.9272173082926992
23,80,21,124,0.22330097087378642,0.8306451612903226,0.11437133015759451,0.9057976850096247
12,86,2,100,0.12244897959183673,0.98,0.10144076110457648,0.9068015460134856
6,58,1,65,0.09375,0.9846153846153847,0.10384460725842264,0.9064120620796979
4,111,4,119,0.034782608695652174,0.9663865546218487,0.10286117040542056,0.9150872302601777
10,36,1,47,0.21739130434782608,0.9787234042553191,0.12406485427777011,0.942935747470397
17,82,1,100,0.1717171717171717,0.99,0.14674059123922137,0.9451238125698544
5,22,1,28,0.18518518518518517,0.9642857142857143,0.1497966029159227,0.9563794598669412
11,56,11,78,0.16417910447761194,0.8589743589743589,0.14135062200218346,0.9604264881075179
16,36,1,53,0.3076923076923077,0.9811320754716981,0.16781395458796503,0.9605882131749033
0,1,59,60,0.0,0.016666666666666666,0.15442109744510787,0.822309824896515
6,162,13,181,0.03571428571428571,0.9281767955801105,0.15455419416205554,0.8168512878905524
17,172,11,200,0.08994708994708994,0.945,0.13634787781909324,0.812033658711221
33,96,12,141,0.2558139534883721,0.9148936170212766,0.14836170378640756,0.8013041754285464
1,55,7,63,0.017857142857142856,0.8888888888888888,0.12445769773954439,0.7905332003718569
22,182,6,210,0.10784313725490197,0.9714285714285714,0.11640970242201439,0.8065980878653158
1,2,64,67,0.3333333333333333,0.04477611940298507,0.12007270608501805,0.6728329512840711
4,9,2,15,0.3076923076923077,0.8666666666666667,0.16402875004106202,0.7942615227126426
23,44,2,69,0.34328358208955223,0.9710144927536232,0.20796722095181436,0.8003811937374301
1,59,3,63,0.016666666666666666,0.9523809523809523,0.19749858905461104,0.8014356155061376
36,73,33,142,0.3302752293577982,0.7676056338028169,0.20813591417881477,0.7803944750463577
141,443,5,589,0.24143835616438356,0.9915110356536503,0.24007608750842055,0.7950547817270379
0,52,1,53,0.0,0.9811320754716981,0.22466992504343458,0.7964409965903416
23,64,9,96,0.26436781609195403,0.90625,0.21481770829466612,0.9195086938184867
2,0,0,2,1.0,1.0,0.313718807195765,0.9385563128661057
1,15,1,17,0.0625,0.9411764705882353,0.27360686689725755,0.9342937382710502
6,87,2,95,0.06451612903225806,0.9789473684210527,0.28044250437805635,0.9380889405624931
17,104,21,142,0.14049586776859505,0.852112676056338,0.25333116700817015,0.950161375170139
16,39,4,59,0.2909090909090909,0.9322033898305084,0.26039841482884263,0.9416888543382617
4,24,2,30,0.14285714285714285,0.9333333333333333,0.2808065780941488,0.9348604626042096
1,21,0,22,0.045454545454545456,1.0,0.24584522646586462,0.9445409958855336
29,65,14,108,0.30851063829787234,0.8703703703703703,0.14706103193698924,0.926022477367015
20,68,2,90,0.22727272727272727,0.9777777777777777,0.17059999297595027,0.9312512355369497
26,74,3,103,0.26,0.970873786407767,0.19793892855017997,0.9298376006281691
112,257,13,382,0.3035230352303523,0.9659685863874345,0.22344221929737315,0.9459283510644694
6,77,13,96,0.07228915662650602,0.8645833333333334,0.19502832157573602,0.9356534077538117
4,28,1,33,0.125,0.9696969696969697,0.19172144326885768,0.9456101177105216
0,12,2,14,0.0,0.8571428571428571,0.18522793677535118,0.9252019544452156
1,8,2,11,0.1111111111111111,0.8181818181818182,0.15702800432009958,0.9177464469897082
28,186,15,229,0.1308411214953271,0.9344978165938864,0.14325206063761384,0.9115635953920094
38,101,15,154,0.2733812949640288,0.9025974025974026,0.1451636742039037,0.9018098262762431
2,22,0,24,0.08333333333333333,1.0,0.11370800250432954,0.9066714567923239
1,44,77,122,0.022222222222222223,0.36885245901639346,0.10655558330371757,0.8358527604613324
2,38,8,48,0.05,0.8333333333333334,0.09584129758943186,0.8163722409808128
11,153,23,187,0.06707317073170732,0.8770053475935828,0.10542317912253289,0.8192097396166308
10,123,2,135,0.07518796992481203,0.9851851851851852,0.10029130181020447,0.8430673634742547
12,126,3,141,0.08695652173913043,0.9787234042553191,0.09402207327360494,0.8493853045687451
4,97,2,103,0.039603960396039604,0.9805825242718447,0.06062531119246362,0.8605260362365225
46,170,6,222,0.21296296296296297,0.972972972972973,0.07914382971098215,0.8566650323755187
6,72,1,79,0.07692307692307693,0.9873417721518988,0.08695823752538996,0.9450206485377338
2,46,5,53,0.041666666666666664,0.9056603773584906,0.08576776133491378,0.9553530833984704
2,27,8,37,0.06896551724137931,0.7837837837837838,0.08603809655058119,0.9420357171399277
2,152,4,158,0.012987012987012988,0.9746835443037974,0.07715224555946705,0.9405354827283009
19,98,14,131,0.1623931623931624,0.8931297709923665,0.08792890851004305,0.9283078208335934
23,84,20,127,0.21495327102803738,0.84251968503937,0.11297881002889987,0.9085845580860971
11,87,2,100,0.11224489795918367,0.98,0.09859051502835998,0.9095884190899579
7,57,1,65,0.109375,0.9846153846153847,0.10322650403934898,0.9091989351561702
2,113,4,119,0.017391304347826087,0.9663865546218487,0.09975859513665748,0.91787410333665
10,36,1,47,0.21739130434782608,0.9787234042553191,0.12096227900900701,0.9457226205468695
17,82,1,100,0.1717171717171717,0.99,0.14363801597045825,0.9479106856463267
4,23,1,28,0.14814814814814814,0.9642857142857143,0.1416030139354562,0.9580758204025194
11,57,10,78,0.16176470588235295,0.8717948717948718,0.13400464748607271,0.9622579899390197
13,39,1,53,0.25,0.9811320754716981,0.15368394777761793,0.9624197150064051
0,1,59,60,0.0,0.016666666666666666,0.1380589477776179,0.8241413267280169
5,163,13,181,0.02976190476190476,0.9281767955801105,0.13982617640820058,0.8186827897220542
18,171,11,200,0.09523809523809523,0.945,0.12237571796395331,0.8138651605427228
32,98,11,141,0.24615384615384617,0.9219858156028369,0.13300952859776397,0.8041488484859852
1,55,7,63,0.017857142857142856,0.8888888888888888,0.11439652784190606,0.7933778734292961
26,179,6,211,0.12682926829268293,0.9715639810426541,0.10940575104338178,0.8076306033218363
1,1,65,67,0.5,0.029850746268656716,0.1451200367576675,0.6717332705785447
4,10,1,15,0.2857142857142857,0.9333333333333333,0.18593636328827973,0.8026856515309256
23,44,2,69,0.34328358208955223,0.9710144927536232,0.23072517433508652,0.8088053225557131
1,59,3,63,0.016666666666666666,0.9523809523809523,0.21950068453916813,0.8098597443244208
37,72,33,142,0.3394495412844037,0.7676056338028169,0.23282864098639064,0.7878054326387035
139,445,5,589,0.238013698630137,0.9915110356536503,0.26427957752538983,0.8024657393193836
0,52,1,53,0.0,0.9811320754716981,0.24616111062643511,0.8038326099521041
23,64,9,96,0.26436781609195403,0.90625,0.21249937006814282,0.9290325033422963
2,0,0,2,1.0,1.0,0.31454018639467346,0.9385563128661057
1,15,1,17,0.0625,0.9411764705882353,0.27442824609616595,0.9342937382710502
3,90,2,95,0.03225806451612903,0.9789473684210527,0.2766555886460892,0.9380889405624931
18,105,19,142,0.14634146341463414,0.8661971830985915,0.24906872037897923,0.9521734476047466
16,39,4,59,0.2909090909090909,0.9322033898305084,0.25662520499025837,0.9437009267728694
4,24,2,30,0.14285714285714285,0.9333333333333333,0.27703336825556446,0.9368725350388172
1,22,0,23,0.043478260869565216,1.0,0.24867621668973444,0.9435886149331526
30,74,13,117,0.28846153846153844,0.8888888888888888,0.1470278650413828,0.9277155990601368
18,91,2,111,0.1651376146788991,0.9819819819819819,0.16169038142408265,0.933544957830672
24,99,3,126,0.1951219512195122,0.9761904761904762,0.17695990386720625,0.9328908500337071
115,291,13,419,0.2832512315270936,0.9689737470167065,0.2016763340178709,0.9503632900837128
4,88,13,105,0.043478260869565216,0.8761904761904762,0.16672528653918892,0.9417465100383612
4,35,1,40,0.10256410256410256,0.975,0.16021328002718244,0.952460795752647
0,12,2,14,0.0,0.8571428571428571,0.15400209990295882,0.9320526324873409
1,13,2,16,0.07142857142857142,0.875,0.12299739032682068,0.9300685055032138
29,225,15,269,0.1141732283464567,0.9442379182156134,0.11571676370790034,0.9246764963937325
37,119,15,171,0.23717948717948717,0.9122807017543859,0.1217249831307539,0.9155465286171482
1,21,4,26,0.045454545454545456,0.8461538461538461,0.08775402797753273,0.8980008284938824
1,41,84,126,0.023809523809523808,0.3333333333333333,0.08494420839752682,0.8204498080857193
5,39,8,52,0.11363636363636363,0.8461538461538461,0.08652595997927841,0.8020432146791258
11,170,25,206,0.06077348066298342,0.8786407766990292,0.09520788578827603,0.8051143460442933
12,151,2,165,0.0736196319018405,0.9878787878787879,0.09552089442731448,0.8212398871698345
14,133,3,150,0.09523809523809523,0.98,0.09281587541183427,0.8263487559961754
4,112,2,118,0.034482758620689655,0.9830508474576272,0.06385919990343462,0.8364587768109242
46,170,6,222,0.21296296296296297,0.972972972972973,0.08778897383320856,0.8545757949279423
8,93,1,102,0.07920792079207921,0.9901960784313726,0.09570303054500218,0.9484133299419478
5,51,5,61,0.08928571428571429,0.9180327868852459,0.09222436635205229,0.9586817500464335
2,29,8,39,0.06451612903225806,0.7948717948717948,0.09275903040480579,0.9467147526425429
2,158,4,164,0.0125,0.975609756097561,0.08402765441882858,0.9449620338166532
18,108,14,140,0.14285714285714285,0.9,0.09083037550726394,0.933533462388082
25,95,20,140,0.20833333333333334,0.8571428571428571,0.11566617189478448,0.915546606628829
13,93,2,108,0.12264150943396226,0.9814814814814815,0.10276310710492723,0.9167621078443303
7,59,1,67,0.10606060606060606,0.9850746268656716,0.10659920500043107,0.916030471906373
3,125,4,132,0.0234375,0.9696969696969697,0.09719231724532904,0.923411069450905
10,39,1,50,0.20408163265306123,0.98,0.11713024633401521,0.9498579558977915
16,84,1,101,0.16,0.9900990099009901,0.13820167490544377,0.9519278492982813
4,25,1,30,0.13793103448275862,0.9666666666666667,0.1374979451376746,0.9614516588220908
12,75,9,96,0.13793103448275862,0.90625,0.1274404738733068,0.9684669649445399
15,39,1,55,0.2777777777777778,0.9818181818181818,0.1496027979224233,0.9685150649926398
0,3,59,62,0.0,0.04838709677419355,0.13445128277090815,0.8347025606938574
6,189,13,208,0.03076923076923077,0.9375,0.13549867288079825,0.8301029935942902
18,205,11,234,0.08071748878923767,0.9529914529914529,0.11787522375739488,0.8262446297359263
32,106,13,151,0.2318840579710145,0.9139072847682119,0.12814437489611125,0.8153600975741008
2,61,2,65,0.031746031746031744,0.9692307692307692,0.11297508879086456,0.8157263979404011
27,196,6,229,0.1210762331838565,0.9737991266375546,0.11056726003387851,0.8253762731743376
1,1,65,67,0.5,0.029850746268656716,0.14231329177991026,0.6893809252386911
3,10,2,15,0.23076923076923078,0.8666666666666667,0.17528032474694322,0.8062780066519016
24,61,2,87,0.2823529411764706,0.9770114942528736,0.21122085480512034,0.8119225058308835
2,60,3,65,0.03225806451612903,0.9538461538461539,0.20429807990896198,0.8120446059529838
35,74,33,142,0.3211009174311927,0.7676056338028169,0.21704334554613025,0.7911443701007844
136,451,5,592,0.23168654173764908,0.9915540540540541,0.24560627554493278,0.7943334107898251
0,58,1,59,0.0,0.9830508474576272,0.22830967080438183,0.7956550851926926
22,75,9,106,0.2268041237113402,0.9150943396226415,0.1892816884774304,0.9221184556718333
2,0,0,2,1.0,1.0,0.2991717983675403,0.9411660747194522
1,15,1,17,0.0625,0.9411764705882353,0.26776423534233024,0.936046785624504
7,95,2,104,0.06862745098039216,0.9807692307692307,0.2729598619800821,0.9398929394706579
16,112,22,150,0.125,0.8533333333333334,0.24494544520419742,0.9521397536893029
16,43,4,63,0.2711864406779661,0.9365079365079365,0.25058828790995696,0.9442760226112863
4,23,3,30,0.14814814814814814,0.9,0.2717523090739782,0.9324116158316252
1,23,0,24,0.041666666666666664,1.0,0.24708999658848393,0.9515148822142586
29,75,13,117,0.27884615384615385,0.8888888888888888,0.14406801856650595,0.9356418663412427
18,91,2,111,0.1651376146788991,0.9819819819819819,0.15873053494920583,0.9414712251117779
27,96,3,126,0.21951219512195122,0.9761904761904762,0.18028549839799998,0.940817117314813
114,292,13,419,0.28078817733990147,0.9689737470167065,0.20171677647952438,0.9554324145076759
4,88,13,105,0.043478260869565216,0.8761904761904762,0.16676572900084238,0.9468156344623244
4,35,1,40,0.10256410256410256,0.975,0.16171331015532012,0.952460795752647
0,12,2,14,0.0,0.8571428571428571,0.15576092920293916,0.9320526324873407
1,13,2,16,0.07142857142857142,0.875,0.12612984600042737,0.9300685055032137
30,224,15,269,0.11811023622047244,0.9442379182156134,0.119411649077795,0.9246764963937327
36,120,15,171,0.23076923076923078,0.9122807017543859,0.12101979702740635,0.9155465286171484
1,25,0,26,0.038461538461538464,1.0,0.08640170575906878,0.9199788504719046
1,41,84,126,0.023809523809523808,0.3333333333333333,0.08359188617906287,0.8424278300637412
5,39,8,52,0.11363636363636363,0.8461538461538461,0.08517363776081444,0.8240212366571479
12,171,23,206,0.06557377049180328,0.8883495145631068,0.09454131925964349,0.8284793305743262
13,150,2,165,0.07975460122699386,0.9878787878787879,0.09573075208798955,0.8446048716998674
14,133,3,150,0.09523809523809523,0.98,0.09246330337622137,0.8497137405262085
4,112,2,118,0.034482758620689655,0.9830508474576272,0.06442237878357264,0.8598237613409572
46,170,6,222,0.21296296296296297,0.972972972972973,0.08935115371234757,0.8559627574799533
7,94,1,102,0.06930693069306931,0.9901960784313726,0.09585078326713979,0.9498002924939589
3,53,5,61,0.05357142857142857,0.9180327868852459,0.08727007825786334,0.9600687125984447
2,29,8,39,0.06451612903225806,0.7948717948717948,0.08711898662078546,0.946714752642543
2,158,4,164,0.0125,0.975609756097561,0.07751118644550062,0.9449620338166534
18,108,14,140,0.14285714285714285,0.9,0.08431390753393599,0.933533462388082
26,93,21,140,0.2184873949579832,0.85,0.11060028415354936,0.9145261984655637
13,93,2,108,0.12264150943396226,0.9814814814814815,0.09769721936369212,0.9157416996810649
7,59,1,67,0.10606060606060606,0.9850746268656716,0.10294774441619738,0.9150100637431077
3,125,4,132,0.0234375,0.9696969696969697,0.09864289747742186,0.9223906612876397
11,38,1,50,0.22448979591836735,0.98,0.12149627846115177,0.9488375477345261
17,83,1,101,0.17,0.9900990099009901,0.14399627846115176,0.9509074411350159
5,24,1,30,0.1724137931034483,0.9666666666666667,0.14821865706776682,0.9604312506588256
11,77,8,96,0.125,0.9166666666666666,0.13486331493091205,0.9699550601826351
16,38,1,55,0.2962962962962963,0.9818181818181818,0.1596711416255312,0.9700031602307352
0,3,59,62,0.0,0.04838709677419355,0.14451962647401606,0.8361906559319525
5,190,13,208,0.02564102564102564,0.9375,0.14483441585130544,0.8315910888323854
18,205,11,234,0.08071748878923767,0.9529914529914529,0.12429551483285835,0.8277327249740215
32,107,12,151,0.2302158273381295,0.9205298013245033,0.13289777588116256,0.817794266605952
2,61,2,65,0.031746031746031744,0.9692307692307692,0.11280238140153163,0.8181605669722524
23,200,6,229,0.1031390134529148,0.9737991266375546,0.1096793833233766,0.8263223469680935
1,1,65,67,0.5,0.029850746268656716,0.1387799124239057,0.6903269990324471
3,11,1,15,0.21428571428571427,0.9333333333333333,0.16939215732186488,0.816747889969467
24,60,3,87,0.2857142857142857,0.9655172413793104,0.20654548018947347,0.8207503530236542
0,62,3,65,0.0,0.9538461538461539,0.19501441036243955,0.8208724531457544
35,75,33,143,0.3181818181818182,0.7692307692307693,0.20758098048296647,0.7992583057037923
136,451,5,592,0.23168654173764908,0.9915540540540541,0.23614391048176894,0.8024473463928331
0,58,1,59,0.0,0.9830508474576272,0.22140976570278112,0.8037690207957006
23,74,9,106,0.23711340206185566,0.9150943396226415,0.18385453742590335,0.9302323912748411
2,0,0,2,1.0,1.0,0.29609943538508704,0.9397562007986507
1,15,1,17,0.0625,0.9411764705882353,0.2642116802830462,0.9362789478284972
9,93,2,104,0.08823529411764706,0.9807692307692307,0.27681672229985294,0.940125101674651
14,113,23,150,0.11023622047244094,0.8466666666666667,0.24711020834137049,0.9511873727369221
17,42,4,63,0.288135593220339,0.9365079365079365,0.2551743585531833,0.9433236416589053
4,23,3,30,0.14814814814814814,0.9,0.2763383797172045,0.9314592348792442
2,22,0,24,0.08333333333333333,1.0,0.25062107003481165,0.9515148822142585
30,73,14,117,0.2912621359223301,0.8803418803418803,0.14937280373800169,0.9344208651202415
19,90,2,111,0.1743119266055046,0.9819819819819819,0.1653459361102166,0.9402502238907768
24,99,3,126,0.1951219512195122,0.9761904761904762,0.18341657900151948,0.9395961160938118
110,296,12,418,0.270935960591133,0.9712918660287081,0.2034403975475055,0.9545425731455319
6,86,13,105,0.06521739130434782,0.8761904761904762,0.1740162476369886,0.9459257931001807
4,35,1,40,0.10256410256410256,0.975,0.16896382879146632,0.9515709543905031
0,12,2,14,0.0,0.8571428571428571,0.1570590668867044,0.9311627911251971
1,13,2,16,0.07142857142857142,0.875,0.12565427195902462,0.9303996653620713
31,223,15,269,0.1220472440944882,0.9442379182156134,0.11818788874316513,0.9250076562525901
38,118,15,171,0.24358974358974358,0.9122807017543859,0.1251118590817696,0.9158776884760058
2,24,0,26,0.07692307692307693,1.0,0.09739573284347589,0.9199788504719046
1,43,82,126,0.022727272727272728,0.3492063492063492,0.09132571590389373,0.8446954037598864
5,39,8,52,0.11363636363636363,0.8461538461538461,0.0929074674856453,0.8262888103532929
11,172,23,206,0.060109289617486336,0.8883495145631068,0.10149450885957191,0.8307469042704715
12,151,2,165,0.0736196319018405,0.9878787878787879,0.10180751749861036,0.8468724453960127
12,135,3,150,0.08163265306122448,0.98,0.09603400449385839,0.8519813142223536
5,111,2,118,0.04310344827586207,0.9830508474576272,0.0673931051633039,0.8620913350371023
46,170,6,222,0.21296296296296297,0.972972972972973,0.08682737459757332,0.8582303311760985
8,93,1,102,0.07920792079207921,0.9901960784313726,0.0948960386068314,0.9498002924939589
3,53,5,61,0.05357142857142857,0.9180327868852459,0.08631533359755497,0.9600687125984447
2,29,8,39,0.06451612903225806,0.7948717948717948,0.08694488208537951,0.9467147526425429
2,158,4,164,0.0125,0.975609756097561,0.07821350609940228,0.9449620338166534
18,108,14,140,0.14285714285714285,0.9,0.0869598617845335,0.933533462388082
25,94,21,140,0.21008403361344538,0.85,0.11081423111847395,0.9145261984655637
12,94,2,108,0.11320754716981132,0.9814814814814815,0.09656345743373802,0.915741699681065
7,59,1,67,0.10606060606060606,0.9850746268656716,0.10039955532924184,0.9150100637431077
3,125,4,132,0.0234375,0.9696969696969697,0.09609470839046633,0.9223906612876397
10,39,1,50,0.20408163265306123,0.98,0.11603263747915249,0.9488375477345261
17,83,1,101,0.17,0.9900990099009901,0.1385326374791525,0.9509074411350159
5,24,1,30,0.1724137931034483,0.9666666666666667,0.14275501608576754,0.9604312506588254
10,76,10,96,0.11627906976744186,0.8958333333333334,0.12935430696490993,0.9669788697064446
17,37,1,55,0.3148148148148148,0.9818181818181818,0.15815534519991042,0.9670269697545446
0,3,59,62,0.0,0.04838709677419355,0.1430038300483953,0.833214465455762
6,193,9,208,0.03015075376884422,0.9567307692307693,0.1439628663010873,0.8313621511034477
18,205,11,234,0.08071748878923767,0.9529914529914529,0.12633941717768396,0.8275037872450838
36,103,12,151,0.2589928057553957,0.9205298013245033,0.13905267514274047,0.8175653288770144
2,56,7,65,0.034482758620689655,0.8923076923076924,0.11934824164520351,0.8069426182543038
24,199,6,229,0.10762331838565023,0.9737991266375546,0.118111705733519,0.8180805887263353
1,2,64,67,0.3333333333333333,0.04477611940298507,0.12075720837902162,0.6842174369527357
4,10,1,15,0.2857142857142857,0.9333333333333333,0.16157353490963386,0.8106383278897556
23,62,2,87,0.27058823529411763,0.9770114942528736,0.19592174655610153,0.8135355743214848
2,60,3,65,0.03225806451612903,0.9538461538461539,0.18899897165994314,0.8136576744435852
37,73,33,143,0.33636363636363636,0.7692307692307693,0.20005194746112037,0.7920435270016231
136,451,5,592,0.23168654173764908,0.9915540540540541,0.22822391647782886,0.8062215786796748
0,58,1,59,0.0,0.9830508474576272,0.21284915670845025,0.8075432530825423
23,74,9,106,0.23711340206185566,0.9150943396226415,0.1991034522410963,0.931874427399636
2,0,0,2,1.0,1.0,0.30114426856762694,0.9413982369234455
1,15,1,17,0.0625,0.9411764705882353,0.27141737781132436,0.9362789478284972
7,95,2,104,0.06862745098039216,0.9807692307692307,0.27661300444907627,0.940125101674651
17,113,20,150,0.13076923076923078,0.8666666666666667,0.24724237507844687,0.9540445155940649
17,42,4,63,0.288135593220339,0.9365079365079365,0.2553065252902597,0.946180784516048
4,25,2,31,0.13793103448275862,0.9354838709677419,0.2750109587877967,0.9393855021603502
1,23,0,24,0.041666666666666664,1.0,0.24356978798352963,0.9515148822142586
29,73,15,117,0.28431372549019607,0.8717948717948718,0.1413288916249862,0.9331998638992403
15,94,2,111,0.13761467889908258,0.9819819819819819,0.15205956003914084,0.9390292226697755
25,98,3,126,0.2032520325203252,0.9761904761904762,0.17129164311627415,0.9383751148728106
111,295,12,418,0.2733990147783251,0.9712918660287081,0.1927662276450459,0.9533215719245308
6,86,13,105,0.06521739130434782,0.8761904761904762,0.16334207773452894,0.9447047918791792
4,35,1,40,0.10256410256410256,0.975,0.15828965888900667,0.9503499531695019
0,12,2,14,0.0,0.8571428571428571,0.15233727793662571,0.9299417899041957
1,13,2,16,0.07142857142857142,0.875,0.12192511307067934,0.9303996653620713
30,224,15,269,0.11811023622047244,0.9442379182156134,0.11913876411659219,0.92500765625259
38,118,15,171,0.24358974358974358,0.9122807017543859,0.12490129426936623,0.9158776884760057
2,24,0,26,0.07692307692307693,1.0,0.09683330314718792,0.9199788504719045
3,44,79,126,0.06382978723404255,0.373015873015873,0.09663507399428717,0.8480967643041042
5,39,8,52,0.11363636363636363,0.8461538461538461,0.09821682557603874,0.8296901708975106
12,171,23,206,0.06557377049180328,0.8883495145631068,0.10758450707486777,0.8341482648146892
12,151,2,165,0.0736196319018405,0.9878787878787879,0.10789751571390623,0.8502738059402304
15,132,3,150,0.10204081632653061,0.98,0.10560188430048596,0.8553826747665713
4,112,2,118,0.034482758620689655,0.9830508474576272,0.07572945787633541,0.86549269558132
45,171,6,222,0.20833333333333334,0.972972972972973,0.09450235164922918,0.8616316917203163
8,93,1,102,0.07920792079207921,0.9901960784313726,0.09669922787180585,0.9498002924939589
3,53,5,61,0.05357142857142857,0.9180327868852459,0.08811852286252941,0.9600687125984446
2,29,8,39,0.06451612903225806,0.7948717948717948,0.08796743122545152,0.9467147526425429
2,158,4,164,0.0125,0.975609756097561,0.0792360552394743,0.9449620338166534
18,108,14,140,0.14285714285714285,0.9,0.08506695902956177,0.933533462388082
26,93,21,140,0.2184873949579832,0.85,0.11135333564917513,0.9145261984655638
12,94,2,108,0.11320754716981132,0.9814814814814815,0.09776393762581484,0.9157416996810649
7,59,1,67,0.10606060606060606,0.9850746268656716,0.10160003552131867,0.9150100637431076
3,125,4,132,0.0234375,0.9696969696969697,0.09729518858254316,0.9223906612876397
9,40,1,50,0.1836734693877551,0.98,0.11431766577618561,0.9488375477345262
17,83,1,101,0.17,0.9900990099009901,0.13681766577618562,0.9509074411350159
4,25,1,30,0.13793103448275862,0.9666666666666667,0.13611393600841643,0.9604312506588256
11,75,10,96,0.12790697674418605,0.8958333333333334,0.12317387626358826,0.9669788697064446
17,37,1,55,0.3148148148148148,0.9818181818181818,0.15197491449858877,0.9670269697545447
0,3,59,62,0.0,0.04838709677419355,0.1368233993470736,0.833214465455762
5,194,9,208,0.02512562814070352,0.9567307692307693,0.13706456051003127,0.8313621511034477
18,204,12,234,0.08108108108108109,0.9487179487179487,0.12240850503764926,0.8268932866345832
37,103,11,151,0.2642857142857143,0.9271523178807947,0.13587789279275128,0.8179009020602697
2,56,7,65,0.034482758620689655,0.8923076923076924,0.12109956766959858,0.807278191437559
23,200,6,229,0.1031390134529148,0.9737991266375546,0.11756128719941697,0.8184161619095907
1,1,65,67,0.5,0.029850746268656716,0.14401631365444345,0.682420813973944
4,10,1,15,0.2857142857142857,0.9333333333333333,0.18483264018505569,0.8088417049109642
24,61,2,87,0.2823529411764706,0.9770114942528736,0.22157939919016525,0.8117389513426934
1,61,3,65,0.016129032258064516,0.9538461538461539,0.21230053507259147,0.8124715520752941
36,75,32,143,0.32432432432432434,0.7762237762237763,0.2208774793638215,0.7909103318385771
133,454,5,592,0.22657580919931858,0.9915540540540541,0.24831934373219702,0.8050883835166288
0,58,1,59,0.0,0.9830508474576272,0.2335851989532092,0.8064100579194963
22,75,9,106,0.2268041237113402,0.9150943396226415,0.19455721662625777,0.932873428398637
2,0,0,2,1.0,1.0,0.2965980329527884,0.9423972379224465
1,15,1,17,0.0625,0.9411764705882353,0.26519046992757833,0.9372779488274982
7,95,2,104,0.06862745098039216,0.9807692307692307,0.27269024403076797,0.941124102673652
17,113,20,150,0.13076923076923078,0.8666666666666667,0.24503951638004035,0.954044515594065
16,43,4,63,0.2711864406779661,0.9365079365079365,0.2514124637341329,0.946180784516048
4,25,2,31,0.13793103448275862,0.9354838709677419,0.2711168972316698,0.9393855021603502
1,23,0,24,0.041666666666666664,1.0,0.2498699655334468,0.9484010593314259
31,75,11,117,0.29245283018867924,0.905982905982906,0.1487917984175438,0.9349700459004124
19,89,2,110,0.17592592592592593,0.9818181818181818,0.1649955021212475,0.9407760046475477
26,97,3,126,0.21138211382113822,0.9761904761904762,0.17983196384992012,0.9403821629003225
114,294,10,418,0.27941176470588236,0.9760765550239234,0.19984160705146303,0.9579435488827611
4,89,12,105,0.043010752688172046,0.8857142857142857,0.16442755873418888,0.9513022482947294
4,35,1,40,0.10256410256410256,0.975,0.16377345093722395,0.9572546292471102
0,13,1,14,0.0,0.9285714285714286,0.157821069984843,0.9470505476144572
2,13,1,16,0.13333333333333333,0.9375,0.13508971329122216,0.9515529896168992
31,223,15,269,0.1220472440944882,0.9442379182156134,0.1273927587438739,0.9461843805308181
38,118,15,171,0.24358974358974358,0.9122807017543859,0.13199384871081754,0.9370544127542336
2,24,0,26,0.07692307692307693,1.0,0.1030668933132739,0.9404720477508162
2,70,54,126,0.027777777777777776,0.5714285714285714,0.10089075404036044,0.8955740885671426
5,46,1,52,0.09803921568627451,0.9807692307692307,0.10024434162924213,0.8963982643913184
12,171,23,206,0.06557377049180328,0.8883495145631068,0.10961202312807118,0.890652276675844
13,150,2,165,0.07975460122699386,0.9878787878787879,0.10195791854145127,0.8978492463728136
17,130,3,150,0.11564625850340136,0.98,0.10104349202843886,0.9029581151991545
4,112,2,118,0.034482758620689655,0.9830508474576272,0.07117106560428829,0.9130681360139034
45,171,6,222,0.20833333333333334,0.972972972972973,0.08994395937718207,0.9092071321528995
8,93,1,102,0.07920792079207921,0.9901960784313726,0.09729112266493942,0.9690310617247283
3,57,1,61,0.05,0.9836065573770492,0.09042837756690021,0.9694363940972738
3,28,8,39,0.0967741935483871,0.7948717948717948,0.09488558086069787,0.956082434141372
2,159,3,164,0.012422360248447204,0.9817073170731707,0.08526668929233407,0.9552007954548553
18,108,14,140,0.14285714285714285,0.9,0.08915395848572572,0.9437722240262838
26,93,21,140,0.2184873949579832,0.85,0.11544033510533906,0.9247649601037656
12,94,2,108,0.11320754716981132,0.9814814814814815,0.1018509370819788,0.9259804613192669
7,59,1,67,0.10606060606060606,0.9850746268656716,0.10568703497748262,0.9252488253813096
5,123,4,132,0.0390625,0.9696969696969697,0.10412453497748263,0.9232617414270125
10,39,1,50,0.20408163265306123,0.98,0.1194541691352932,0.949708627873899
16,84,1,101,0.16,0.9900990099009901,0.14053668909980074,0.9509074411350161
4,25,1,30,0.13793103448275862,0.9666666666666667,0.1398329593320316,0.9604312506588254
11,82,3,96,0.11827956989247312,0.96875,0.12551755575124443,0.9773955363731112
17,37,1,55,0.3148148148148148,0.9818181818181818,0.1543185939862449,0.9774436364212112
0,3,59,62,0.0,0.04838709677419355,0.13916707883472978,0.8436311321224287
5,194,9,208,0.02512562814070352,0.9567307692307693,0.13717609714054457,0.8417788177701143
18,207,9,234,0.08,0.9615384615384616,0.11945014961867866,0.8391414551327517
37,103,11,151,0.2642857142857143,0.9271523178807947,0.13434810880235215,0.830149070558438
4,59,2,65,0.06349206349206349,0.9692307692307692,0.12371397008939569,0.8305153709247385
24,199,6,229,0.10762331838565023,0.9737991266375546,0.12219164844556385,0.8312366747301034
9,57,1,67,0.13636363636363635,0.9850746268656716,0.09669862295253837,0.831701881165459
4,10,1,15,0.2857142857142857,0.9333333333333333,0.1375149494831506,0.9581227721024791
24,61,2,87,0.2823529411764706,0.9770114942528736,0.1742617084882602,0.9610200185342083
2,60,3,65,0.03225806451612903,0.9538461538461539,0.16744143199056433,0.9599211174353072
38,75,30,143,0.336283185840708,0.7902097902097902,0.17772678506984915,0.9403578991965923
136,456,0,592,0.22972972972972974,1.0,0.20147502310380147,0.9447535035921967
0,58,1,59,0.0,0.9830508474576272,0.18610026333442287,0.9460751779950642
22,75,9,106,0.2268041237113402,0.9150943396226415,0.1990203329555234,0.9360779941032027
2,0,0,2,1.0,1.0,0.301061149282054,0.9456018036270122
1,15,1,17,0.0625,0.9411764705882353,0.26965358625684394,0.940482514532064
7,95,2,104,0.06862745098039216,0.9807692307692307,0.2748492128945958,0.9443286683782178
16,114,20,150,0.12307692307692308,0.8666666666666667,0.24439117535691227,0.9552510793006287
16,43,4,63,0.2711864406779661,0.9365079365079365,0.2503135626352317,0.946180784516048
4,25,2,31,0.13793103448275862,0.9354838709677419,0.27001799613276867,0.9393855021603503
1,22,0,23,0.043478260869565216,1.0,0.25985666449635747,0.949400060330427
31,63,14,108,0.32978723404255317,0.8703703703703703,0.16411198364529364,0.9308815418119085
16,73,2,91,0.1797752808988764,0.978021978021978,0.17193702377370457,0.9361451857310146
26,76,3,105,0.2549019607843137,0.9714285714285714,0.19606280311770025,0.9350710718749459
114,252,12,378,0.3114754098360656,0.9682539682539683,0.2219762472638513,0.9505159444626755
4,79,13,96,0.04819277108433735,0.8645833333333334,0.1821076820940813,0.9408559363916505
4,28,1,33,0.125,0.9696969696969697,0.1846587025022446,0.9460507415864557
0,12,2,14,0.0,0.8571428571428571,0.17844752237802095,0.9256425783211496
1,7,2,10,0.125,0.8,0.1491922032290848,0.9155896682682396
31,183,15,229,0.14485981308411214,0.9344978165938864,0.14420427925554705,0.9093719309213694
37,102,15,154,0.26618705035971224,0.9025974025974026,0.14581643490917542,0.8995389068026309
2,22,0,24,0.08333333333333333,1.0,0.11322470969449938,0.9040740541949212
2,47,73,122,0.04081632653061224,0.4016393442622951,0.11217093190111006,0.8379391986133443
3,37,8,48,0.075,0.8333333333333334,0.10502807475825292,0.8184586791328249
10,155,22,187,0.06060606060606061,0.8823529411764706,0.11368608341626159,0.8220601197090553
12,122,2,136,0.08955223880597014,0.9852941176470589,0.10862211753140018,0.8485307079443495
15,124,3,142,0.1079136690647482,0.9788732394366197,0.10334409695720534,0.8548700540647399
4,97,2,103,0.039603960396039604,0.9805825242718447,0.07097508410525209,0.8660107857325173
46,170,6,222,0.21296296296296297,0.972972972972973,0.08949360262377061,0.8621497818715136
6,72,1,79,0.07692307692307693,0.9873417721518988,0.09465170982269414,0.945821557284314
2,46,5,53,0.041666666666666664,0.9056603773584906,0.08988980506078938,0.9561539921450508
2,26,8,36,0.07142857142857142,0.7777777777777778,0.09143587803543378,0.9412146830880946
2,154,4,160,0.01282051282051282,0.975,0.08047420289465416,0.9397440948528004
19,98,14,131,0.1623931623931624,0.8931297709923665,0.0882569876558562,0.927495027932193
25,79,21,125,0.2403846153846154,0.832,0.11693993836850988,0.9062689530362151
12,86,2,100,0.12244897959183673,0.98,0.10400936931549186,0.9072728140400762
7,57,1,65,0.109375,0.9846153846153847,0.10864535832648084,0.9068833301062883
3,112,4,119,0.02608695652173913,0.9663865546218487,0.10641968544863407,0.915558498286768
10,36,1,47,0.21739130434782608,0.9787234042553191,0.12727150443709903,0.9442650163549883
17,82,1,100,0.1717171717171717,0.99,0.1499710271366217,0.9464078734978455
5,22,1,28,0.18518518518518517,0.9642857142857143,0.15322703039262495,0.956573008254038
10,60,8,78,0.14285714285714285,0.8974358974358975,0.13929453431727173,0.9659209936020233
15,37,1,53,0.28846153846153844,0.9811320754716981,0.16301061415580057,0.9660827186694088
0,1,59,60,0.0,0.016666666666666666,0.14738561415580057,0.8278043303910205
5,167,9,181,0.029069767441860465,0.9502762430939227,0.1478117300015322,0.8255028573156026
18,172,11,201,0.09473684210526316,0.945273631840796,0.13028966396688033,0.8207243183992421
36,93,12,141,0.27906976744186046,0.9148936170212766,0.14562574907040732,0.8099948351165673
1,55,7,63,0.017857142857142856,0.8888888888888888,0.12172174302354412,0.7992238600598779
27,178,6,211,0.13170731707317074,0.9715639810426541,0.12012891076869095,0.8098135862894146
1,2,64,67,0.3333333333333333,0.04477611940298507,0.12653916717894736,0.6760484497081698
4,10,1,15,0.2857142857142857,0.9333333333333333,0.1673554937095596,0.8070008306605507
23,44,2,69,0.34328358208955223,0.9710144927536232,0.21224318151637273,0.8099634377547937
2,58,3,63,0.03333333333333333,0.9523809523809523,0.20347125169181132,0.8109787692605304
37,73,33,143,0.33636363636363636,0.7692307692307693,0.21165609010920788,0.7901697910047435
141,443,5,589,0.24143835616438356,0.9915110356536503,0.24359626343881366,0.8048300976854239
0,52,1,53,0.0,0.9811320754716981,0.22478093242836072,0.8061969683181445
22,64,9,95,0.2558139534883721,0.9052631578947369,0.213706735307652,0.9291236881026804
2,0,0,2,1.0,1.0,0.3157475516341826,0.9386474976264899
1,15,1,17,0.0625,0.9411764705882353,0.27563561133567516,0.9343849230314346
10,83,2,95,0.10752688172043011,0.9789473684210527,0.28623468967668897,0.9381801253228774
17,105,21,143,0.13934426229508196,0.8531468531468531,0.2580890648097526,0.9501681373108893
16,39,4,59,0.2909090909090909,0.9322033898305084,0.2651563126304251,0.9416956164790119
3,25,2,30,0.10714285714285714,0.9333333333333333,0.28046243507940466,0.9348672247449599
1,21,0,22,0.045454545454545456,1.0,0.25479338683657515,0.9496362846213753
30,63,15,108,0.3225806451612903,0.8611111111111112,0.15801919328818803,0.9297950147801054
19,69,2,90,0.2159090909090909,0.9777777777777777,0.17100620627520105,0.93502377295004
28,76,3,107,0.2692307692307692,0.9719626168224299,0.19698508176863963,0.9337395209314756
115,252,12,379,0.3133514986376022,0.9683377308707124,0.22500851014543996,0.9501687205796727
5,78,13,96,0.060240963855421686,0.8645833333333334,0.19003082701582705,0.9398937772690151
4,28,1,33,0.125,0.9696969696969697,0.1931096447498172,0.944781362801762
0,12,2,14,0.0,0.8571428571428571,0.1866161382563107,0.9243731995364558
1,7,2,10,0.125,0.8,0.1583903318046978,0.915643040806297
29,185,15,229,0.13551401869158877,0.9344978165938864,0.14690532148791177,0.9094601892085983
38,102,15,155,0.2714285714285714,0.9032258064516129,0.14721929323045496,0.8996406448699101
2,22,0,24,0.08333333333333333,1.0,0.11435955532984511,0.9041638261740942
2,45,75,122,0.0425531914893617,0.38524590163934425,0.11183273070612228,0.8356870502178099
4,37,8,49,0.0975609756097561,0.8367346938775511,0.10791287007894457,0.8166924393864644
9,156,22,187,0.05454545454545454,0.8823529411764706,0.11570507787115236,0.820293879962695
12,122,2,136,0.08955223880597014,0.9852941176470589,0.11064111198629094,0.8467644681979891
14,125,3,142,0.10071942446043165,0.9788732394366197,0.10567045566755422,0.8531038143183796
5,97,2,104,0.049019607843137254,0.9807692307692307,0.07389774658392077,0.8641814463637535
45,171,6,222,0.20833333333333334,0.972972972972973,0.09175488944106362,0.8603204425027496
6,72,1,79,0.07692307692307693,0.9873417721518988,0.09666487307445151,0.9463341382902575
2,46,5,53,0.041666666666666664,0.9056603773584906,0.0886799717968673,0.9561806645018203
2,26,8,36,0.07142857142857142,0.7777777777777778,0.09109184563731257,0.9412413554448641
2,154,4,160,0.01282051282051282,0.975,0.08013017049653297,0.9397707672095699
19,98,14,131,0.1623931623931624,0.8931297709923665,0.08894070448692307,0.9275217002889624
25,81,20,126,0.2358490566037736,0.8412698412698413,0.11563062573844254,0.9075932160747638
11,87,2,100,0.11224489795918367,0.98,0.1019037063992783,0.9085970770786249
7,57,1,65,0.109375,0.9846153846153847,0.10653969541026731,0.9082075931448371
4,111,4,119,0.034782608695652174,0.9663865546218487,0.10555625855726525,0.9168827613253169
11,35,1,47,0.2391304347826087,0.9787234042553191,0.12951366760784203,0.945589279393537
16,83,1,100,0.16161616161616163,0.99,0.15077018886436327,0.9477321365363942
5,22,1,28,0.18518518518518517,0.9642857142857143,0.15402619212036653,0.9578972712925867
10,59,9,78,0.14492753623188406,0.8846153846153846,0.14103740349581087,0.9640894917705215
17,35,1,53,0.3269230769230769,0.9811320754716981,0.17170571477636706,0.9642512168379069
0,1,59,60,0.0,0.016666666666666666,0.15608071477636706,0.8259728285595187
5,168,9,182,0.028901734104046242,0.9505494505494505,0.15524058983470906,0.8237103851206046
18,172,11,201,0.09473684210526316,0.945273631840796,0.13461293373794542,0.8189318462042443
35,96,12,143,0.26717557251908397,0.916083916083916,0.14969284958122003,0.8083724056448036
2,54,7,63,0.03571428571428571,0.8888888888888888,0.12833986394252012,0.7976014305881142
25,179,6,210,0.12254901960784313,0.9714285714285714,0.12514293299622856,0.8100033144185695
1,2,64,67,0.3333333333333333,0.04477611940298507,0.12605868391197947,0.6762381778373248
4,9,2,15,0.3076923076923077,0.8666666666666667,0.17001472786802344,0.7976667492658962
23,44,2,69,0.34328358208955223,0.9710144927536232,0.2149264204373814,0.8005903267236353
2,58,3,63,0.03333333333333333,0.9523809523809523,0.20615449061282004,0.8016056582293718
36,74,33,143,0.32727272727272727,0.7692307692307693,0.21473979843476904,0.7806266372503509
143,441,5,589,0.24486301369863014,0.9915110356536503,0.24461818814681827,0.795286943931031
0,52,1,53,0.0,0.9811320754716981,0.2271111853456978,0.796673158794335
22,64,9,95,0.2558139534883721,0.9052631578947369,0.21603698822498904,0.9195998785788709
2,0,0,2,1.0,1.0,0.3149380871260879,0.9386474976264899
2,14,1,17,0.125,0.9411764705882353,0.2837547182561519,0.9343849230314344
8,85,2,95,0.08602150537634409,0.9789473684210527,0.291281599976582,0.9381801253228773
16,107,20,143,0.13008130081300814,0.8601398601398601,0.26311139619662216,0.9511671383098904
18,37,4,59,0.32727272727272727,0.9322033898305084,0.27488421242149313,0.942694617478013
3,25,2,30,0.10714285714285714,0.9333333333333333,0.29019033487047274,0.9358662257439608
1,22,0,23,0.043478260869565216,1.0,0.25213515694158867,0.9459803706428807
30,72,15,117,0.29411764705882354,0.8717948717948718,0.15129482080713488,0.9276653523278623
22,85,2,109,0.205607476635514,0.981651376146789,0.16281017461220829,0.93344748169337
26,97,3,126,0.21138211382113822,0.9761904761904762,0.1832988815797218,0.9327672095845266
118,288,12,418,0.29064039408866993,0.9712918660287081,0.20820764219704008,0.9486660475886276
6,86,13,105,0.06521739130434782,0.8761904761904762,0.17394087727441665,0.9400492675432762
4,34,1,39,0.10526315789473684,0.9743589743589743,0.17367234881039945,0.9502111486728992
0,12,2,14,0.0,0.8571428571428571,0.16746116868617583,0.9298029854075931
1,13,2,16,0.07142857142857142,0.875,0.13564844359613984,0.9302608608654686
31,223,15,269,0.1220472440944882,0.9442379182156134,0.12371126751885043,0.9249160811610148
37,119,15,171,0.23717948717948717,0.9122807017543859,0.12739660657004315,0.9157861133844305
1,25,0,26,0.038461538461538464,1.0,0.09137105576616722,0.9198872753803294
3,47,76,126,0.06,0.3968253968253968,0.09062571415126039,0.8514065497567467
4,40,8,52,0.09090909090909091,0.8461538461538461,0.08857513315331098,0.8330915314417283
12,168,25,205,0.06666666666666667,0.8780487804878049,0.0980989426771205,0.836078091919578
11,152,2,165,0.06748466257668712,0.9878787878787879,0.09753552712685132,0.8522036330451191
17,129,3,149,0.11643835616438356,0.9798657718120806,0.09673425742255064,0.8572933264160431
4,112,2,118,0.034482758620689655,0.9830508474576272,0.067777581914151,0.8674033472307918
45,171,6,222,0.20833333333333334,0.972972972972973,0.09204498118155027,0.8635423433697881
8,93,1,102,0.07920792079207921,0.9901960784313726,0.09478896986613301,0.9483095835992131
3,53,5,61,0.05357142857142857,0.9180327868852459,0.08945501810360981,0.9585780037036987
3,28,8,39,0.0967741935483871,0.7948717948717948,0.09375609337242703,0.9466955771871259
3,157,4,164,0.01875,0.975609756097561,0.08679399871861458,0.9449428583612364
19,107,14,140,0.15079365079365079,0.9,0.09170189795136705,0.933533462388082
27,91,22,140,0.2288135593220339,0.8428571428571429,0.11946344090870194,0.9135057903022986
12,94,2,108,0.11320754716981132,0.9814814814814815,0.10587404288534165,0.9147212915177996
7,59,1,67,0.10606060606060606,0.9850746268656716,0.1097101407808455,0.9139896555798425
3,124,4,131,0.023622047244094488,0.9694656488549618,0.10543165773408347,0.9213372072898018
11,37,1,49,0.22916666666666666,0.9795918367346939,0.12434486817955197,0.9477257846987873
16,84,1,101,0.16,0.9900990099009901,0.14452343960812342,0.9497956780992772
3,26,1,30,0.10344827586206896,0.9666666666666667,0.13775981461789744,0.9593194876230868
10,78,8,96,0.11363636363636363,0.9166666666666666,0.12130592951994455,0.9698637053101615
17,36,1,54,0.32075471698113206,0.9814814814814815,0.15095552520727606,0.9698637053101616
0,4,59,63,0.0,0.06349206349206349,0.13580401005576093,0.8382090533996462
6,193,9,208,0.03015075376884422,0.9567307692307693,0.13673668241643946,0.8363897848819043
18,205,11,234,0.08071748878923767,0.9529914529914529,0.11552965700537818,0.8325897300614413
35,106,12,153,0.24822695035460993,0.9215686274509803,0.12813350705603674,0.8227996754257257
3,60,2,65,0.047619047619047616,0.9692307692307692,0.12015790302131941,0.823165975792026
26,197,6,229,0.11659192825112108,0.9737991266375546,0.12058012653771333,0.8313277557878672
1,1,65,67,0.5,0.029850746268656716,0.14618659554040875,0.6953805079003208
3,11,1,15,0.21428571428571427,0.9333333333333333,0.17679884043836794,0.8196435464490737
24,61,2,87,0.2823529411764706,0.9770114942528736,0.2128277243537431,0.8225407928808028
1,61,3,65,0.016129032258064516,0.9538461538461539,0.20360080199214695,0.822662893002903
36,73,34,143,0.3302752293577982,0.7622377622377622,0.2153219847068881,0.7999013408295861
146,441,5,592,0.24872231686541738,0.9915540540540541,0.24405102317065525,0.8030903815186268
0,58,1,59,0.0,0.9830508474576272,0.22739503342049508,0.8044120559214942
23,74,9,106,0.23711340206185566,0.9150943396226415,0.18983980514361729,0.930875426400635
2,0,0,2,1.0,1.0,0.302084703102801,0.9403992359244445
2,14,1,17,0.125,0.9411764705882353,0.27960571150616237,0.9352799468294962
9,94,2,105,0.08737864077669903,0.9809523809523809,0.2897842270088244,0.9391522649875287
15,113,22,150,0.1171875,0.8533333333333334,0.2593431228148532,0.9521659180011817
18,41,4,63,0.3050847457627119,0.9365079365079365,0.26739489837160957,0.9443021869231648
3,26,2,31,0.10344827586206896,0.9354838709677419,0.2821732234947623,0.937506904567467
1,23,0,24,0.041666666666666664,1.0,0.2463781662342659,0.9515410465261372
29,74,14,117,0.2815533980582524,0.8803418803418803,0.14374293738544486,0.9344470294321202
24,84,2,110,0.2222222222222222,0.9818181818181818,0.15763182627433373,0.9402529881792553
26,97,3,126,0.21138211382113822,0.9761904761904762,0.17812053324184723,0.9395727160704118
114,292,12,418,0.28078817733990147,0.9712918660287081,0.20174961352117382,0.954519173122132
6,86,13,105,0.06521739130434782,0.8761904761904762,0.17232546361065695,0.9459023930767805
4,34,1,39,0.10526315789473684,0.9743589743589743,0.1725847324724666,0.951455979275528
0,12,2,14,0.0,0.8571428571428571,0.16663235152008565,0.9310478160102219
1,13,2,16,0.07142857142857142,0.875,0.13661451914441697,0.9302846902470961
31,223,15,269,0.1220472440944882,0.9442379182156134,0.1223038079833121,0.924916081161015
39,117,15,171,0.25,0.9122807017543859,0.1278206488660066,0.9157861133844306
2,24,0,26,0.07692307692307693,1.0,0.09869706309217455,0.9198872753803294
3,46,77,126,0.061224489795918366,0.3888888888888889,0.09812664859097034,0.8502727629086742
4,40,8,52,0.09090909090909091,0.8461538461538461,0.09607606759302093,0.8319577445936559
12,168,25,205,0.06666666666666667,0.8780487804878049,0.10559987711683046,0.8349443050715054
11,152,2,165,0.06748466257668712,0.9878787878787879,0.10503646156656125,0.8510698461970466
16,130,3,149,0.1095890410958904,0.9798657718120806,0.1032567182810473,0.8561595395679705
4,112,2,118,0.034482758620689655,0.9830508474576272,0.07246854094114583,0.8662695603827192
45,171,6,222,0.20833333333333334,0.972972972972973,0.09124143471403959,0.8624085565217153
9,92,1,102,0.0891089108910891,0.9901960784313726,0.09522492344192113,0.9483095835992131
2,54,5,61,0.03571428571428571,0.9180327868852459,0.08733995127123466,0.9585780037036987
2,29,8,39,0.06451612903225806,0.7948717948717948,0.08703273160917631,0.9466955771871258
2,158,4,164,0.0125,0.975609756097561,0.0791777798125067,0.9449428583612363
19,107,14,140,0.15079365079365079,0.9,0.08506415262647248,0.933533462388082
28,91,21,140,0.23529411764705882,0.85,0.1137514896302395,0.9145261984655637
11,95,2,108,0.10377358490566038,0.9814814814814815,0.0988143827120005,0.915741699681065
9,57,1,67,0.13636363636363635,0.9850746268656716,0.10556505777950727,0.9150100637431077
3,124,4,131,0.023622047244094488,0.9694656488549618,0.10383759514090851,0.9223576154530672
11,37,1,49,0.22916666666666666,0.9795918367346939,0.12735910051725258,0.9487461928620526
16,84,1,101,0.16,0.9900990099009901,0.14843052908868118,0.9508160862625425
3,26,1,30,0.10344827586206896,0.9666666666666667,0.1416669040984552,0.960339895786352
10,77,9,96,0.11494252873563218,0.90625,0.12447381996825138,0.9683756100720664
17,36,1,54,0.32075471698113206,0.9814814814814815,0.1554711245504616,0.9683756100720664
0,4,59,63,0.0,0.06349206349206349,0.13599060506994215,0.8367209581615509
6,193,9,208,0.03015075376884422,0.9567307692307693,0.1369232774306207,0.8349016896438092
17,206,11,234,0.07623318385650224,0.9529914529914529,0.11507563702916863,0.8311016348233462
34,107,12,153,0.24113475177304963,0.9215686274509803,0.12666631585389002,0.8213115801876304
3,60,2,65,0.047619047619047616,0.9692307692307692,0.11869071181917266,0.8216778805539308
25,198,6,229,0.11210762331838565,0.9737991266375546,0.11828572533099457,0.8313277557878672
1,1,65,67,0.5,0.029850746268656716,0.14389219433369,0.6953805079003208
4,10,1,15,0.2857142857142857,0.9333333333333333,0.18470852086430226,0.8196435464490737
24,61,2,87,0.2823529411764706,0.9770114942528736,0.22073740477967746,0.8225407928808028
1,61,3,65,0.016129032258064516,0.9538461538461539,0.21215109740847207,0.822662893002903
36,73,34,143,0.3302752293577982,0.7622377622377622,0.22488545134915042,0.7999013408295861
148,439,5,592,0.252129471890971,0.9915540540540541,0.2541012262451395,0.8030903815186268
0,58,1,59,0.0,0.9830508474576272,0.2380858514853701,0.8044120559214942
23,74,9,106,0.23711340206185566,0.9150943396226415,0.20053062320849233,0.930875426400635
2,0,0,2,1.0,1.0,0.30257143953502297,0.9403992359244445
2,14,1,17,0.125,0.9411764705882353,0.2800924479383843,0.9352799468294962
7,96,2,105,0.06796116504854369,0.9809523809523809,0.2874970383370242,0.9391522649875286
15,114,21,150,0.11627906976744186,0.86,0.2569261583955447,0.9531182989535625
18,41,4,63,0.3050847457627119,0.9365079365079365,0.2644911975200791,0.9452545678755458
3,25,3,31,0.10714285714285714,0.9032258064516129,0.2797973199690587,0.9338509905889724
1,23,0,24,0.041666666666666664,1.0,0.2530249175412114,0.9515410465261372
30,72,15,117,0.29411764705882354,0.8717948717948718,0.15218458140675764,0.9332260282111189
20,88,2,110,0.18518518518518517,0.9818181818181818,0.16078246500464122,0.9390319869582541
25,98,3,126,0.2032520325203252,0.9761904761904762,0.17456188157827993,0.9383517148494106
115,291,12,418,0.2832512315270936,0.9712918660287081,0.19744392564259,0.9532981719011308
6,86,13,105,0.06521739130434782,0.8761904761904762,0.16801977573207308,0.9446813918557793
4,34,1,39,0.10526315789473684,0.9743589743589743,0.1682790445938828,0.9502349780545268
0,12,2,14,0.0,0.8571428571428571,0.16232666364150186,0.9298268147892207
1,13,2,16,0.07142857142857142,0.875,0.1305139385514658,0.9302846902470961
31,223,15,269,0.1220472440944882,0.9442379182156134,0.12149423268136626,0.924916081161015
41,115,15,171,0.26282051282051283,0.9122807017543859,0.13000401558139305,0.9157861133844306
2,24,0,26,0.07692307692307693,1.0,0.10052856492367639,0.9198872753803294
3,49,74,126,0.057692307692307696,0.4126984126984127,0.09945355297909922,0.8536741234528918
4,40,8,52,0.09090909090909091,0.8461538461538461,0.0974029719811498,0.8353591051378736
11,171,23,205,0.06043956043956044,0.8878048780487805,0.10603719490108701,0.8397393938387196
13,150,2,165,0.07975460122699386,0.9878787878787879,0.10722662772943306,0.8558649349642609
14,131,4,149,0.09655172413793103,0.9731543624161074,0.10358441059278205,0.8599958555643313
6,110,2,118,0.05172413793103448,0.9830508474576272,0.07342778560857087,0.8701058763790801
45,171,6,222,0.20833333333333334,0.972972972972973,0.09220067938146463,0.8662448725180764
9,92,1,102,0.0891089108910891,0.9901960784313726,0.09668876555271912,0.9487445390513563
2,54,5,61,0.03571428571428571,0.9180327868852459,0.08880379338203266,0.959012959155842
2,29,8,39,0.06451612903225806,0.7948717948717948,0.08938616032384661,0.9457368044162726
2,159,3,164,0.012422360248447204,0.9817073170731707,0.07976726875548279,0.9448551657297558
19,107,14,140,0.15079365079365079,0.9,0.08751611542058561,0.9344045425274548
29,91,20,140,0.24166666666666667,0.8571428571428571,0.1146507623828188,0.916417686768202
12,94,2,108,0.11320754716981132,0.9814814814814815,0.10106136435945849,0.9176331879837031
9,57,1,67,0.13636363636363635,0.9850746268656716,0.10781203942696525,0.916901552045746
4,123,4,131,0.031496062992125984,0.9694656488549618,0.10720943618094245,0.9242491037557052
12,36,1,49,0.25,0.9795918367346939,0.133707132033477,0.9506376811646909
17,83,1,101,0.17,0.9900990099009901,0.15621822342655597,0.9518364944258079
6,23,1,30,0.20689655172413793,0.9666666666666667,0.16423292355948269,0.9613603039496175
11,76,9,96,0.12643678160919541,0.90625,0.1477715114084154,0.9683756100720664
17,37,1,55,0.3148148148148148,0.9818181818181818,0.1765725496434159,0.9684237101201665
0,4,59,63,0.0,0.06349206349206349,0.15709203016289638,0.8367690582096509
6,193,9,208,0.03015075376884422,0.9567307692307693,0.156899843130999,0.8349497896919092
28,196,10,234,0.125,0.9572649572649573,0.13904270027385615,0.8317602354819468
36,105,12,153,0.2553191489361702,0.9215686274509803,0.15123115012188046,0.8219701808462311
3,55,7,65,0.05172413793103448,0.8923076923076924,0.1290636624371514,0.8113474702235205
25,198,6,229,0.11210762331838565,0.9737991266375546,0.12701663982417857,0.8209973454574568
1,2,64,67,0.3333333333333333,0.04477611940298507,0.12966214246968122,0.6871341936838574
4,9,2,15,0.3076923076923077,0.8666666666666667,0.17361818642572516,0.8018734227088008
24,61,2,87,0.2823529411764706,0.9770114942528736,0.2096470703411004,0.8047706691405299
2,60,3,65,0.03225806451612903,0.9538461538461539,0.1963982224148331,0.8042822686521295
37,73,33,143,0.33636363636363636,0.7692307692307693,0.20797600633304253,0.7825197174778136
149,443,0,592,0.2516891891891892,1.0,0.23654244222706464,0.7979043328624289
0,58,1,59,0.0,0.9830508474576272,0.22052706746729528,0.7992260072652965
23,74,9,106,0.23711340206185566,0.9150943396226415,0.20678136299994135,0.9235571815823901
2,0,0,2,1.0,1.0,0.3056824619010402,0.9426048006300091
2,14,1,17,0.125,0.9411764705882353,0.28320347030440157,0.9374855115350609
7,96,2,105,0.06796116504854369,0.9809523809523809,0.2883039132376037,0.9413578296930932
15,115,20,150,0.11538461538461539,0.8666666666666667,0.2567354816691721,0.9552772436125073
16,43,4,63,0.2711864406779661,0.9365079365079365,0.25952080331042593,0.9462069488279267
3,26,2,31,0.10344827586206896,0.9354838709677419,0.2742991284335786,0.9394116664722288
1,23,0,24,0.041666666666666664,1.0,0.2531612153519278,0.9505886655737561
31,72,14,117,0.30097087378640774,0.8803418803418803,0.15329991160712894,0.9334946484797391
20,88,2,110,0.18518518518518517,0.9818181818181818,0.16189779520501252,0.9393006072268744
27,96,3,126,0.21951219512195122,0.9761904761904762,0.17800009215031207,0.9386203351180308
117,290,12,419,0.28746928746928746,0.9713603818615751,0.20134841782421914,0.9545289610982558
7,85,13,105,0.07608695652173914,0.8761904761904762,0.17347706294475815,0.9459121810529043
4,34,1,39,0.10526315789473684,0.9743589743589743,0.17373633180656783,0.9514657672516519
0,12,2,14,0.0,0.8571428571428571,0.1677839508541869,0.9310576039863456
1,13,2,16,0.07142857142857142,0.875,0.13499219337449597,0.93029447822322
31,223,15,269,0.1220472440944882,0.9442379182156134,0.1259724875043964,0.9249258691371389
40,116,15,171,0.2564102564102564,0.9122807017543859,0.13124363911701145,0.9157959013605544
2,24,0,26,0.07692307692307693,1.0,0.10116560903898135,0.9198872753803294
3,49,74,126,0.057692307692307696,0.4126984126984127,0.09853780206334829,0.8536741234528918
4,40,8,52,0.09090909090909091,0.8461538461538461,0.09648722106539888,0.8353591051378734
11,169,25,205,0.06111111111111111,0.8780487804878049,0.1052173797955576,0.8383456656157231
13,150,2,165,0.07975460122699386,0.9878787878787879,0.10640681262390368,0.8544712067412643
18,127,4,149,0.12413793103448276,0.9731543624161074,0.10670548218676004,0.8586021273413349
4,112,2,118,0.034482758620689655,0.9830508474576272,0.07500155393110765,0.8687121481560836
45,171,6,222,0.20833333333333334,0.972972972972973,0.09377444770400142,0.8648511442950798
9,92,1,102,0.0891089108910891,0.9901960784313726,0.09826253387525592,0.9473508108283598
2,54,5,61,0.03571428571428571,0.9180327868852459,0.09037756170456945,0.9576192309328455
2,29,8,39,0.06451612903225806,0.7948717948717948,0.09086399283616187,0.9457368044162726
2,158,4,164,0.0125,0.975609756097561,0.08125619266087704,0.943984085590383
19,107,14,140,0.15079365079365079,0.9,0.08506415262647248,0.9335334623880819
29,91,20,140,0.24166666666666667,0.8571428571428571,0.11466185377589777,0.915546606628829
13,93,2,108,0.12264150943396226,0.9814814814814815,0.10242016464741618,0.9167621078443302
8,58,1,67,0.12121212121212122,0.9850746268656716,0.10700633755042077,0.916030471906373
4,123,4,131,0.031496062992125984,0.9694656488549618,0.10640373430439795,0.9233780236163324
12,36,1,49,0.25,0.9795918367346939,0.1329014301569325,0.949766601025318
17,83,1,101,0.17,0.9900990099009901,0.1554014301569325,0.9518364944258079
6,23,1,30,0.20689655172413793,0.9666666666666667,0.16341613028985927,0.9613603039496175
11,76,9,96,0.12643678160919541,0.90625,0.14695471813879193,0.9683756100720664
17,37,1,55,0.3148148148148148,0.9818181818181818,0.17440804747891372,0.9684237101201665
0,4,59,63,0.0,0.06349206349206349,0.15709203016289638,0.8367690582096509
6,193,9,208,0.03015075376884422,0.9567307692307693,0.156899843130999,0.8349497896919092
29,194,11,234,0.13004484304932734,0.9529914529914529,0.13976339213804576,0.8311497348714462
36,105,12,153,0.2553191489361702,0.9215686274509803,0.1519518419860701,0.8213596802357305
2,56,7,65,0.034482758620689655,0.8923076923076924,0.1273213001141489,0.8107369696130198
27,195,7,229,0.12162162162162163,0.9694323144104804,0.12663342011592407,0.8197630145288028
1,1,65,67,0.5,0.029850746268656716,0.15308844657095053,0.6837676665931564
3,10,2,15,0.23076923076923078,0.8666666666666667,0.1860554795379835,0.7985068956180997
23,62,2,87,0.27058823529411763,0.9770114942528736,0.22040369118445113,0.8014041420498288
2,60,3,65,0.03225806451612903,0.9538461538461539,0.20643415139399424,0.801526242171929
37,72,34,143,0.3394495412844037,0.7622377622377622,0.21845277887231326,0.778764689998612
149,438,5,592,0.25383304940374785,0.9915540540540541,0.2497885346984645,0.7929427416766638
0,58,1,59,0.0,0.9830508474576272,0.23241401732394706,0.7948882463976847
20,77,9,106,0.20618556701030927,0.9150943396226415,0.1904405268968484,0.9213516168768255
2,0,0,2,1.0,1.0,0.3003306367869583,0.9403992359244445
2,14,1,17,0.125,0.9411764705882353,0.2795323174592272,0.9352799468294961
11,92,2,105,0.10679611650485436,0.9809523809523809,0.2901806106004737,0.9391522649875286
16,114,20,150,0.12307692307692308,0.8666666666666667,0.2592702365708336,0.9540706799059436
16,43,4,63,0.2711864406779661,0.9365079365079365,0.2617492924671505,0.9462069488279268
3,26,2,31,0.10344827586206896,0.9354838709677419,0.2765276175903032,0.9394116664722288
1,23,0,24,0.041666666666666664,1.0,0.25866033607969097,0.9447769057072725
31,75,11,117,0.29245283018867924,0.905982905982906,0.15758216896378804,0.9313458922762591
18,90,2,110,0.16666666666666666,0.9818181818181818,0.16353454991616898,0.9371518510233942
27,95,3,125,0.22131147540983606,0.976,0.1813255901820903,0.9367307983918153
118,291,10,419,0.2885085574572127,0.9761336515513126,0.20180377120132342,0.9531625898832726
7,85,13,105,0.07608695652173914,0.8761904761904762,0.1711148948602732,0.9451607450775537
4,34,1,39,0.10526315789473684,0.9743589743589743,0.1702794729722197,0.9557834557002644
0,13,1,14,0.0,0.9285714285714286,0.16432709201983875,0.9455793740676113
1,14,1,16,0.06666666666666667,0.9375,0.1320719258024084,0.9500818160700533
33,221,15,269,0.12992125984251968,0.9442379182156134,0.1268225819703874,0.9447132069839721
14,80,14,108,0.14893617021276595,0.8703703703703703,0.11648325265652024,0.929623259894025
1,25,0,26,0.038461538461538464,1.0,0.08076224994285248,0.9330327382438374
3,74,49,126,0.03896103896103896,0.6111111111111112,0.07545854743418103,0.8951642575182139
4,47,1,52,0.0784313725490196,0.9807692307692307,0.07162543524193572,0.8960800084339647
11,171,23,205,0.06043956043956044,0.8878048780487805,0.08025965816187293,0.8902562155021579
13,150,2,165,0.07975460122699386,0.9878787878787879,0.08212936309906252,0.8974531851991275
18,127,4,149,0.12413793103448276,0.9731543624161074,0.08130317326934297,0.9015841057991982
4,112,2,118,0.034482758620689655,0.9830508474576272,0.06495268589904635,0.9176813168116634
45,171,6,222,0.20833333333333334,0.972972972972973,0.08922008516644563,0.9138203129506596
9,92,1,102,0.0891089108910891,0.9901960784313726,0.0963840668707385,0.9679753082821255
2,58,1,61,0.03333333333333333,0.9836065573770492,0.08994148983992616,0.9683806406546711
2,29,8,39,0.06451612903225806,0.7948717948717948,0.0905238567817401,0.9551044859151017
2,158,4,164,0.0125,0.975609756097561,0.08091605660645527,0.9533517670892121
20,107,13,140,0.15748031496062992,0.9071428571428571,0.08567925431019059,0.9439215520501761
28,92,20,140,0.23333333333333334,0.8571428571428571,0.11408647926913969,0.9259346962909234
14,92,2,108,0.1320754716981132,0.9814814814814815,0.10319249903553682,0.9271501975064246
9,57,1,67,0.13636363636363635,0.9850746268656716,0.10994317410304356,0.9264185615684674
4,123,4,131,0.031496062992125984,0.9694656488549618,0.10968070691144251,0.9243984317795977
12,36,1,49,0.25,0.9795918367346939,0.13617840276397705,0.9507870091885833
17,83,1,101,0.17,0.9900990099009901,0.15867840276397707,0.9528569025890732
5,24,1,30,0.1724137931034483,0.9666666666666667,0.16081175678437967,0.9613603039496175
12,81,3,96,0.12903225806451613,0.96875,0.14591160317454865,0.9773041815006378
16,38,1,55,0.2962962962962963,0.9818181818181818,0.1693717209742891,0.9773522815487379
0,4,59,63,0.0,0.06349206349206349,0.14989120149376964,0.8456976296382223
7,191,9,207,0.03535353535353535,0.9565217391304348,0.15044226897397098,0.8438484996775758
27,197,10,234,0.12053571428571429,0.9572649572649573,0.1319473710147873,0.8406589454676132
36,106,11,153,0.2535211267605634,0.9281045751633987,0.14387896055201063,0.8318025976479574
3,55,7,65,0.05172413793103448,0.8923076923076924,0.1266375812416658,0.8211798870252468
26,197,6,229,0.11659192825112108,0.9737991266375546,0.12486039126832364,0.8219011908306116
9,57,1,67,0.13636363636363635,0.9850746268656716,0.1020128684208008,0.8223663972659675
4,10,1,15,0.2857142857142857,0.9333333333333333,0.14282919495141305,0.9466294358147203
23,62,2,87,0.27058823529411763,0.9770114942528736,0.17643415208578195,0.9495565436893543
2,60,3,65,0.03225806451612903,0.9538461538461539,0.1638230592615555,0.9490681432009538
40,75,28,143,0.34782608695652173,0.8041958041958042,0.17729519643240668,0.9313668902055833
153,434,5,592,0.2606473594548552,0.9915540540540541,0.20714137093580964,0.9455449418836349
0,58,1,59,0.0,0.9830508474576272,0.1904853811856495,0.9468666162865025
20,77,9,106,0.20618556701030927,0.9150943396226415,0.20045994270660275,0.936869432394641
2,0,0,2,1.0,1.0,0.3025007590331334,0.9463932419184505
2,14,1,17,0.125,0.9411764705882353,0.28170243970540226,0.9412739528235022
11,92,2,105,0.10679611650485436,0.9809523809523809,0.29235073284664875,0.9451462709815346
16,113,21,150,0.12403100775193798,0.86,0.2603800072459939,0.9531182989535626
16,43,4,63,0.2711864406779661,0.9365079365079365,0.26188559027786695,0.9452545678755458
3,26,2,31,0.10344827586206896,0.9354838709677419,0.27666391540101964,0.9384592855198479
1,22,0,23,0.043478260869565216,1.0,0.2573593977976746,0.949400060330427
33,61,14,108,0.35106382978723405,0.8703703703703703,0.1646542306244223,0.9308815418119085
16,72,2,90,0.18181818181818182,0.9777777777777777,0.17277111374130544,0.9361102999818431
28,74,3,105,0.27450980392156865,0.9714285714285714,0.19816191522318855,0.9350361861257743
122,247,13,382,0.33062330623306235,0.9659685863874345,0.22564933295450867,0.9501545755897135
5,78,13,96,0.060240963855421686,0.8645833333333334,0.19269674337541307,0.9404945675186885
4,28,1,33,0.125,0.9696969696969697,0.19524776378357633,0.9456893727134936
0,12,2,14,0.0,0.8571428571428571,0.18903658365935275,0.9252812094481876
1,7,2,10,0.125,0.8,0.15674175083260503,0.9152282993952775
32,183,15,230,0.14883720930232558,0.9347826086956522,0.15203018333033985,0.9090861323835454
13,64,14,91,0.16883116883116883,0.8461538461538461,0.13693323546028274,0.8911897430585846
2,22,0,24,0.08333333333333333,1.0,0.10160609647460715,0.8960513735746655
2,43,77,122,0.044444444444444446,0.36885245901639346,0.09934945084446756,0.825232677243674
3,37,8,48,0.075,0.8333333333333334,0.09220659370161041,0.8057521577631546
11,154,22,187,0.06666666666666667,0.8823529411764706,0.10173040322541993,0.8093535983393849
11,123,2,136,0.08208955223880597,0.9852941176470589,0.09560033925953507,0.835824186574679
16,121,4,141,0.11678832116788321,0.9716312056737588,0.09102192666890045,0.8410882718572658
5,96,2,103,0.04950495049504951,0.9805825242718447,0.07397532404945482,0.8602923687312656
46,170,6,222,0.21296296296296297,0.972972972972973,0.09249384256797334,0.8564313648702617
7,71,1,79,0.08974358974358974,0.9873417721518988,0.09896514903927982,0.9447869810324766
3,45,5,53,0.0625,0.9056603773584906,0.09717943475356552,0.9551194158932136
2,27,8,37,0.06896551724137931,0.7837837837837838,0.09750784197852448,0.9410381076942581
2,153,4,159,0.012903225806451613,0.9748427672955975,0.0876240810596167,0.9395450576440494
20,97,14,131,0.17094017094017094,0.8931297709923665,0.09536005959851497,0.9283305669752792
26,78,21,125,0.25,0.832,0.1240022095277936,0.9071044920793013
12,86,2,100,0.12244897959183673,0.98,0.11107164047477558,0.9081083530831623
10,55,1,66,0.15384615384615385,0.9848484848484849,0.12022914963228473,0.9077521691826747
3,112,4,119,0.02608695652173913,0.9663865546218487,0.11502728627824746,0.9164273373631543
11,35,1,47,0.2391304347826087,0.9787234042553191,0.1393365602127088,0.9442758545733737
17,82,1,100,0.1717171717171717,0.99,0.16202426677138312,0.9464411735311454
7,20,1,28,0.25925925925925924,0.9642857142857143,0.17464127938839574,0.956606308287338
8,62,8,78,0.11428571428571428,0.8974358974358975,0.1552535242863549,0.9659542936353233
16,36,1,53,0.3076923076923077,0.9811320754716981,0.18171685687213648,0.9661160187027089
0,1,59,60,0.0,0.016666666666666666,0.15973883489411447,0.8278043303910205
7,165,9,181,0.040697674418604654,0.9502762430939227,0.16182608030795245,0.8255028573156025
28,161,11,200,0.14814814814814814,0.945,0.1488286107887438,0.8206852281362712
39,93,11,143,0.29545454545454547,0.9230769230769231,0.16650537846551147,0.8111247885758317
1,55,7,63,0.017857142857142856,0.8888888888888888,0.13201936183663768,0.8003538135191423
24,178,7,209,0.1188118811881188,0.9665071770334929,0.13266595710840975,0.8102211391759415
1,1,65,67,0.5,0.029850746268656716,0.16013848458093724,0.67432380643265
4,10,1,15,0.2857142857142857,0.9333333333333333,0.20095481111154948,0.8052761873850309
22,45,2,69,0.3283582089552239,0.9710144927536232,0.24204917318820934,0.8082387944792738
3,57,3,63,0.05,0.9523809523809523,0.22802800916704533,0.8092932162479813
38,72,32,142,0.34545454545454546,0.7746478873239436,0.2351708663099025,0.78808906828327
148,436,5,589,0.2534246575342466,0.9915110356536503,0.26882336840663157,0.8027493749639502
0,52,1,53,0.0,0.9811320754716981,0.2518502425226146,0.8048386461694081
20,66,9,95,0.23255813953488372,0.9052631578947369,0.21364426245616944,0.9298975621159908
2,0,0,2,1.0,1.0,0.3156850787827001,0.9394213716398004
2,14,1,17,0.125,0.9411764705882353,0.28663390607481093,0.9351587970447451
9,84,2,95,0.0967741935483871,0.9789473684210527,0.2933159337245805,0.938953999336188
18,106,20,144,0.14516129032258066,0.8611111111111112,0.2647026115628712,0.9513058884486405
16,39,4,59,0.2909090909090909,0.9322033898305084,0.27005753061642046,0.9428333676167632
3,24,3,30,0.1111111111111111,0.9,0.28593054648943633,0.9312430711208062
1,21,0,22,0.045454545454545456,1.0,0.2547366858470955,0.9505886655737562
33,61,14,108,0.35106382978723405,0.8703703703703703,0.16203151867384324,0.9320701470552377
16,71,2,89,0.1839080459770115,0.9775280898876404,0.17044695381341635,0.9372632355265813
28,74,3,105,0.27450980392156865,0.9714285714285714,0.1957930145678152,0.9359026913088943
125,243,13,381,0.33967391304347827,0.9658792650918635,0.22659914389517807,0.9510283006077318
7,76,13,96,0.08433734939759036,0.8645833333333334,0.19748510906335684,0.9407533572970743
4,28,1,33,0.125,0.9696969696969697,0.20056392679734697,0.9456409428298211
0,12,2,14,0.0,0.8571428571428571,0.1940704203038405,0.9252327795645149
1,7,2,10,0.125,0.8,0.16177558747709275,0.9151798695116049
32,183,15,230,0.14883720930232558,0.9347826086956522,0.15676546795213767,0.9090733721984637
12,63,14,89,0.16,0.8426966292134831,0.1404069245347707,0.8906830947391654
2,22,0,24,0.08333333333333333,1.0,0.10378684171903571,0.8955574854403279
2,45,75,122,0.0425531914893617,0.38524590163934425,0.09781767630357448,0.8270807094840436
3,37,8,48,0.075,0.8333333333333334,0.09067481916071732,0.8076001900035241
12,152,23,187,0.07317073170731707,0.8770053475935828,0.1011277808331912,0.8104376886393422
12,123,2,137,0.08888888888888889,0.9854014598540146,0.09596905067446103,0.83692361147563
15,122,4,141,0.10948905109489052,0.9716312056737588,0.09034788521625603,0.8421876967582166
6,97,2,105,0.05825242718446602,0.9809523809523809,0.07581251767117976,0.861938518435202
46,170,6,222,0.21296296296296297,0.972972972972973,0.09433103618969826,0.8580775145741981
7,71,1,79,0.08974358974358974,0.9873417721518988,0.101072521654588,0.944091210361706
2,46,5,53,0.041666666666666664,0.9056603773584906,0.0963106168926832,0.9544236452224426
2,27,8,37,0.06896551724137931,0.7837837837837838,0.09570987196897783,0.9411062789638999
3,152,4,159,0.01935483870967742,0.9748427672955975,0.08577643622909048,0.9395978943126976
20,97,14,131,0.17094017094017094,0.8931297709923665,0.09455516763555911,0.9283834036439271
28,79,18,125,0.2616822429906542,0.856,0.12361656989358598,0.9105330635078728
12,87,2,101,0.12121212121212122,0.9801980198019802,0.11050930678632288,0.9115652130548738
9,55,1,65,0.140625,0.9846153846153847,0.11777807968009577,0.9111757291210861
2,113,4,119,0.017391304347826087,0.9663865546218487,0.11431017077740425,0.9198508973015659
11,35,1,47,0.2391304347826087,0.9787234042553191,0.1386194447118656,0.9476994145117851
17,82,1,100,0.1717171717171717,0.99,0.1603854922843648,0.9498647334695569
6,21,1,28,0.2222222222222222,0.9642857142857143,0.1677114996103721,0.9600298682257494
8,62,8,78,0.11428571428571428,0.8974358974358975,0.14665485265252354,0.9659492821451633
16,36,1,53,0.3076923076923077,0.9811320754716981,0.1732948792925502,0.9660827186694088
0,1,59,60,0.0,0.016666666666666666,0.1532055935782645,0.8278043303910205
8,160,13,181,0.047619047619047616,0.9281767955801105,0.1575238426170104,0.8223457933850579
28,161,11,200,0.14814814814814814,0.945,0.14452637309780175,0.8175281642057266
37,95,11,143,0.2803030303030303,0.9230769230769231,0.16003863861006726,0.8079677246452871
2,54,7,63,0.03571428571428571,0.8888888888888888,0.13339464768036205,0.7971967495885977
27,177,6,210,0.1323529411764706,0.9714285714285714,0.13597568009332722,0.8077671315875511
1,2,64,67,0.3333333333333333,0.04477611940298507,0.1396386837563309,0.6740019950063063
4,10,1,15,0.2857142857142857,0.9333333333333333,0.18045501028694316,0.8049543759586874
21,46,2,69,0.31343283582089554,0.9710144927536232,0.21842840860149287,0.8110740469834749
2,58,3,63,0.03333333333333333,0.9523809523809523,0.20202629219937646,0.8121284687521824
40,70,32,142,0.36363636363636365,0.7746478873239436,0.21393105410413835,0.7909243207874709
154,431,5,590,0.26324786324786326,0.9915254237288136,0.24643585089464942,0.8055866829074603
0,52,1,53,0.0,0.9811320754716981,0.22752828786943935,0.8069728977707641
20,66,9,95,0.23255813953488372,0.9052631578947369,0.21313183161251797,0.9298996175553
2,0,0,2,1.0,1.0,0.3151726479390486,0.9394234270791095
2,14,1,17,0.125,0.9411764705882353,0.2882536713932064,0.9351608524840541
9,84,2,95,0.0967741935483871,0.9789473684210527,0.2973166514239284,0.938956054775497
17,106,20,143,0.13821138211382114,0.8601398601398601,0.2651130826349937,0.9511691937491994
16,39,4,59,0.2909090909090909,0.9322033898305084,0.26906468658659766,0.942694617478013
3,25,2,30,0.10714285714285714,0.9333333333333333,0.28437080903557727,0.9358662257439609
1,23,0,24,0.041666666666666664,1.0,0.25626425021405436,0.9505886655737564
33,71,13,117,0.3173076923076923,0.8888888888888888,0.15873677768658181,0.9347156497007404
17,91,2,110,0.1574074074074074,0.9818181818181818,0.16336640731621146,0.9405216084478756
29,94,3,126,0.23577235772357724,0.9761904761904762,0.18595247228920514,0.939841336339032
123,283,13,419,0.30295566502463056,0.9689737470167065,0.21151313761387552,0.9554090144842757
6,86,13,105,0.06521739130434782,0.8761904761904762,0.1748250651851988,0.9467922344389245
4,35,1,40,0.10256410256410256,0.975,0.17469875471406077,0.952437395729247
0,12,2,14,0.0,0.8571428571428571,0.1687463737616798,0.9320292324639409
2,12,2,16,0.14285714285714285,0.875,0.1438248666973156,0.9300451054798139
31,222,15,268,0.1225296442687747,0.9440298507462687,0.13884232910608235,0.9246467724695406
37,115,15,167,0.24342105263157895,0.9101796407185628,0.13993499980722543,0.9152166531164101
1,25,0,26,0.038461538461538464,1.0,0.10215012458392657,0.9196489749711664
2,44,80,126,0.043478260869565216,0.36507936507936506,0.09904453452181479,0.8466331019552932
4,40,8,52,0.09090909090909091,0.8461538461538461,0.0973795328568131,0.8282265085486998
13,167,25,205,0.07222222222222222,0.8780487804878049,0.1076969931742734,0.8312130690265496
12,151,2,165,0.0736196319018405,0.9878787878787879,0.0978059201806588,0.8473386101520906
18,128,4,150,0.1232876712328767,0.9733333333333334,0.0979142097469591,0.8515248219502427
4,112,2,118,0.034482758620689655,0.9830508474576272,0.06806588203111776,0.8619349943415376
46,170,6,222,0.21296296296296297,0.972972972972973,0.0929946569598927,0.8580739904805338
8,92,1,101,0.08,0.9900990099009901,0.09821204826424053,0.9473625111693373
3,52,5,60,0.05454545454545454,0.9166666666666666,0.09301724306943533,0.9574357712425975
2,29,8,39,0.06451612903225806,0.7948717948717948,0.09191637261372614,0.9455533447260246
3,157,4,164,0.01875,0.975609756097561,0.08407785377060609,0.943800625900135
20,106,14,140,0.15873015873015872,0.9,0.0891410662702178,0.9333244354239446
29,90,21,140,0.24369747899159663,0.85,0.11902888346606166,0.9143171715014263
14,92,2,108,0.1320754716981132,0.9814814814814815,0.10747352757108311,0.9155326727169276
9,57,1,67,0.13636363636363635,0.9850746268656716,0.11552547562303117,0.9148149037118821
2,126,4,132,0.015625,0.9696969696969697,0.10996541068796624,0.9223906612876397
12,37,1,50,0.24489795918367346,0.98,0.13573424356673988,0.9488375477345261
16,84,1,101,0.16,0.9900990099009901,0.1559128149953113,0.9509074411350159
7,22,1,30,0.2413793103448276,0.9666666666666667,0.16771983665454973,0.9604312506588254
10,77,9,96,0.11494252873563218,0.90625,0.14932627233226906,0.9684669649445398
19,35,1,55,0.35185185185185186,0.9818181818181818,0.18072289806851743,0.9685150649926398
0,4,59,63,0.0,0.06349206349206349,0.16124237858799795,0.8368604130821244
7,188,13,208,0.035897435897435895,0.9375,0.16413844085906024,0.8322608459825573
30,192,11,233,0.13513513513513514,0.9527896995708155,0.14845803742355476,0.8283736602069596
35,106,12,153,0.24822695035460993,0.9215686274509803,0.16106188747421332,0.8185836055712439
1,62,2,65,0.015873015873015872,0.9692307692307692,0.1288467025496688,0.8189499059375442
26,197,6,229,0.11659192825112108,0.9737991266375546,0.1290823310518815,0.8285997811714807
1,1,65,67,0.5,0.029850746268656716,0.15024635221590263,0.6926044332358341
4,10,1,15,0.2857142857142857,0.9333333333333333,0.1910626787465149,0.816867471784587
21,64,2,87,0.24705882352941178,0.9770114942528736,0.2212285912653686,0.8225119709635689
1,61,3,65,0.016129032258064516,0.9538461538461539,0.20422771942578707,0.822662893002903
35,75,32,142,0.3181818181818182,0.7746478873239436,0.2142212719725311,0.8016742158418977
149,439,5,593,0.2534013605442177,0.9915682967959528,0.24815389263984566,0.8048652912083526
0,58,1,59,0.0,0.9830508474576272,0.23149790288968553,0.8061869656112199
20,77,9,106,0.20618556701030927,0.9150943396226415,0.1895244124625868,0.9326503360903607
2,0,0,2,1.0,1.0,0.29156522878911745,0.9421741456141702
2,14,1,17,0.125,0.9411764705882353,0.2741282539992015,0.9370548565192218
10,93,2,105,0.0970873786407767,0.9809523809523809,0.28569373205387466,0.9409271746772543
16,113,21,150,0.12403100775193798,0.86,0.2579579019924632,0.9531203336309766
17,42,4,63,0.288135593220339,0.9365079365079365,0.2629199352319091,0.9452545678755458
3,26,2,31,0.10344827586206896,0.9354838709677419,0.2776982603550618,0.9384592855198479
1,23,0,24,0.041666666666666664,1.0,0.25569728546411097,0.9524934274785182
33,71,13,117,0.3173076923076923,0.8888888888888888,0.15816981293663845,0.9366204116055022
18,90,2,110,0.16666666666666666,0.9818181818181818,0.1641221938890194,0.9424263703526375
29,94,3,126,0.23577235772357724,0.9761904761904762,0.1880952214140242,0.941746098243794
125,282,12,419,0.3071253071253071,0.9713603818615751,0.21343155209386633,0.9557499623192571
7,85,13,105,0.07608695652173914,0.8761904761904762,0.17829627469624557,0.9471331822739055
4,35,1,40,0.10256410256410256,0.975,0.17816996422510747,0.9527783435642282
0,12,2,14,0.0,0.8571428571428571,0.17221758327272654,0.932370180298922
2,12,2,16,0.14285714285714285,0.875,0.14729607620836233,0.930386053314795
30,223,14,267,0.11857707509881422,0.947565543071161,0.14042613455581196,0.9254928192080778
37,118,15,170,0.23870967741935484,0.9117647058823529,0.1408457516552088,0.9162891377354887
1,25,0,26,0.038461538461538464,1.0,0.1024652132746704,0.9203805117552637
2,45,79,126,0.0425531914893617,0.373015873015873,0.09767467541290219,0.8484984255874634
4,40,8,52,0.09090909090909091,0.8461538461538461,0.09600967374790052,0.8300918321808698
12,170,23,205,0.06593406593406594,0.8878048780487805,0.10542882602419566,0.8344721208817162
13,150,2,165,0.07975460122699386,0.9878787878787879,0.09641417721988865,0.8505976620072573
19,127,4,150,0.13013698630136986,0.9733333333333334,0.09806559310596803,0.8542787749018533
4,112,2,118,0.034482758620689655,0.9830508474576272,0.068890318991873,0.8644625094126068
46,170,6,222,0.21296296296296297,0.972972972972973,0.09381909392064793,0.8606015055516029
8,92,1,101,0.08,0.9900990099009901,0.09916863799359628,0.9487562393923339
2,53,5,60,0.03636363636363636,0.9166666666666666,0.09137643020138848,0.958829499465594
2,29,8,39,0.06451612903225806,0.7948717948717948,0.09117386778684448,0.9455533447260247
3,157,4,164,0.01875,0.975609756097561,0.08245892475441681,0.943800625900135
20,106,14,140,0.15873015873015872,0.9,0.0865436636728152,0.9333244354239445
29,91,20,140,0.24166666666666667,0.8571428571428571,0.1161413648222405,0.9153375796646916
13,93,2,108,0.12264150943396226,0.9814814814814815,0.10323830003238324,0.9165530808801928
9,57,1,67,0.13636363636363635,0.9850746268656716,0.1112902480843313,0.9158353118751474
2,124,6,132,0.015873015873015872,0.9545454545454546,0.10836301658567124,0.9212465672864028
12,37,1,50,0.24489795918367346,0.98,0.13413184946444484,0.9476934537332893
16,84,1,101,0.16,0.9900990099009901,0.1543104208930163,0.9497633471337792
7,22,1,30,0.2413793103448276,0.9666666666666667,0.1661174425522547,0.9592871566575888
10,76,10,96,0.11627906976744186,0.8958333333333334,0.14820492870950827,0.9648143675419424
18,36,1,55,0.3333333333333333,0.9818181818181818,0.17830376069513273,0.9648624675900423
0,4,59,63,0.0,0.06349206349206349,0.15882324121461325,0.8332078156795271
6,189,13,208,0.03076923076923077,0.9375,0.16095127191407252,0.8307727507444621
31,191,11,233,0.13963963963963963,0.9527896995708155,0.1459143691220677,0.8268855649688643
35,106,12,153,0.24822695035460993,0.9215686274509803,0.15851821917272627,0.8170955103331485
2,61,2,65,0.031746031746031744,0.9692307692307692,0.12857060794432684,0.8174618106994489
26,197,6,229,0.11659192825112108,0.9737991266375546,0.1286153020134239,0.8285997811714806
1,1,65,67,0.5,0.029850746268656716,0.1524248258229477,0.6926044332358342
4,10,1,15,0.2857142857142857,0.9333333333333333,0.19324115235355993,0.816867471784587
22,63,2,87,0.25882352941176473,0.9770114942528736,0.22582033787392192,0.8225119709635689
1,61,3,65,0.016129032258064516,0.9538461538461539,0.20817596539083977,0.822662893002903
36,75,32,143,0.32432432432432434,0.7762237762237763,0.21904701881508468,0.8018993428275881
156,432,5,593,0.2653061224489796,0.9915682967959528,0.252412746058363,0.8050904181940429
0,58,1,59,0.0,0.9830508474576272,0.23575675630820278,0.8064120925969105
20,77,9,106,0.20618556701030927,0.9150943396226415,0.19378326588110412,0.9328754630760511
2,0,0,2,1.0,1.0,0.29582408220763473,0.9423992725998607
2,14,1,17,0.125,0.9411764705882353,0.2767064351488112,0.9372799835049123
8,95,2,105,0.07766990291262135,0.9809523809523809,0.2854979880994622,0.9411523016629447
16,113,21,150,0.12403100775193798,0.86,0.2568846571605498,0.9531203336309767
19,40,4,63,0.3220338983050847,0.9365079365079365,0.26498862513999344,0.9452545678755457
3,26,2,31,0.10344827586206896,0.9354838709677419,0.2797669502631462,0.9384592855198478
1,23,0,24,0.041666666666666664,1.0,0.25487728766204326,0.9505886655737562
34,69,14,117,0.3300970873786408,0.8803418803418803,0.15917687157327767,0.9334946484797391
21,87,2,110,0.19444444444444445,0.9818181818181818,0.16909750649391259,0.9393006072268744
30,93,3,126,0.24390243902439024,0.9761904761904762,0.1942319742047478,0.9386203351180308
126,280,13,419,0.3103448275862069,0.9689737470167065,0.22084823418107194,0.9541880132632746
7,85,13,105,0.07608695652173914,0.8761904761904762,0.1857129567834511,0.9455712332179231
4,35,1,40,0.10256410256410256,0.975,0.18558664631231306,0.9512163945082458
0,12,2,14,0.0,0.8571428571428571,0.1796342653599321,0.9308082312429395
2,13,1,16,0.13333333333333333,0.9375,0.1515251576391739,0.9389736769083853
32,220,15,267,0.12698412698412698,0.9438202247191011,0.14188796943055712,0.9335453973228022
36,119,15,170,0.23225806451612904,0.9117647058823529,0.14022448735794837,0.9243417158502132
2,24,0,26,0.07692307692307693,1.0,0.10687852297750124,0.9287740377049695
2,49,75,126,0.0392156862745098,0.40476190476190477,0.10161119865646848,0.8614270989294593
4,40,8,52,0.09090909090909091,0.8461538461538461,0.09994619699146681,0.8430205055228658
10,172,23,205,0.054945054945054944,0.8878048780487805,0.1077954905550461,0.8474007942237121
13,150,2,165,0.07975460122699386,0.9878787878787879,0.10014138596842617,0.8545977639206818
18,128,4,150,0.1232876712328767,0.9733333333333334,0.0996133208611047,0.8588139222941434
5,111,2,118,0.04310344827586207,0.9830508474576272,0.07259123282678084,0.8689976568048969
45,170,7,222,0.20930232558139536,0.9684684684684685,0.09150255406368347,0.8644931523003925
8,92,1,101,0.08,0.9900990099009901,0.09732888459589636,0.9481127387488332
1,54,5,60,0.01818181818181818,0.9166666666666666,0.08693927420628597,0.9581859988220932
2,29,8,39,0.06451612903225806,0.7948717948717948,0.08830657050445782,0.944909844082524
3,157,4,164,0.01875,0.975609756097561,0.07959162747203015,0.9431571252566344
20,105,15,140,0.16,0.8928571428571429,0.08483624586733349,0.9316605266171786
31,87,22,140,0.2627118644067797,0.8428571428571429,0.11620887674317884,0.9116328545313951
14,92,2,108,0.1320754716981132,0.9814814814814815,0.10517646904556711,0.913491856390397
9,57,1,67,0.13636363636363635,0.9850746268656716,0.11322841709751516,0.9127740873853514
3,125,4,132,0.0234375,0.9696969696969697,0.11397922878582685,0.9203498449611092
12,37,1,50,0.24489795918367346,0.98,0.1397480616646005,0.9467967314079955
16,84,1,101,0.16,0.9900990099009901,0.1599266330931719,0.9488666248084854
6,23,1,30,0.20689655172413793,0.9666666666666667,0.16662614048233446,0.9594108424955603
10,77,9,96,0.11494252873563218,0.90625,0.14551623538645625,0.9684669649445398
19,35,1,55,0.35185185185185186,0.9818181818181818,0.17691286112270463,0.9685150649926398
0,4,59,63,0.0,0.06349206349206349,0.15743234164218517,0.8368604130821244
7,188,13,208,0.035897435897435895,0.9375,0.15921233248467598,0.8322608459825572
30,192,11,233,0.13513513513513514,0.9527896995708155,0.14353192904917053,0.8283736602069595
36,105,12,153,0.2553191489361702,0.9215686274509803,0.15714895032576628,0.8185836055712439
2,56,7,65,0.034482758620689655,0.8923076923076924,0.13251840845384508,0.8079608949485333
25,198,6,229,0.11210762331838565,0.9737991266375546,0.132113421965667,0.8176107701824696
1,2,64,67,0.3333333333333333,0.04477611940298507,0.12946791932016435,0.6837476184088701
4,10,1,15,0.2857142857142857,0.9333333333333333,0.1702842458507766,0.808010656957623
22,63,2,87,0.25882352941176473,0.9770114942528736,0.20213083063853785,0.8136551561366049
1,61,3,65,0.016129032258064516,0.9538461538461539,0.18512995879895633,0.813806078175939
38,72,33,143,0.34545454545454546,0.7692307692307693,0.1980064440158671,0.7920435270016231
159,429,5,593,0.27040816326530615,0.9915682967959528,0.2317100732508123,0.8062236133570888
0,58,1,59,0.0,0.9830508474576272,0.21569469849104292,0.8075452877599564
20,77,9,106,0.20618556701030927,0.9150943396226415,0.1975307318734681,0.9318764620770501
2,0,0,2,1.0,1.0,0.29957154819999865,0.9414002716008597
2,14,1,17,0.125,0.9411764705882353,0.28045390114117513,0.9362809825059113
7,96,2,105,0.06796116504854369,0.9809523809523809,0.287858491539815,0.9401533006639438
17,114,19,150,0.1297709923664122,0.8733333333333333,0.25704655538436744,0.9550250955357386
19,40,4,63,0.3220338983050847,0.9365079365079365,0.2644216603900501,0.9471593297803077
3,26,2,31,0.10344827586206896,0.9354838709677419,0.2791999855132028,0.9403640474246098
1,23,0,24,0.041666666666666664,1.0,0.255775334805369,0.9515410465261372
34,69,14,117,0.3300970873786408,0.8803418803418803,0.16007491871660337,0.9344470294321201
21,87,2,110,0.19444444444444445,0.9818181818181818,0.16999555363723834,0.9402529881792553
30,93,3,126,0.24390243902439024,0.9761904761904762,0.19651698390008465,0.9395727160704117
128,278,13,419,0.31527093596059114,0.9689737470167065,0.22397327145489435,0.9541880132632746
5,87,13,105,0.05434782608695652,0.8761904761904762,0.18331109648910848,0.9455712332179231
4,35,1,40,0.10256410256410256,0.975,0.18318478601797045,0.9512163945082458
0,12,2,14,0.0,0.8571428571428571,0.1772324050655895,0.9308082312429395
1,14,1,16,0.06666666666666667,0.9375,0.13959948782102174,0.9389736769083853
25,227,15,267,0.0992063492063492,0.9438202247191011,0.125994045644151,0.9335453973228022
36,119,15,170,0.23225806451612904,0.9117647058823529,0.12433056357154226,0.9243417158502132
2,24,0,26,0.07692307692307693,1.0,0.09028086942332594,0.9287740377049695
2,47,77,126,0.04081632653061224,0.3888888888888889,0.08834779805813389,0.8591595252333141
4,40,8,52,0.09090909090909091,0.8461538461538461,0.08668279639313224,0.8407529318267208
12,170,23,205,0.06593406593406594,0.8878048780487805,0.09610194866942737,0.8451332205275669
13,150,2,165,0.07975460122699386,0.9878787878787879,0.09797165360661697,0.8523301902245366
16,131,3,150,0.10884353741496598,0.98,0.09934839477927651,0.8574987295503794
5,111,2,118,0.04310344827586207,0.9830508474576272,0.07232630674495266,0.8676824640611328
45,170,7,222,0.20930232558139536,0.9684684684684685,0.0912376279818553,0.8631779595566282
8,92,1,101,0.08,0.9900990099009901,0.09683529562033924,0.9490651197012142
1,58,1,60,0.01694915254237288,0.9833333333333333,0.08626959013937954,0.9686621892982837
2,29,8,39,0.06451612903225806,0.7948717948717948,0.08606702772483556,0.9553860345587143
3,157,4,164,0.01875,0.975609756097561,0.07735208469240787,0.9536333157328248
20,104,16,140,0.16129032258064516,0.8857142857142857,0.08484448257321918,0.9401639279777229
29,91,20,140,0.24166666666666667,0.8571428571428571,0.11321065662904839,0.9221770722184699
13,93,2,108,0.12264150943396226,0.9814814814814815,0.10083054003655796,0.9240360740774719
9,57,1,67,0.13636363636363635,0.9850746268656716,0.10888248808850601,0.9233183050724263
3,125,4,132,0.0234375,0.9696969696969697,0.10980939486816703,0.9213702531243744
12,37,1,50,0.24489795918367346,0.98,0.13557822774694064,0.9478171395712609
17,83,1,101,0.17,0.9900990099009901,0.15718537060408352,0.9498870329717508
4,25,1,30,0.13793103448275862,0.9666666666666667,0.15384832944724258,0.9614516588220907
11,75,10,96,0.12790697674418605,0.8958333333333334,0.1375969451726025,0.9669788697064446
18,36,1,55,0.3333333333333333,0.9818181818181818,0.16769577715822695,0.9670269697545446
0,4,59,63,0.0,0.06349206349206349,0.14821525767770746,0.8353723178440292
6,193,9,208,0.03015075376884422,0.9567307692307693,0.1491742939303995,0.8335200034917148
31,191,11,233,0.13963963963963963,0.9527896995708155,0.13413739113839465,0.829632817716117
39,103,11,153,0.2746478873239437,0.9281045751633987,0.14908708932752943,0.820776469896461
2,56,7,65,0.034482758620689655,0.8923076923076924,0.13430876420437673,0.8101537592737506
27,196,6,229,0.1210762331838565,0.9737991266375546,0.13333294369575824,0.8212917297457821
1,3,63,67,0.25,0.05970149253731343,0.12142818179099633,0.6895607741342296
4,10,1,15,0.2857142857142857,0.9333333333333333,0.16224450832160858,0.8138238126829823
22,63,2,87,0.25882352941176473,0.9770114942528736,0.19491204769916864,0.8167210591147115
2,60,3,65,0.03225806451612903,0.9538461538461539,0.17957182268152425,0.8168719811540457
36,74,33,143,0.32727272727272727,0.7692307692307693,0.1870896569599219,0.79417572316367
149,438,5,592,0.25383304940374785,0.9915540540540541,0.2184254127860731,0.8083537748417217
0,58,1,59,0.0,0.9830508474576272,0.2011288080455222,0.8096754492445892
20,77,9,106,0.20618556701030927,0.9150943396226415,0.19486960333270922,0.931874427399636
2,0,0,2,1.0,1.0,0.2969104196592398,0.9413982369234455
2,14,1,17,0.125,0.9411764705882353,0.2777927726004163,0.9362789478284972
7,96,2,105,0.06796116504854369,0.9809523809523809,0.2828932155336184,0.9401512659865296
16,113,21,150,0.12403100775193798,0.86,0.25385868417350566,0.9531182989535625
19,40,4,63,0.3220338983050847,0.9365079365079365,0.26360166258798234,0.9452545678755457
3,26,2,31,0.10344827586206896,0.9354838709677419,0.27837998771113504,0.9384592855198478
1,23,0,24,0.041666666666666664,1.0,0.2608025614938058,0.950399061329428
35,70,12,117,0.3333333333333333,0.8974358974358975,0.16556446625571059,0.9357470466774133
20,88,2,110,0.18518518518518517,0.9818181818181818,0.1741623498535942,0.9415530054245487
28,95,3,126,0.22764227642276422,0.9761904761904762,0.20053828181567876,0.9411591636773233
130,278,11,419,0.31862745098039214,0.9737470167064439,0.22531916190965187,0.9563897564735486
5,87,13,105,0.05434782608695652,0.8761904761904762,0.1811350851168794,0.9483879116678297
4,35,1,40,0.10256410256410256,0.975,0.18048097731991447,0.9543402926202107
0,13,1,14,0.0,0.9285714285714286,0.1745285963675335,0.9441362109875575
1,14,1,16,0.06666666666666667,0.9375,0.1364333582722954,0.9498596542110008
26,226,15,267,0.10317460317460317,0.9438202247191011,0.12471756084221228,0.9444313746254178
39,116,15,170,0.25161290322580643,0.9117647058823529,0.12814193609978974,0.9352276931528288
2,24,0,26,0.07692307692307693,1.0,0.09361273980588757,0.9389781193376224
2,75,49,126,0.025974025974025976,0.6111111111111112,0.08955933978975462,0.901109638611999
4,47,1,52,0.0784313725490196,0.9807692307692307,0.08611180693045707,0.9019338144361748
10,173,23,206,0.0546448087431694,0.8883495145631068,0.09391820817948127,0.8961878267207003
14,149,2,165,0.08588957055214724,0.9878787878787879,0.0966643373059785,0.9033847964176701
17,130,3,150,0.11564625850340136,0.98,0.09844600235294966,0.9085533357435126
7,108,2,117,0.06086956521739131,0.9829059829059829,0.07119695406603321,0.918716375318317
45,170,7,222,0.20930232558139536,0.9684684684684685,0.09010827530293584,0.9142118708138126
9,91,1,101,0.09,0.9900990099009901,0.09925484302093213,0.9683529992123666
2,57,1,60,0.03389830508474576,0.9833333333333333,0.09289297624032158,0.9687192995786669
2,29,8,39,0.06451612903225806,0.7948717948717948,0.09430316485304854,0.9553653396227652
3,157,4,164,0.01875,0.975609756097561,0.08471179763131322,0.9536126207968757
20,106,14,140,0.15873015873015872,0.9,0.09086664052084999,0.9421840493683042
29,91,20,140,0.24166666666666667,0.8571428571428571,0.11669479787074646,0.9242178885450006
13,93,2,108,0.12264150943396226,0.9814814814814815,0.10431468127825602,0.9260768904040023
9,57,1,67,0.13636363636363635,0.9850746268656716,0.11093805790163265,0.9253591213989569
5,123,4,132,0.0390625,0.9696969696969697,0.11167580003238324,0.923411069450905
11,38,1,50,0.22448979591836735,0.98,0.13452918101611314,0.9498579558977914
17,83,1,101,0.17,0.9900990099009901,0.15613632387325602,0.9519278492982813
5,24,1,30,0.1724137931034483,0.9666666666666667,0.15809112878372594,0.9614516588220908
11,81,4,96,0.11956521739130435,0.9583333333333334,0.14064806460153131,0.975907441135016
18,36,1,55,0.3333333333333333,0.9818181818181818,0.17074689658715575,0.9759555411831161
0,4,59,63,0.0,0.06349206349206349,0.1512663771066363,0.8443008892726007
6,193,9,208,0.03015075376884422,0.9567307692307693,0.14999327050218544,0.8424485749202864
31,192,10,233,0.13901345291479822,0.9570815450643777,0.13778236435881844,0.8391745099294831
36,106,11,153,0.2535211267605634,0.9281045751633987,0.14971395389604178,0.8303181621098271
3,55,7,65,0.05172413793103448,0.8923076923076924,0.13247257458569694,0.8196954514871165
24,199,6,229,0.10762331838565023,0.9737991266375546,0.13076658901346064,0.8219048505305767
9,57,1,67,0.13636363636363635,0.9850746268656716,0.1026280608749325,0.8223700569659324
4,10,1,15,0.2857142857142857,0.9333333333333333,0.14344438740554472,0.9466330955146852
21,64,2,87,0.24705882352941178,0.9770114942528736,0.17443125451419725,0.9495303419464144
3,59,3,65,0.04838709677419355,0.9538461538461539,0.16148463220839657,0.9490681432009539
38,76,29,143,0.3333333333333333,0.7972027972027972,0.17288637600450657,0.9303678892065823
145,442,5,592,0.24701873935264054,0.9915540540540541,0.20078560477902174,0.944545940884634
0,58,1,59,0.0,0.9830508474576272,0.18541084500964314,0.9458676152875015
20,77,9,106,0.20618556701030927,0.9150943396226415,0.1953854065305964,0.93587043139564
2,0,0,2,1.0,1.0,0.29742622285712705,0.9453942409194495
2,14,1,17,0.125,0.9411764705882353,0.2799892480672111,0.9402749518245013
6,97,2,105,0.05825242718446602,0.9809523809523809,0.2813985809829643,0.9441472699825336
16,114,20,150,0.12307692307692308,0.8666666666666667,0.25136195094633423,0.9540706799059435
20,39,4,63,0.3389830508474576,0.9365079365079365,0.2644997097313081,0.9462069488279268
3,26,2,31,0.10344827586206896,0.9354838709677419,0.2792780348544608,0.9394116664722288
1,22,0,23,0.043478260869565216,1.0,0.2638273594190587,0.949400060330427
33,60,15,108,0.3548387096774194,0.8611111111111112,0.1716614608015472,0.9295587904891571
22,65,2,89,0.25287356321839083,0.9775280898876404,0.18992911268988874,0.9347518789605006
27,75,3,105,0.2647058823529412,0.9714285714285714,0.2215998454991415,0.9336777651044319
135,234,13,382,0.36585365853658536,0.9659685863874345,0.2529587305165631,0.9487961545683712
3,80,13,96,0.03614457831325301,0.8645833333333334,0.2035767871587161,0.9391361464973461
4,28,1,33,0.125,0.9696969696969697,0.20612780756687937,0.9443309516921514
0,12,2,14,0.0,0.8571428571428571,0.1999166274426558,0.9239227884268452
0,8,2,10,0.0,0.8,0.14922538320302442,0.9151926296966865
21,193,15,229,0.09813084112149532,0.9344978165938864,0.12711928004632508,0.9090454477975788
38,101,15,154,0.2733812949640288,0.9025974025974026,0.12835862470505188,0.8992124236788405
2,22,0,24,0.08333333333333333,1.0,0.08799857824744446,0.9040740541949212
2,39,81,122,0.04878048780487805,0.3360655737704918,0.08980370817481945,0.8285715171145152
3,37,8,48,0.075,0.8333333333333334,0.08266085103196232,0.809090997633996
10,156,22,188,0.060240963855421686,0.8829787234042553,0.09126670301130826,0.8127818356713384
12,122,2,136,0.08955223880597014,0.9852941176470589,0.1040598799835897,0.8392524239066326
17,121,3,141,0.12318840579710146,0.9787234042553191,0.10763953208010489,0.8455703650011229
4,97,2,103,0.039603960396039604,0.9805825242718447,0.07424276999896355,0.8567110966689003
46,170,6,222,0.21296296296296297,0.972972972972973,0.09276128851748208,0.8528500928078966
8,70,1,79,0.10256410256410256,0.9873417721518988,0.10044466205451415,0.9458895497195261
2,49,1,52,0.0392156862745098,0.9807692307692307,0.095332617236587,0.966951820781797
2,27,8,37,0.06896551724137931,0.7837837837837838,0.09657898200600952,0.9527811151217297
3,151,4,158,0.01948051948051948,0.9746835443037974,0.08656873638808797,0.9512653189298351
20,97,14,131,0.17094017094017094,0.8931297709923665,0.09339041712281218,0.9390376570351278
29,74,21,124,0.2815533980582524,0.8306451612903226,0.1279546225031283,0.9176180337520531
13,85,2,100,0.1326530612244898,0.98,0.11648177939763214,0.9186218947559143
10,55,1,66,0.15384615384615385,0.9848484848484849,0.12380778672363946,0.9182657108554263
5,110,4,119,0.043478260869565216,0.9663865546218487,0.12441672595150452,0.9162110428343718
10,36,1,47,0.21739130434782608,0.9787234042553191,0.14562040982385407,0.9440595600445912
17,82,1,100,0.1717171717171717,0.99,0.16736850300051867,0.9462476251440487
4,23,1,28,0.14814814814814814,0.9642857142857143,0.1641124997445154,0.9564127599002411
9,60,9,78,0.13043478260869565,0.8846153846153846,0.14252412610886447,0.9641227918038215
19,33,1,53,0.36538461538461536,0.9811320754716981,0.17577149098888237,0.964284516871207
0,1,59,60,0.0,0.016666666666666666,0.1537934690108604,0.8259728285595187
6,167,9,182,0.03468208092485549,0.9505494505494505,0.15253687187590187,0.8237103851206047
30,160,11,201,0.15789473684210525,0.945273631840796,0.14403736223222746,0.8189318462042442
36,97,13,146,0.2706766917293233,0.910958904109589,0.1581744365196777,0.8076402610770426
2,54,7,63,0.03571428571428571,0.8888888888888888,0.14211245617198306,0.7968692860203533
26,175,6,207,0.12935323383084577,0.9710144927536232,0.1419579492037188,0.8092120157543874
1,2,64,67,0.3333333333333333,0.04477611940298507,0.13737919462496423,0.6754468791731426
4,10,1,15,0.2857142857142857,0.9333333333333333,0.17819552115557644,0.8063992601255237
21,46,2,69,0.31343283582089554,0.9710144927536232,0.21801705756929643,0.8093228375832625
1,59,3,63,0.016666666666666666,0.9523809523809523,0.19784161897280525,0.8103381690889992
39,72,32,143,0.35135135135135137,0.7762237762237763,0.20936657034738068,0.7910902936767402
156,428,5,589,0.2671232876712329,0.9915110356536503,0.24242499919837313,0.8057506003574204
0,52,1,53,0.0,0.9811320754716981,0.22394596579396658,0.8071959693171454
20,66,9,95,0.23255813953488372,0.9052631578947369,0.2095495095370452,0.9301226891016814
2,0,0,2,1.0,1.0,0.3115903258635758,0.9396464986254909
2,14,1,17,0.125,0.9411764705882353,0.28467134931773364,0.9353839240304355
4,89,2,95,0.043010752688172046,0.9789473684210527,0.28843479017794865,0.9391791263218784
18,106,19,143,0.14516129032258066,0.8671328671328671,0.25897906717383856,0.9521661393088914
20,35,4,59,0.36363636363636365,0.9322033898305084,0.2727666494545715,0.9436936184770139
3,25,2,30,0.10714285714285714,0.9333333333333333,0.2880727719035511,0.9368652267429619
1,22,0,23,0.043478260869565216,1.0,0.26769566705304454,0.9486839036689945
33,61,15,109,0.35106382978723405,0.8623853211009175,0.17499049987979226,0.9290246638262684
20,67,2,89,0.22988505747126436,0.9775280898876404,0.1899740795185443,0.934217752297612
31,71,3,105,0.30392156862745096,0.9714285714285714,0.22229574604923427,0.9328572080799249
138,231,13,382,0.37398373983739835,0.9659685863874345,0.25659938492364326,0.9499003394686059
5,78,13,96,0.060240963855421686,0.8645833333333334,0.21435777927587057,0.9396253961579484
4,28,1,33,0.125,0.9696969696969697,0.21251048863547647,0.9445129816906952
0,12,2,14,0.0,0.8571428571428571,0.20629930851125286,0.9241048184253889
0,8,2,10,0.0,0.8,0.1561473328273623,0.9151926296966865
24,191,15,230,0.11162790697674418,0.9347826086956522,0.13925345418528798,0.9090861323835453
38,101,15,154,0.2733812949640288,0.9025974025974026,0.13489055794765623,0.899253108264807
3,21,0,24,0.125,1.0,0.09932145225659934,0.9041147387808878
2,41,79,122,0.046511627906976744,0.3524590163934426,0.09736011854967862,0.830954122075189
3,37,8,48,0.075,0.8333333333333334,0.09021726140682149,0.8114736025946695
11,156,22,189,0.0658682634730539,0.8835978835978836,0.09962701333154346,0.8152528920882448
14,120,2,136,0.1044776119402985,0.9852941176470589,0.11455238646587182,0.8417234803235389
16,121,4,141,0.11678832116788321,0.9716312056737588,0.1152895884931774,0.8469875656061256
4,98,2,104,0.0392156862745098,0.9807692307692307,0.08183735868038898,0.8581549696306724
45,171,6,222,0.20833333333333334,0.972972972972973,0.09374212058515087,0.8542939657696687
7,71,1,79,0.08974358974358974,0.9873417721518988,0.09991811513323845,0.9449915023065909
2,49,1,52,0.0392156862745098,0.9807692307692307,0.09480607031531128,0.966053773368862
3,26,8,37,0.10344827586206896,0.7837837837837838,0.10017464351374201,0.951794616252562
3,152,4,159,0.01935483870967742,0.9748427672955975,0.08801424733793899,0.9503015662023532
20,95,16,131,0.17391304347826086,0.8778625954198473,0.09617492195370723,0.9369060504517943
29,77,18,124,0.27358490566037735,0.8548387096774194,0.12965623900883116,0.9189159760101072
15,83,2,100,0.15306122448979592,0.98,0.12176022345975437,0.919919837013968
9,57,1,67,0.13636363636363635,0.9850746268656716,0.12842023011976103,0.9195959591159356
4,111,4,119,0.034782608695652174,0.9663865546218487,0.12778693332278138,0.9175412910948809
10,36,1,47,0.21739130434782608,0.9787234042553191,0.14406450882074667,0.9453898083051004
17,82,1,100,0.1717171717171717,0.99,0.16583055639324587,0.9475551272628723
4,23,1,28,0.14814814814814814,0.9642857142857143,0.1621498570603726,0.9599012871008533
9,60,9,78,0.13043478260869565,0.8846153846153846,0.14169983948156095,0.9641550978062767
18,34,1,53,0.34615384615384615,0.9811320754716981,0.16928449971928242,0.9643168228736622
0,1,59,60,0.0,0.016666666666666666,0.14980398023876296,0.8259728285595187
6,162,13,181,0.03571428571428571,0.9281767955801105,0.1499370769557106,0.820514291553556
30,159,12,201,0.15873015873015872,0.9402985074626866,0.1415569132960438,0.8150250205831799
38,95,12,145,0.2857142857142857,0.9172413793103448,0.15784221529563153,0.8046309319132293
1,56,7,64,0.017543859649122806,0.890625,0.13918445979577077,0.7941079727295558
25,175,6,206,0.125,0.970873786407767,0.13840806228024283,0.8064306015570389
1,2,64,67,0.3333333333333333,0.04477611940298507,0.13657656044874097,0.6726654649757942
4,10,1,15,0.2857142857142857,0.9333333333333333,0.17739288697935324,0.8036178459281752
20,47,2,69,0.29850746268656714,0.9710144927536232,0.21493476940396486,0.8097375169529627
0,60,3,63,0.0,0.9523809523809523,0.1922590324425136,0.811463580512715
38,72,32,142,0.34545454545454546,0.7746478873239436,0.2007933552625507,0.7910930816575148
153,375,61,589,0.2897727272727273,0.8964346349745331,0.23968319349449424,0.7919230295110194
0,52,1,53,0.0,0.9811320754716981,0.22182605063735136,0.7933884993772954
20,66,9,95,0.23255813953488372,0.9052631578947369,0.20742959438043002,0.9163152191618315
2,0,0,2,1.0,1.0,0.30947041070696063,0.9258390286856409
2,14,1,17,0.125,0.9411764705882353,0.2846836303231653,0.9215764540905855
4,89,2,95,0.043010752688172046,0.9789473684210527,0.29082802356433274,0.9253716563820283
18,105,20,143,0.14634146341463414,0.8601398601398601,0.26238329755863116,0.9375847953557308
21,34,4,59,0.38181818181818183,0.9322033898305084,0.27553264820798173,0.942694617478013
3,25,2,30,0.10714285714285714,0.9333333333333333,0.29083877065696134,0.9358662257439609
1,23,0,24,0.041666666666666664,1.0,0.26824781302468687,0.9505886655737562
35,68,14,117,0.33980582524271846,0.8803418803418803,0.17393435948793234,0.9334946484797391
21,87,2,110,0.19444444444444445,0.9818181818181818,0.18385499440856728,0.9393006072268744
31,92,3,126,0.25203252032520324,0.9761904761904762,0.20876393975322186,0.9386203351180308
133,272,12,417,0.32839506172839505,0.9712230215827338,0.23574396518285967,0.9545093382012786
4,88,13,105,0.043478260869565216,0.8761904761904762,0.19110768767996464,0.9458925581559271
4,35,1,40,0.10256410256410256,0.975,0.18605526883444234,0.9515377194462495
0,12,2,14,0.0,0.8571428571428571,0.18010288788206139,0.9311295561809435
1,13,1,15,0.07142857142857142,0.9333333333333333,0.1417632801943261,0.9386997637511512
21,232,15,268,0.08300395256916997,0.9440298507462687,0.12584320992642975,0.9333014307408778
36,120,15,171,0.23076923076923078,0.9122807017543859,0.1228055971327194,0.9241714629642933
3,23,0,26,0.11538461538461539,1.0,0.09237553336932228,0.9282824598810456
3,58,65,126,0.04918032786885246,0.48412698412698413,0.09319011436922046,0.8722733895862611
3,41,8,52,0.06818181818181818,0.8461538461538461,0.08827835945746555,0.8538667961796679
10,171,25,206,0.055248618784530384,0.8786407766990292,0.09617101928382706,0.8569379275448351
13,150,2,165,0.07975460122699386,0.9878787878787879,0.0973604521121731,0.8647301353370429
19,127,4,150,0.13013698630136986,0.9733333333333334,0.10409374264534452,0.868916347135195
4,112,2,118,0.034482758620689655,0.9830508474576272,0.07605281805269579,0.8790263679499439
45,171,6,222,0.20833333333333334,0.972972972972973,0.08933120633108405,0.8751653640889401
10,91,1,102,0.09900990099009901,0.9901960784313726,0.09644971677697643,0.947460948989567
4,55,1,60,0.06779661016949153,0.9833333333333333,0.09639468706092975,0.9670580185866365
2,29,8,39,0.06451612903225806,0.7948717948717948,0.09771861709631943,0.9550910211827458
4,156,4,164,0.025,0.975609756097561,0.08989653120674888,0.9533383023568563
20,106,14,140,0.15873015873015872,0.9,0.09398127012514727,0.9428621118806658
30,88,22,140,0.2542372881355932,0.8428571428571429,0.12537477434156208,0.9228344397948823
15,91,2,108,0.14150943396226415,0.9814814814814815,0.1158285030028379,0.9240499410103836
9,57,1,67,0.13636363636363635,0.9850746268656716,0.12116475091334324,0.9233183050724263
4,124,4,132,0.03125,0.9696969696969697,0.11594380660341587,0.9213702531243744
11,38,1,50,0.22448979591836735,0.98,0.1387971875871458,0.9478171395712608
16,84,1,101,0.16,0.9900990099009901,0.15808290187286006,0.9498870329717507
4,25,1,30,0.13793103448275862,0.9666666666666667,0.15511159840894576,0.9594108424955602
11,81,4,96,0.11956521739130435,0.9583333333333334,0.13587273115976164,0.975907441135016
16,38,1,55,0.2962962962962963,0.9818181818181818,0.15798514006462336,0.975955541183116
0,4,59,63,0.0,0.06349206349206349,0.1385046205841039,0.8443008892726006
7,188,13,208,0.035897435897435895,0.9375,0.1391685399980233,0.8397013221730335
29,193,11,233,0.13063063063063063,0.9527896995708155,0.12576008781406092,0.8358141363974356
37,102,13,152,0.26618705035971224,0.9144736842105263,0.14092966643687693,0.8250105184416551
3,60,2,65,0.047619047619047616,0.9692307692307692,0.1280279540277754,0.8253768188079557
25,198,6,229,0.11210762331838565,0.9737991266375546,0.12696258344592987,0.8275862178514156
1,1,65,67,0.5,0.029850746268656716,0.15606311254645894,0.6915908699157693
4,10,1,15,0.2857142857142857,0.9333333333333333,0.19687943907707117,0.8158539084645221
22,63,2,87,0.25882352941176473,0.9770114942528736,0.22872602386483248,0.8214984076435041
1,61,3,65,0.016129032258064516,0.9538461538461539,0.2123686526687516,0.8216493296828382
36,74,32,142,0.32727272727272727,0.7746478873239436,0.22109517794203942,0.8016742158418977
153,434,5,592,0.2606473594548552,0.9915540540540541,0.25152779391858343,0.8048632565309385
0,58,1,59,0.0,0.9830508474576272,0.23551241915881402,0.8061849309338059
21,77,9,107,0.21428571428571427,0.9158878504672897,0.19469609262820176,0.9327616601050391
2,0,0,2,1.0,1.0,0.29673690895473237,0.9422854696288488
2,14,1,17,0.125,0.9411764705882353,0.27761926189590885,0.9371661805339003
8,95,2,105,0.07766990291262135,0.9809523809523809,0.2864108148465598,0.9410384986919329
17,110,23,150,0.13385826771653545,0.8466666666666667,0.2587801777671038,0.9513268957408932
21,38,4,63,0.3559322033898305,0.9365079365079365,0.27239229832924317,0.9434631646628765
4,25,2,31,0.13793103448275862,0.9354838709677419,0.2920967318267801,0.9366678823071786
1,23,0,24,0.041666666666666664,1.0,0.2642933934505651,0.9505886655737562
35,68,14,117,0.33980582524271846,0.8803418803418803,0.1699799399138106,0.9334946484797391
19,90,2,111,0.1743119266055046,0.9819819819819819,0.17702450085745408,0.9393240072502743
30,93,3,126,0.24390243902439024,0.9761904761904762,0.20493289367231154,0.9386437351414308
132,273,12,417,0.32592592592592595,0.9712230215827338,0.23377502484002408,0.9545327382246785
5,87,13,105,0.05434782608695652,0.8761904761904762,0.18827023486213168,0.945915958179327
4,35,1,40,0.10256410256410256,0.975,0.18321781601660939,0.9515611194696497
0,12,2,14,0.0,0.8571428571428571,0.17726543506422843,0.9311529562043435
1,12,2,15,0.07692307692307693,0.8666666666666667,0.13971075673285105,0.9291993542507415
22,231,15,268,0.08695652173913043,0.9440298507462687,0.1272314131805119,0.9237776212170683
38,118,15,171,0.24358974358974358,0.9122807017543859,0.1271867424041338,0.9146476534404838
3,23,0,26,0.11538461538461539,1.0,0.09710941232680373,0.9187586503572361
4,47,75,126,0.0784313725490196,0.40476190476190477,0.1005499189642413,0.851411711581726
4,40,8,52,0.09090909090909091,0.8461538461538461,0.09888491729923965,0.8330051181751327
10,173,23,206,0.0546448087431694,0.8883495145631068,0.10669131854826384,0.8374632120923112
14,149,2,165,0.08588957055214724,0.9878787878787879,0.1079722462095596,0.8547792294083285
16,130,4,150,0.1095890410958904,0.9733333333333334,0.11120546326052531,0.8589654412064806
3,113,2,118,0.02586206896551724,0.9830508474576272,0.0801015097427787,0.8690754620212294
45,171,6,222,0.20833333333333334,0.972972972972973,0.09337989802116697,0.8652144581602255
10,91,1,102,0.09900990099009901,0.9901960784313726,0.09631968779846402,0.948847911541578
2,57,1,60,0.03389830508474576,0.9833333333333333,0.08817528982355759,0.9684449811386476
2,29,8,39,0.06451612903225806,0.7948717948717948,0.08958547843628452,0.9550910211827458
4,156,4,164,0.025,0.975609756097561,0.08088696835740636,0.9533383023568563
21,105,14,140,0.16666666666666666,0.9,0.08904091486751724,0.9428621118806658
30,91,19,140,0.24793388429752067,0.8642857142857143,0.12076545991494632,0.9258956642846784
15,91,2,108,0.14150943396226415,0.9814814814814815,0.11121918857622214,0.9271111655001796
9,57,1,67,0.13636363636363635,0.9850746268656716,0.11655543648672748,0.9263795295622222
4,124,4,132,0.03125,0.9696969696969697,0.11617710718890664,0.9244314776141703
12,37,1,50,0.24489795918367346,0.98,0.1419459400676803,0.9508783640610569
17,83,1,101,0.17,0.9900990099009901,0.162660225781966,0.9529482574615467
5,24,1,30,0.1724137931034483,0.9666666666666667,0.16348124384436336,0.9624720669853561
12,81,3,96,0.12903225806451613,0.96875,0.14649529723964844,0.9773955363731114
16,38,1,55,0.2962962962962963,0.9818181818181818,0.16860770614451018,0.9774436364212112
0,4,59,63,0.0,0.06349206349206349,0.1491271866639907,0.8457889845106958
7,192,9,208,0.035175879396984924,0.9567307692307693,0.1496880265778457,0.8439366701583815
30,192,11,233,0.13513513513513514,0.9527896995708155,0.1340076231423402,0.8400494843827836
39,102,12,153,0.2765957446808511,0.9215686274509803,0.14923558666817607,0.830259429747068
2,61,2,65,0.031746031746031744,0.9692307692307692,0.12914019218854514,0.8306257301133684
26,197,6,229,0.11659192825112108,0.9737991266375546,0.12736300221520297,0.8313470339187333
0,2,65,67,0.0,0.029850746268656716,0.08503495988716067,0.6953516859830869
4,10,1,15,0.2857142857142857,0.9333333333333333,0.1258512864177729,0.8196147245318397
22,63,2,87,0.25882352941176473,0.9770114942528736,0.1578009507055986,0.822511970963569
1,61,3,65,0.016129032258064516,0.9538461538461539,0.1408000788660171,0.822662893002903
41,70,32,143,0.36936936936936937,0.7762237762237763,0.1540534538215197,0.8018993428275881
153,434,5,592,0.2606473594548552,0.9915540540540541,0.18675364349420875,0.8050883835166288
0,58,1,59,0.0,0.9830508474576272,0.1700976537440486,0.8064100579194964
21,77,9,107,0.21428571428571427,0.9158878504672897,0.20070989864200778,0.9329867870907295
2,0,0,2,1.0,1.0,0.3027507149685384,0.9425105966145392
2,14,1,17,0.125,0.9411764705882353,0.2836330679097148,0.9373913075195908
8,95,2,105,0.07766990291262135,0.9809523809523809,0.2924246208603658,0.9412636256776233
18,111,21,150,0.13953488372093023,0.86,0.2595911229105888,0.9532316576456551
21,38,4,63,0.3559322033898305,0.9365079365079365,0.2732032434727282,0.9453679265676384
4,25,2,31,0.13793103448275862,0.9354838709677419,0.2929076769702651,0.9385726442119404
1,23,0,24,0.041666666666666664,1.0,0.27012061416255223,0.9469327515952617
35,67,15,117,0.3431372549019608,0.8717948717948718,0.17628307914854663,0.9286177332802433
21,88,2,111,0.1926605504587156,0.9819819819819819,0.1859488720712203,0.9344470920507785
26,97,3,126,0.21138211382113822,0.9761904761904762,0.2050506164867227,0.933766819941935
131,274,12,417,0.3234567901234568,0.9712230215827338,0.2325774106801836,0.9487034420728018
4,88,13,105,0.043478260869565216,0.8761904761904762,0.18551982567123523,0.9400866620274503
4,35,1,40,0.10256410256410256,0.975,0.1797636770579438,0.9503401182486483
0,12,2,14,0.0,0.8571428571428571,0.17381129610556284,0.9299319549833422
1,12,2,15,0.07692307692307693,0.8666666666666667,0.13578069925143657,0.9291993542507415
24,229,15,268,0.09486166007905138,0.9440298507462687,0.12180942919719882,0.9237776212170683
40,116,15,171,0.2564102564102564,0.9122807017543859,0.12824202099564427,0.9146476534404838
3,23,0,26,0.11538461538461539,1.0,0.09851742460438122,0.9187586503572361
3,47,76,126,0.06,0.3968253968253968,0.1008776730515862,0.8502779247336535
4,40,8,52,0.09090909090909091,0.8461538461538461,0.09921267138658452,0.8318713313270599
11,172,23,206,0.060109289617486336,0.8883495145631068,0.10779971276051115,0.8363294252442385
17,146,2,165,0.10429447852760736,0.9878787878787879,0.11170991298972978,0.853645442560256
19,127,4,150,0.13013698630136986,0.9733333333333334,0.11674924530720385,0.857831654358408
4,112,2,118,0.034482758620689655,0.9830508474576272,0.08504531705155145,0.8679416751731568
45,171,6,222,0.20833333333333334,0.972972972972973,0.09832370532993973,0.8640806713121529
10,91,1,102,0.09900990099009901,0.9901960784313726,0.10389654832852531,0.948847911541578
1,58,1,60,0.01694915254237288,0.9833333333333333,0.09333084284756558,0.9684449811386476
2,29,8,39,0.06451612903225806,0.7948717948717948,0.09396039133539012,0.9550910211827458
4,156,4,164,0.025,0.975609756097561,0.08263260868858906,0.9533383023568563
21,105,14,140,0.16666666666666666,0.9,0.08785113445506003,0.9428621118806658
27,94,19,140,0.2231404958677686,0.8642857142857143,0.11480223977607132,0.9258956642846783
16,90,2,108,0.1509433962264151,0.9814814814814815,0.10660367733222585,0.9271111655001796
10,56,1,67,0.15151515151515152,0.9850746268656716,0.11410442740723337,0.9263795295622222
5,123,4,132,0.0390625,0.9696969696969697,0.11726347704403721,0.9244314776141703
12,37,1,50,0.24489795918367346,0.98,0.14303230992281085,0.9508783640610569
17,83,1,101,0.17,0.9900990099009901,0.16374659563709656,0.9529482574615467
4,25,1,30,0.13793103448275862,0.9666666666666667,0.1596415053251097,0.9624720669853561
11,76,9,96,0.12643678160919541,0.90625,0.1458266890024564,0.9684669649445399
19,35,1,55,0.35185185185185186,0.9818181818181818,0.17452789694894738,0.9685150649926398
0,4,59,63,0.0,0.06349206349206349,0.15288287530392572,0.8368604130821244
7,188,13,208,0.035897435897435895,0.9375,0.1524307232892737,0.8322608459825573
29,193,11,233,0.13063063063063063,0.9527896995708155,0.1361068192102676,0.8283736602069595
43,99,11,153,0.3028169014084507,0.9281045751633987,0.15508066226861766,0.8195173123873036
2,56,7,65,0.034482758620689655,0.8923076923076924,0.14030233714546497,0.808894601764593
30,193,6,229,0.13452914798206278,0.9737991266375546,0.14145838948444603,0.8185444769985294
1,2,64,67,0.3333333333333333,0.04477611940298507,0.13881288683894338,0.6846813252249299
4,10,1,15,0.2857142857142857,0.9333333333333333,0.17962921336955562,0.8089443637736827
22,63,2,87,0.25882352941176473,0.9770114942528736,0.21147579815731685,0.8145888629526646
2,60,3,65,0.03225806451612903,0.9538461538461539,0.19742257442667377,0.8147397849919987
42,70,32,144,0.375,0.7777777777777778,0.20773444565403798,0.7932645282226243
163,424,5,592,0.2776831345826235,0.9915540540540541,0.2424773565057428,0.807442579900676
0,58,1,59,0.0,0.9830508474576272,0.22325890679401958,0.8087642543035434
21,77,9,107,0.21428571428571427,0.9158878504672897,0.2062521040729311,0.9332087873127298
2,0,0,2,1.0,1.0,0.3082929203994617,0.9427325968365393
2,14,1,17,0.125,0.9411764705882353,0.2891752733406382,0.937613307741591
5,98,2,105,0.04854368932038835,0.9809523809523809,0.29150179116981817,0.9414856258996235
16,113,21,150,0.12403100775193798,0.86,0.25564907799152353,0.9532316576456551
22,37,4,63,0.3728813559322034,0.9365079365079365,0.2692488238986064,0.9453679265676384
4,25,2,31,0.13793103448275862,0.9354838709677419,0.2889532573961433,0.9385726442119405
1,23,0,24,0.041666666666666664,1.0,0.2744916709484519,0.9450279896904997
35,67,15,117,0.3431372549019608,0.8717948717948718,0.18065413593444626,0.9267129713754814
23,86,2,111,0.21100917431192662,0.9819819819819819,0.19294116083615007,0.9325423301460167
27,96,3,126,0.21951219512195122,0.9761904761904762,0.21043042033346074,0.9318620580371731
132,274,11,417,0.3251231527093596,0.973621103117506,0.23901944214908352,0.9490460251491978
6,86,13,105,0.06521739130434782,0.8761904761904762,0.19264613969619376,0.9404292451038463
4,35,1,40,0.10256410256410256,0.975,0.18688999108290227,0.9506827013250445
0,12,2,14,0.0,0.8571428571428571,0.18093761013052131,0.9302745380597383
1,12,2,15,0.07692307692307693,0.8666666666666667,0.14290701327639505,0.9295419373271377
28,225,15,268,0.11067193675889328,0.9440298507462687,0.12857312219739028,0.9241202042934643
43,113,15,171,0.27564102564102566,0.9122807017543859,0.13659152655725806,0.9149902365168799
3,23,0,26,0.11538461538461539,1.0,0.10662887836800891,0.9187586503572361
3,46,77,126,0.061224489795918366,0.3888888888888889,0.1060584638668047,0.849144137885581
4,40,8,52,0.09090909090909091,0.8461538461538461,0.10439346220180303,0.8307375444789875
13,168,25,206,0.0718232044198895,0.8786407766990292,0.11465391997607297,0.833808675844155
16,147,2,165,0.09815950920245399,0.9878787878787879,0.11768769601598397,0.8511246931601723
17,129,4,150,0.11643835616438356,0.9733333333333334,0.11851147021676829,0.8553109049583244
3,113,2,118,0.02586206896551724,0.9830508474576272,0.08282876212026709,0.8654209257730733
45,171,6,222,0.20833333333333334,0.972972972972973,0.09610715039865536,0.8615599219120693
10,91,1,102,0.09900990099009901,0.9901960784313726,0.10150506628353832,0.947460948989567
1,58,1,60,0.01694915254237288,0.9833333333333333,0.0909393608025786,0.9670580185866366
2,29,8,39,0.06451612903225806,0.7948717948717948,0.08989549289005981,0.9550910211827459
4,156,4,164,0.025,0.975609756097561,0.07944413443256639,0.9533383023568563
21,105,14,140,0.16666666666666666,0.9,0.08661960736146398,0.9428621118806658
27,91,22,140,0.2288135593220339,0.8428571428571429,0.11561267741239492,0.9228344397948823
15,91,2,108,0.14150943396226415,0.9814814814814815,0.10606640607367077,0.9240499410103836
9,57,1,67,0.13636363636363635,0.9850746268656716,0.1114026539841761,0.9233183050724263
4,124,4,132,0.03125,0.9696969696969697,0.11344563219240855,0.9213702531243744
11,38,1,50,0.22448979591836735,0.98,0.13629901317613843,0.9478171395712608
17,83,1,101,0.17,0.9900990099009901,0.15701329889042417,0.9498870329717507
5,24,1,30,0.1724137931034483,0.9666666666666667,0.15783431695282155,0.9594108424955602
12,76,8,96,0.13636363636363635,0.9166666666666666,0.14462718510162187,0.9699550601826351
20,34,1,55,0.37037037037037035,0.9818181818181818,0.1773216045884942,0.9700031602307352
0,4,59,63,0.0,0.06349206349206349,0.15784108510797473,0.8383485083202196
7,188,13,208,0.035897435897435895,0.9375,0.15850500452189414,0.8337489412206525
31,191,11,233,0.13963963963963963,0.9527896995708155,0.14638355362493302,0.8298617554450548
39,102,12,153,0.2765957446808511,0.9215686274509803,0.16161151715076888,0.8200717008093391
2,56,7,65,0.034482758620689655,0.8923076923076924,0.14190708365323196,0.8094489901866285
29,194,6,229,0.13004484304932734,0.9737991266375546,0.14100439889404495,0.8176107701824696
1,3,63,67,0.25,0.05970149253731343,0.12380863169827776,0.6858798145709171
4,10,1,15,0.2857142857142857,0.9333333333333333,0.16462495822888998,0.8101428531196698
23,62,2,87,0.27058823529411763,0.9770114942528736,0.1981522152855588,0.8157873522986518
2,60,3,65,0.03225806451612903,0.9538461538461539,0.18281199026791445,0.8159382743379859
40,71,33,144,0.36036036036036034,0.7708333333333334,0.19477836393641576,0.7944046608926076
168,419,5,592,0.28620102214650767,0.9915540540540541,0.2307381158686755,0.8085827125706595
0,58,1,59,0.0,0.9830508474576272,0.212160281147343,0.8099043869735267
23,75,9,107,0.23469387755102042,0.9158878504672897,0.2099736922260602,0.9322167238206662
2,0,0,2,1.0,1.0,0.31201450855259083,0.9417405333444758
2,14,1,17,0.125,0.9411764705882353,0.29121618922485976,0.9366212442495275
8,95,2,105,0.07766990291262135,0.9809523809523809,0.29770359471007296,0.94049356240756
17,113,20,150,0.13076923076923078,0.8666666666666667,0.2649048619113401,0.9541840385980361
22,37,4,63,0.3728813559322034,0.9365079365079365,0.2772877667378681,0.9463203075200194
4,24,3,31,0.14285714285714285,0.9032258064516129,0.2976959300031742,0.9349167302334458
1,23,0,24,0.041666666666666664,1.0,0.2880154407804178,0.9495388104691772
36,70,11,117,0.33962264150943394,0.905982905982906,0.19367581813890838,0.9361077970381638
20,89,2,111,0.1834862385321101,0.9819819819819819,0.20203099507206693,0.9419371558086989
28,95,3,126,0.22764227642276422,0.9761904761904762,0.2191903371724004,0.9415433140614737
132,275,10,417,0.32432432432432434,0.9760191846522782,0.24478505631550665,0.9579587531387832
8,84,13,105,0.08695652173913043,0.8761904761904762,0.19746715682369412,0.9499569083330645
4,35,1,40,0.10256410256410256,0.975,0.18660896739407612,0.9559092892854454
0,13,1,14,0.0,0.9285714285714286,0.18065658644169516,0.9457052076527923
1,13,1,15,0.07142857142857142,0.9333333333333333,0.1423431478587148,0.9496124115599961
31,222,15,268,0.1225296442687747,0.9440298507462687,0.1336350629639526,0.944190678526323
44,112,15,171,0.28205128205128205,0.9122807017543859,0.14140777805374086,0.9350607107497385
3,23,0,26,0.11538461538461539,1.0,0.11155924820521101,0.9384865415136989
5,72,49,126,0.06493506493506493,0.6111111111111112,0.10841332580463024,0.9006180607880753
4,47,1,52,0.0784313725490196,0.9807692307692307,0.10496579294533268,0.9014422366122511
11,172,23,206,0.060109289617486336,0.8883495145631068,0.11355283431925929,0.8956962488967765
18,145,2,165,0.11042944785276074,0.9878787878787879,0.11912438809414348,0.9034884566889845
16,130,4,150,0.1095890410958904,0.9733333333333334,0.11727573049801716,0.9076746684871365
5,110,2,117,0.043478260869565216,0.9829059829059829,0.08319387032920046,0.917763994365936
45,171,6,222,0.20833333333333334,0.972972972972973,0.09647225860758872,0.9139029905049322
10,91,1,102,0.09900990099009901,0.9901960784313726,0.10134009232973647,0.9680579858363981
1,58,1,60,0.01694915254237288,0.9833333333333333,0.09255691804307263,0.9684242862026985
2,29,8,39,0.06451612903225806,0.7948717948717948,0.09318646653089717,0.9550703262467968
5,155,4,164,0.03125,0.975609756097561,0.08187511683764563,0.9533176074209072
20,106,14,140,0.15873015873015872,0.9,0.08889527649968397,0.9428414169447167
30,93,17,140,0.24390243902439024,0.8785714285714286,0.11752730195037327,0.927936480611209
18,88,2,108,0.16981132075471697,0.9814814814814815,0.1120241572962852,0.92915198182671
9,56,1,66,0.13846153846153847,0.9848484848484849,0.11766010550649085,0.9283880398862976
5,123,4,132,0.0390625,0.9696969696969697,0.12081915514329471,0.9264399879382456
11,38,1,50,0.22448979591836735,0.98,0.1436725361270246,0.952886874385132
17,83,1,101,0.17,0.9900990099009901,0.1634939646984532,0.9549567677856219
6,23,1,30,0.20689655172413793,0.9666666666666667,0.17037487798330736,0.9644805773094315
13,80,3,96,0.13978494623655913,0.96875,0.15550095044218865,0.977363230370656
17,37,1,55,0.3148148148148148,0.9818181818181818,0.17621573530791693,0.9774113304187562
0,4,59,63,0.0,0.06349206349206349,0.15643551552769713,0.8457889845106958
7,192,9,208,0.035175879396984924,0.9567307692307693,0.15588028401298068,0.8439366701583815
31,192,10,233,0.13901345291479822,0.9570815450643777,0.14366937786961367,0.8406626051675783
42,100,11,153,0.29577464788732394,0.9281045751633987,0.16163718471065994,0.8318062573479225
4,53,7,64,0.07017543859649122,0.890625,0.14210559712099613,0.8209431621098272
28,195,6,229,0.12556053811659193,0.9737991266375546,0.14007353881814363,0.8216644659151922
9,57,1,67,0.13636363636363635,0.9850746268656716,0.11458051332511816,0.8221296723505478
3,11,1,15,0.21428571428571427,0.9333333333333333,0.14519275822307737,0.9463927108993007
22,63,2,87,0.25882352941176473,0.9770114942528736,0.17714242251090304,0.9492899573310298
1,61,3,65,0.016129032258064516,0.9538461538461539,0.1595875052742268,0.9488277585855693
41,76,27,144,0.3504273504273504,0.8125,0.16739503420851626,0.9323128192765123
171,415,5,591,0.29180887372013653,0.9915397631133672,0.19905695351189417,0.9467292140069933
0,58,1,59,0.0,0.9830508474576272,0.18111973378095247,0.9480508884098607
22,75,10,107,0.2268041237113402,0.9065420560747663,0.194039803402053,0.9368319497254458
2,0,0,2,1.0,1.0,0.3062847013612367,0.9463557592492553
2,14,1,17,0.125,0.9411764705882353,0.2871670543024131,0.9412364701543069
10,93,2,105,0.0970873786407767,0.9809523809523809,0.29873253235708636,0.9451087883123394
16,112,22,150,0.125,0.8533333333333334,0.26652862515317916,0.9509421216456727
23,36,4,63,0.3898305084745763,0.9365079365079365,0.28053171583238484,0.9430804321306113
4,24,3,31,0.14285714285714285,0.9032258064516129,0.300939879097691,0.9316768548440378
1,22,0,23,0.043478260869565216,1.0,0.2785396000838677,0.949400060330427
35,59,14,108,0.3723404255319149,0.8703703703703703,0.1888739465884269,0.9308815418119085
18,71,2,91,0.20224719101123595,0.978021978021978,0.19990925959003206,0.9361451857310146
28,74,3,105,0.27450980392156865,0.9714285714285714,0.22990835600279075,0.9350710718749459
137,229,12,378,0.3743169398907104,0.9682539682539683,0.2636377213994892,0.9505159444626755
6,77,13,96,0.07228915662650602,0.8645833333333334,0.21682188663184718,0.9408559363916505
4,28,1,33,0.125,0.9696969696969697,0.20916882540735737,0.9460507415864557
0,12,2,14,0.0,0.8571428571428571,0.2029576452831338,0.9256425783211496
1,8,1,10,0.1111111111111111,0.9,0.1656391717944475,0.9298753825539539
28,188,15,231,0.12962962962962962,0.935064935064935,0.15526523445421805,0.9237386621315192
43,98,15,156,0.3049645390070922,0.9038461538461539,0.15961591089500712,0.9140840310483166
2,22,0,24,0.08333333333333333,1.0,0.11804682424395327,0.9186191784406069
2,41,79,122,0.046511627906976744,0.3524590163934426,0.11436432014116338,0.8454585617349082
3,37,8,48,0.075,0.8333333333333334,0.10722146299830622,0.8259780422543888
14,150,24,188,0.08536585365853659,0.8723404255319149,0.11941658494952574,0.8281491234528257
15,119,2,136,0.11194029850746269,0.9852941176470589,0.11953504029186168,0.8403339974024054
16,121,4,141,0.11678832116788321,0.9716312056737588,0.11770056765446933,0.845557750346523
5,96,2,103,0.04950495049504951,0.9805825242718447,0.08120634072417753,0.8565200889787646
46,170,6,222,0.21296296296296297,0.972972972972973,0.09972485924269603,0.8526590851177609
7,71,1,79,0.08974358974358974,0.9873417721518988,0.10590085379078361,0.9433566216546831
1,46,5,52,0.02127659574468085,0.9038461538461539,0.09822608175430944,0.9534298817279431
2,27,8,37,0.06896551724137931,0.7837837837837838,0.0958831765518584,0.9407789329067816
6,148,4,158,0.03896103896103896,0.9746835443037974,0.08545756804522645,0.939263136714887
20,97,14,131,0.17094017094017094,0.8931297709923665,0.0931935465841247,0.9280486460461167
29,77,19,125,0.27358490566037735,0.848,0.12520496875060008,0.9091082854358533
17,81,2,100,0.17346938775510204,0.98,0.11956302943519138,0.9101121464397142
9,56,1,66,0.13846153846153847,0.9848484848484849,0.12652273639489836,0.9097559625392265
4,111,4,119,0.034782608695652174,0.9663865546218487,0.12845216681646568,0.9186903055071829
11,35,1,47,0.2391304347826087,0.9787234042553191,0.15276144075092704,0.9465388227174022
17,82,1,100,0.1717171717171717,0.99,0.17172660257323166,0.9487268878168598
5,22,1,28,0.18518518518518517,0.9642857142857143,0.17376160460823376,0.9588920225730524
9,60,9,78,0.13043478260869565,0.8846153846153846,0.15331158702942208,0.9641227918038215
17,35,1,53,0.3269230769230769,0.9811320754716981,0.17523354262484706,0.964284516871207
0,1,59,60,0.0,0.016666666666666666,0.1554533228446273,0.8259728285595187
8,164,9,181,0.046511627906976744,0.9502762430939227,0.15712889701767366,0.8236713554841008
33,156,11,200,0.1746031746031746,0.945,0.1479107169920402,0.8188537263047693
42,93,11,146,0.3111111111111111,0.9246575342465754,0.1678241369054601,0.8095190883399944
2,54,7,63,0.03571428571428571,0.8888888888888888,0.14647115126676022,0.7987481132833051
28,174,6,208,0.13861386138613863,0.9711538461538461,0.1476395910921092,0.8111107506459424
1,1,65,67,0.5,0.029850746268656716,0.17236486581738392,0.6752134179026508
3,11,1,15,0.21428571428571427,0.9333333333333333,0.20297711071534308,0.8061657988550318
22,45,2,69,0.3283582089552239,0.9710144927536232,0.2432409080079498,0.8091284059492746
2,58,3,63,0.03333333333333333,0.9523809523809523,0.22305950211225825,0.8101828277179822
40,71,33,144,0.36036036036036034,0.7708333333333334,0.2300951091478652,0.7882079418732333
173,410,5,588,0.2967409948542024,0.9914965986394558,0.2673846390249962,0.8028661861233142
0,52,1,53,0.0,0.9811320754716981,0.24758265882697636,0.8042916474544359
24,62,9,95,0.27906976744186046,0.9052631578947369,0.21602119703295644,0.9293505634010188
2,0,0,2,1.0,1.0,0.32826609499214016,0.9388743729248283
2,14,1,17,0.125,0.9411764705882353,0.29921492228425095,0.934611798329773
10,83,2,95,0.10752688172043011,0.9789473684210527,0.3098140006252649,0.9384070006212158
18,106,20,144,0.14516129032258066,0.8611111111111112,0.27907127633415346,0.9513038260180414
23,32,4,59,0.41818181818181815,0.9322033898305084,0.2964199653809557,0.9428333676167631
5,23,2,30,0.17857142857142858,0.9333333333333333,0.32193016946258834,0.936004975882711
1,21,0,22,0.045454545454545456,1.0,0.27704805772409924,0.9505886655737561
35,59,14,108,0.3723404255319149,0.8703703703703703,0.1873824042286585,0.9320701470552377
21,69,2,92,0.23333333333333334,0.9782608695652174,0.202858594704849,0.9373679183376638
29,73,3,105,0.28431372549019607,0.9714285714285714,0.22683129057931528,0.9360073741199767
139,228,12,379,0.3787465940054496,0.9683377308707124,0.2632192314726741,0.9514841928157927
6,77,13,96,0.07228915662650602,0.8645833333333334,0.22269879622077057,0.9412092495051352
4,28,1,33,0.125,0.9696969696969697,0.21592539720599227,0.9460968350378819
0,12,2,14,0.0,0.8571428571428571,0.20943189071248577,0.9256886717725757
1,7,2,10,0.125,0.8,0.1740975442079265,0.9156357617196658
29,186,15,230,0.13488372093023257,0.9347826086956522,0.16003331386462638,0.9094245815954423
44,96,15,155,0.3142857142857143,0.9032258064516129,0.16431502654970043,0.8996813294558768
2,22,0,24,0.08333333333333333,1.0,0.12211313216796953,0.9042045107600607
2,57,63,122,0.03389830508474576,0.48360655737704916,0.1166287248048609,0.8497792570520202
3,37,8,48,0.075,0.8333333333333334,0.10948586766200377,0.8302987375715005
16,149,23,188,0.09696969696969697,0.8776595744680851,0.12333868151481762,0.8332296971893902
15,119,2,136,0.11194029850746269,0.9852941176470589,0.12147300987302657,0.8597002854246844
17,120,4,141,0.12408759124087591,0.9716312056737588,0.11993070563168992,0.8649643707072711
5,96,2,103,0.04950495049504951,0.9805825242718447,0.08210488223302352,0.8760153303958756
45,171,6,222,0.20833333333333334,0.972972972972973,0.09996202509016638,0.8721543265348718
7,71,1,79,0.08974358974358974,0.9873417721518988,0.10793992289857267,0.944116500074136
1,50,1,52,0.0196078431372549,0.9807692307692307,0.10002675763246624,0.965178771136407
2,27,8,37,0.06896551724137931,0.7837837837837838,0.09602616052842083,0.9517679438957926
6,148,4,158,0.03896103896103896,0.9746835443037974,0.08560055202178887,0.950252147703898
19,97,15,131,0.16379310344827586,0.8854961832061069,0.09127276805141744,0.9379471444942336
30,78,19,127,0.2777777777777778,0.8503937007874016,0.12388317194895006,0.9193487411393131
16,82,2,100,0.16326530612244897,0.98,0.11744488234739515,0.920352602143174
8,57,1,66,0.12307692307692308,0.9848484848484849,0.12220678710929991,0.9199964182426863
6,109,4,119,0.05217391304347826,0.9663865546218487,0.12685908281018896,0.9179417502216317
12,34,1,47,0.2608695652173913,0.9787234042553191,0.15427394680676207,0.9457902674318512
17,82,1,100,0.1717171717171717,0.99,0.17323910862906677,0.9479783325313086
6,21,1,28,0.2222222222222222,0.9642857142857143,0.18158612559677342,0.9592339798283954
9,61,8,78,0.12857142857142856,0.8974358974358975,0.16027093285300922,0.9659542936353234
20,32,1,53,0.38461538461538464,0.9811320754716981,0.19189237263771433,0.9661160187027089
0,1,59,60,0.0,0.016666666666666666,0.17430995505529673,0.8278043303910205
8,165,9,182,0.046242774566473986,0.9505494505494505,0.17346264955858184,0.8255418869521065
33,156,11,200,0.1746031746031746,0.945,0.1611388794708366,0.8207242577727752
41,92,11,144,0.3082706766917293,0.9236111111111112,0.18064652303863055,0.8112401307886482
2,54,7,63,0.03571428571428571,0.8888888888888888,0.15400253210892534,0.8004691557319588
26,176,6,208,0.12871287128712872,0.9711538461538461,0.15402273821116821,0.8110002912630944
1,1,65,67,0.5,0.029850746268656716,0.1705062546946847,0.6751029585198027
4,10,1,15,0.2857142857142857,0.9333333333333333,0.21132258122529693,0.8060553394721837
22,45,2,69,0.3283582089552239,0.9710144927536232,0.2516247861379755,0.8089789169299226
2,58,3,63,0.03333333333333333,0.9523809523809523,0.2314433802422839,0.8100333386986301
41,69,32,142,0.37272727272727274,0.7746478873239436,0.24065146539021867,0.7887528781576061
174,349,65,588,0.3326959847036329,0.8894557823129252,0.2830774223886968,0.7888338629324684
0,52,1,53,0.0,0.9811320754716981,0.26468986934767846,0.7902593242635901
23,63,9,95,0.26744186046511625,0.9052631578947369,0.23146727798555222,0.915318240210173
2,0,0,2,1.0,1.0,0.3335080943120828,0.9248420497339828
2,14,1,17,0.125,0.9411764705882353,0.30445692160419363,0.9205794751389272
6,87,2,95,0.06451612903225806,0.9789473684210527,0.30891160670404005,0.92437467743037
17,106,20,143,0.13821138211382114,0.8601398601398601,0.27540933661640415,0.9365878164040724
22,33,4,59,0.4,0.9322033898305084,0.2850241959444566,0.942694617478013
5,23,2,30,0.17857142857142858,0.9333333333333333,0.31053440002608923,0.9358662257439609
1,22,0,23,0.043478260869565216,1.0,0.2764861885148761,0.9505886655737562
34,70,13,117,0.3269230769230769,0.8888888888888888,0.18033234236102996,0.9347156497007403
24,84,2,110,0.2222222222222222,0.9818181818181818,0.19422123124991883,0.9405216084478756
32,91,3,126,0.2601626016260163,0.9761904761904762,0.21613072912437056,0.939841336339032
142,262,14,418,0.35148514851485146,0.9665071770334929,0.24751675809271592,0.9550566473438168
7,85,13,105,0.07608695652173914,0.8761904761904762,0.20753886568298857,0.9464398672984652
4,35,1,40,0.10256410256410256,0.975,0.19756033846308202,0.9520850285887877
0,12,2,14,0.0,0.8571428571428571,0.19134915833885843,0.9316768653234817
2,12,2,16,0.14285714285714285,0.875,0.16505402490086782,0.9296927383393548
28,225,15,268,0.11067193675889328,0.9440298507462687,0.149118269834678,0.9242944053290814
45,111,15,171,0.28846153846153844,0.9122807017543859,0.1531609750968954,0.9151644375524972
2,24,0,26,0.07692307692307693,1.0,0.11393782201235624,0.9199491265477124
3,49,74,126,0.057692307692307696,0.4126984126984127,0.11131001503672314,0.8537359746202747
5,39,8,52,0.11363636363636363,0.8461538461538461,0.11289176661847473,0.8353293812136814
16,165,25,206,0.08839779005524862,0.8786407766990292,0.1255200223406531,0.8384005125788487
14,150,2,166,0.08536585365853659,0.9879518072289156,0.11730698102656652,0.8545364850401225
16,130,4,150,0.1095890410958904,0.9733333333333334,0.11715228164613753,0.8587226968382745
5,111,2,118,0.04310344827586207,0.9830508474576272,0.0821011259053266,0.8688327176530233
46,170,6,222,0.21296296296296297,0.972972972972973,0.10153539533959603,0.8649717137920195
10,91,1,102,0.09900990099009901,0.9901960784313726,0.10743790866785195,0.9474713803252995
2,57,1,60,0.03389830508474576,0.9833333333333333,0.09604675744619226,0.967068449922369
2,29,8,39,0.06451612903225806,0.7948717948717948,0.09263509158576502,0.9551014525184784
6,154,4,164,0.0375,0.975609756097561,0.08579711249168838,0.9533383023568563
20,106,14,140,0.15873015873015872,0.9,0.0928172721537267,0.9428621118806658
30,89,21,140,0.25210084033613445,0.85,0.12267404244805133,0.9238548479581478
14,92,2,108,0.1320754716981132,0.9814814814814815,0.11111868655307279,0.9250703491736488
9,57,1,67,0.13636363636363635,0.9850746268656716,0.11645493446357812,0.9243387132356915
4,124,4,132,0.03125,0.9696969696969697,0.11607660516575728,0.9223906612876398
13,36,1,50,0.2653061224489796,0.98,0.14476088993957467,0.9488375477345261
16,84,1,101,0.16,0.9900990099009901,0.1622608899395747,0.9509074411350159
5,24,1,30,0.1724137931034483,0.9666666666666667,0.1642156948500446,0.9604312506588256
11,76,9,96,0.12643678160919541,0.90625,0.14626368646048188,0.9684669649445398
18,36,1,55,0.3333333333333333,0.9818181818181818,0.17501480955122764,0.9685150649926398
0,4,59,63,0.0,0.06349206349206349,0.15553429007070813,0.8368604130821244
8,190,9,207,0.04040404040404041,0.9565217391304348,0.1568420101284282,0.8349782372869051
34,189,11,234,0.15246636771300448,0.9529914529914529,0.14072204516614603,0.8311198734285412
40,100,12,152,0.2857142857142857,0.9210526315789473,0.1586812288396154,0.8212561050968209
2,61,2,65,0.031746031746031744,0.9692307692307692,0.13858583435998448,0.8216224054631213
29,194,6,229,0.13004484304932734,0.9737991266375546,0.13910127170857475,0.8312722806970576
1,1,65,67,0.5,0.029850746268656716,0.16291079551809856,0.6952769327614112
4,10,1,15,0.2857142857142857,0.9333333333333333,0.20372712204871082,0.819539971310164
23,62,2,87,0.27058823529411763,0.9770114942528736,0.23661057846157899,0.8224670791847981
1,61,3,65,0.016129032258064516,0.9538461538461539,0.2171338162537304,0.8225891793068983
42,67,33,142,0.3853211009174312,0.7676056338028169,0.23136336128275123,0.8006681796245939
154,432,5,591,0.2627986348122867,0.9915397631133672,0.2643708760065019,0.8038551787506794
0,58,1,59,0.0,0.9830508474576272,0.24579304128516943,0.8051768531535469
22,75,9,106,0.2268041237113402,0.9150943396226415,0.20676505895821803,0.9316402236326875
2,0,0,2,1.0,1.0,0.3088058752847487,0.9411640331564971
2,14,1,17,0.125,0.9411764705882353,0.28800755595701755,0.9360447440615486
12,91,2,105,0.11650485436893204,0.9809523809523809,0.30234695911571297,0.939917062219581
16,113,21,150,0.12403100775193798,0.86,0.2650198029492139,0.9531162573906073
21,38,4,63,0.3559322033898305,0.9365079365079365,0.27832459846029156,0.9452545678755458
5,24,2,31,0.1724137931034483,0.9354838709677419,0.30295514033221277,0.9384592855198479
1,22,0,23,0.043478260869565216,1.0,0.27699282913465034,0.9524934274785181
35,71,11,117,0.330188679245283,0.905982905982906,0.1813054975982622,0.9390624140475047
27,81,2,110,0.25,0.9818181818181818,0.19916264045540505,0.94486837279464
32,90,3,125,0.26229508196721313,0.976,0.22276374093061027,0.9441608898014425
141,265,12,418,0.3472906403940887,0.9712918660287081,0.251656951281347,0.9581549659007819
7,85,13,105,0.07608695652173914,0.8761904761904762,0.2116790588716197,0.9495381858554304
4,35,1,40,0.10256410256410256,0.975,0.20170053165171317,0.955183347145753
0,12,2,14,0.0,0.8571428571428571,0.19548935152748959,0.934775183880447
2,12,2,16,0.14285714285714285,0.875,0.16872770347204097,0.9303490544543175
29,224,15,268,0.11462450592885376,0.9440298507462687,0.14938834717616295,0.9249507214440441
45,111,15,171,0.28846153846153844,0.9122807017543859,0.153126412389638,0.9158479645518136
2,24,0,26,0.07692307692307693,1.0,0.11450247475092201,0.9199491265477125
2,47,77,126,0.04081632653061224,0.3888888888888889,0.10946381332361818,0.850334614076057
5,39,8,52,0.11363636363636363,0.8461538461538461,0.11104556490536976,0.8319280206694637
14,169,23,206,0.07650273224043716,0.8883495145631068,0.12197452665400364,0.8363861145866422
15,149,2,166,0.09146341463414634,0.9879518072289156,0.11463256547928984,0.8525220870479159
18,128,4,150,0.1232876712328767,0.9733333333333334,0.1158701605227217,0.856708298846068
5,111,2,118,0.04310344827586207,0.9830508474576272,0.0808190047819108,0.8668183196608169
45,171,6,222,0.20833333333333334,0.972972972972973,0.09959189855480456,0.8629573157998128
10,91,1,102,0.09900990099009901,0.9901960784313726,0.10790526633473123,0.9488583428773106
2,57,1,60,0.03389830508474576,0.9833333333333333,0.09651411511307155,0.9684554124743802
2,29,8,39,0.06451612903225806,0.7948717948717948,0.09480174322618883,0.9551014525184784
6,154,4,164,0.0375,0.975609756097561,0.08709268399273935,0.9533383023568563
20,105,15,140,0.16,0.8928571428571429,0.09233730238804268,0.9418417037174004
33,87,20,140,0.275,0.8571428571428571,0.12546538120577666,0.9238548479581477
17,89,2,108,0.16037735849056603,0.9814814814814815,0.11861452765680991,0.9250703491736488
10,56,1,67,0.15151515151515152,0.9850746268656716,0.12611527773181738,0.9243387132356916
4,124,4,132,0.03125,0.9696969696969697,0.12573694843399658,0.9223906612876397
12,37,1,50,0.24489795918367346,0.98,0.1515057813127702,0.9488375477345261
16,84,1,101,0.16,0.9900990099009901,0.1690057813127702,0.9509074411350159
6,23,1,30,0.20689655172413793,0.9666666666666667,0.17570528870193278,0.9614516588220907
11,76,9,96,0.12643678160919541,0.90625,0.1544819717889607,0.9684669649445398
19,34,1,54,0.3584905660377358,0.9814814814814815,0.18278385858141352,0.9684669649445398
0,4,59,63,0.0,0.06349206349206349,0.16113883693639183,0.8368123130340244
8,190,9,207,0.04040404040404041,0.9565217391304348,0.1624465569941119,0.834930137238805
33,190,11,234,0.14798206278026907,0.9529914529914529,0.14860142893648273,0.8310717733804412
44,96,12,152,0.3142857142857143,0.9210526315789473,0.17064224526301336,0.8212080050487209
1,62,2,65,0.015873015873015872,0.9692307692307692,0.14335316871285306,0.8215743054150212
27,196,6,229,0.1210762331838565,0.9737991266375546,0.14258737608066177,0.8312241806489576
1,1,65,67,0.5,0.029850746268656716,0.16280300950384236,0.6952769327614111
4,10,1,15,0.2857142857142857,0.9333333333333333,0.20361933603445462,0.819539971310164
23,62,2,87,0.27058823529411763,0.9770114942528736,0.23650279244732278,0.8224670791847981
0,62,3,65,0.0,0.9538461538461539,0.2153624977644272,0.8225891793068982
43,67,32,142,0.39090909090909093,0.7746478873239436,0.22630869442490958,0.8016742158418977
166,420,5,591,0.2832764505119454,0.9915397631133672,0.26450918508761384,0.8048612149679831
0,58,1,59,0.0,0.9830508474576272,0.24721258034706287,0.8061828893708506
23,74,9,106,0.23711340206185566,0.9150943396226415,0.20965735207018507,0.9326462598499914
2,0,0,2,1.0,1.0,0.31169816839671566,0.9421700693738009
2,14,1,17,0.125,0.9411764705882353,0.2908998490689846,0.9370507802788526
11,92,2,105,0.10679611650485436,0.9809523809523809,0.3061564371411067,0.940923098436885
17,112,21,150,0.13178294573643412,0.86,0.2691384164021557,0.9531162573906072
21,38,4,63,0.3559322033898305,0.9365079365079365,0.279517809670425,0.9452545678755458
5,24,2,31,0.1724137931034483,0.9354838709677419,0.30414835154234615,0.9384592855198479
1,22,0,23,0.043478260869565216,1.0,0.272775773891765,0.9524934274785181
36,71,10,117,0.3364485981308411,0.9145299145299145,0.17798271648188518,0.9402834152685059
20,88,2,110,0.18518518518518517,0.9818181818181818,0.18658060007976876,0.9460893740156412
31,91,3,125,0.2540983606557377,0.976,0.21455859057566476,0.9453818910224437
145,261,12,418,0.35714285714285715,0.9712918660287081,0.24594977300283408,0.9593759671217831
8,84,13,105,0.08695652173913043,0.8761904761904762,0.20510336811810934,0.9507591870764317
4,35,1,40,0.10256410256410256,0.975,0.19512484089820284,0.9564043483667543
0,12,2,14,0.0,0.8571428571428571,0.18891366077397923,0.9359961851014482
1,14,1,16,0.06666666666666667,0.9375,0.15037338485052573,0.939277625882889
28,225,15,268,0.11067193675889328,0.9440298507462687,0.1397286350753412,0.9338792928726155
43,113,15,171,0.27564102564102566,0.9122807017543859,0.14280615864466803,0.924776535980385
3,23,0,26,0.11538461538461539,1.0,0.1082692669649192,0.928877697976284
2,59,65,126,0.03278688524590164,0.48412698412698413,0.10053074746588651,0.8728686276814992
5,39,8,52,0.11363636363636363,0.8461538461538461,0.1021124990476381,0.854462034274906
13,170,23,206,0.07103825136612021,0.8883495145631068,0.11226082067136955,0.8589201281920843
18,146,2,166,0.10975609756097561,0.9879518072289156,0.11841645365627085,0.8661275292247865
14,132,4,150,0.0958904109589041,0.9733333333333334,0.11630480711341525,0.8703137410229387
8,108,2,118,0.06896551724137931,0.9830508474576272,0.08677973448489433,0.8804237618376876
46,170,6,222,0.21296296296296297,0.972972972972973,0.10071949842465829,0.8765627579766836
10,91,1,102,0.09900990099009901,0.9901960784313726,0.11017992924525791,0.9488583428773106
2,57,1,60,0.03389830508474576,0.9833333333333333,0.09878877802359821,0.9684554124743802
2,29,8,39,0.06451612903225806,0.7948717948717948,0.09785704626161788,0.9551014525184784
6,154,4,164,0.0375,0.975609756097561,0.08753474661004994,0.9533383023568563
20,106,14,140,0.15873015873015872,0.9,0.09651185343451489,0.9428621118806658
28,93,19,140,0.23140495867768596,0.8642857142857143,0.11971748792541584,0.9258956642846783
16,90,2,108,0.1509433962264151,0.9814814814814815,0.11085754982019472,0.9271111655001796
10,56,1,67,0.15151515151515152,0.9850746268656716,0.11835829989520222,0.9263795295622222
3,125,4,132,0.0234375,0.9696969696969697,0.11686389916880997,0.9244314776141703
14,35,1,50,0.2857142857142857,0.98,0.14846363583767105,0.9508783640610569
17,83,1,101,0.17,0.9900990099009901,0.16739220726624246,0.9529482574615467
6,23,1,30,0.20689655172413793,0.9666666666666667,0.1742731205510967,0.9624720669853561
11,77,8,96,0.125,0.9166666666666666,0.1590724121685701,0.9699550601826351
20,34,1,55,0.37037037037037035,0.9818181818181818,0.1904191227605637,0.970003160230735
0,4,59,63,0.0,0.06349206349206349,0.16877410111554209,0.8383485083202197
8,190,9,207,0.04040404040404041,0.9565217391304348,0.17119789260183355,0.8364663325250004
33,189,12,234,0.14864864864864866,0.9487179487179487,0.15161708730674256,0.8319974680561358
46,94,12,152,0.32857142857142857,0.9210526315789473,0.17427014853123232,0.8221336997244154
1,57,7,65,0.017241379310344827,0.8923076923076924,0.14717655247211905,0.8115109891017048
26,197,6,229,0.11659192825112108,0.9737991266375546,0.14597539936513632,0.819672769097546
1,2,65,68,0.3333333333333333,0.04411764705882353,0.14068439407413105,0.6857155498462092
3,11,1,15,0.21428571428571427,0.9333333333333333,0.17129663897209021,0.809978588394962
23,62,2,87,0.27058823529411763,0.9770114942528736,0.20418009538495838,0.8129056962695961
2,60,3,65,0.03225806451612903,0.9538461538461539,0.18755286908031274,0.8136382970021968
43,68,32,143,0.38738738738738737,0.7762237762237763,0.195955148911164,0.7929484605228867
163,423,5,591,0.2781569965870307,0.9915397631133672,0.2332288085221191,0.807124470637983
0,58,1,59,0.0,0.9830508474576272,0.21657281877195894,0.8084461450408506
22,75,9,106,0.2268041237113402,0.9150943396226415,0.20135436025453138,0.9328713868356818
2,0,0,2,1.0,1.0,0.3135992582137151,0.9423951963594913
2,14,1,17,0.125,0.9411764705882353,0.29280093888598396,0.937275907264543
10,93,2,105,0.0970873786407767,0.9809523809523809,0.30206226947521936,0.9411482254225755
19,112,19,150,0.1450381679389313,0.8733333333333333,0.2674409524111542,0.9550210192953692
21,38,4,63,0.3559322033898305,0.9365079365079365,0.2785516962401256,0.9471593297803078
5,24,2,31,0.1724137931034483,0.9354838709677419,0.30318223811204675,0.9403640474246099
1,22,0,23,0.043478260869565216,1.0,0.2746017919410099,0.9515410465261372
37,71,9,117,0.3425925925925926,0.9230769230769231,0.18068644802566602,0.9405520355371263
20,88,2,110,0.18518518518518517,0.9818181818181818,0.1892843316235496,0.9463579942842614
32,90,3,125,0.26229508196721313,0.976,0.21565935720277699,0.9456505112910641
143,263,13,419,0.3522167487684729,0.9689737470167065,0.24729471691695445,0.960265808483927
7,85,13,105,0.07608695652173914,0.8761904761904762,0.20489551700117384,0.9516490284385756
4,34,2,40,0.10526315789473684,0.95,0.1953025691142151,0.9537227611574696
0,12,2,14,0.0,0.8571428571428571,0.18909138898999148,0.9333145978921634
2,13,1,16,0.13333333333333333,0.9375,0.15919720909581156,0.935375037452603
25,229,14,268,0.0984251968503937,0.9477611940298507,0.14680292504798423,0.9305097534828414
46,110,15,171,0.2948717948717949,0.9122807017543859,0.15145674117721017,0.9214069965906109
2,24,0,26,0.07692307692307693,1.0,0.11212907377072504,0.925839318445367
3,57,66,126,0.05,0.47619047619047616,0.10840236569619087,0.8686964613025098
5,39,8,52,0.11363636363636363,0.8461538461538461,0.10959853794499472,0.8538612964673451
14,167,25,206,0.07734806629834254,0.8786407766990292,0.12064826170190078,0.8569324278325124
17,147,2,166,0.10365853658536585,0.9879518072289156,0.11640900502361971,0.8641398288652147
15,131,4,150,0.10273972602739725,0.9733333333333334,0.11702536633462023,0.8677929916228552
6,110,2,118,0.05172413793103448,0.9830508474576272,0.08228998677165444,0.8779030124376038
46,170,6,222,0.21296296296296297,0.972972972972973,0.10172425620592387,0.8740420085766
11,90,1,102,0.10891089108910891,0.9901960784313726,0.11014009779008228,0.9474713803252995
2,57,1,60,0.03389830508474576,0.9833333333333333,0.0987489465684226,0.9670684499223691
2,29,8,39,0.06451612903225806,0.7948717948717948,0.09691581267326768,0.9551014525184784
6,154,4,164,0.0375,0.975609756097561,0.08746459316107257,0.9533383023568563
20,106,14,140,0.15873015873015872,0.9,0.09546322640432418,0.9428621118806657
31,91,18,140,0.2540983606557377,0.8714285714285714,0.12437382965071035,0.9269160724479436
14,92,2,108,0.1320754716981132,0.9814814814814815,0.11281847375573184,0.9281315736634449
9,57,1,67,0.13636363636363635,0.9850746268656716,0.11674029450923576,0.9273999377254876
4,124,4,132,0.03125,0.9696969696969697,0.11636196521141494,0.9254518857774355
13,36,1,50,0.2653061224489796,0.98,0.1450462499852323,0.951898772224322
17,83,1,101,0.17,0.9900990099009901,0.1639748214138037,0.9539686656248119
5,24,1,30,0.1724137931034483,0.9666666666666667,0.16592962632427363,0.9634924751486215
10,77,9,96,0.11494252873563218,0.90625,0.14605022176425858,0.9684669649445398
20,34,1,55,0.37037037037037035,0.9818181818181818,0.1800923501460096,0.9685150649926398
0,4,59,63,0.0,0.06349206349206349,0.16061183066549015,0.8368604130821244
9,189,9,207,0.045454545454545456,0.9565217391304348,0.16264105144471092,0.8349782372869051
33,190,11,234,0.14798206278026907,0.9529914529914529,0.14588047149203795,0.8311198734285413
45,96,11,152,0.3191489361702128,0.9276315789473685,0.16718746237349694,0.822195954720881
1,57,7,65,0.017241379310344827,0.8923076923076924,0.14501997468876787,0.8115732440981704
30,193,6,229,0.13452914798206278,0.9737991266375546,0.14781806315254367,0.8212231193321068
1,2,65,68,0.3333333333333333,0.04411764705882353,0.14252705786153838,0.6872659000807699
4,10,1,15,0.2857142857142857,0.9333333333333333,0.18334338439215062,0.8115289386295227
22,63,2,87,0.25882352941176473,0.9770114942528736,0.21382466781461051,0.8144560465041568
2,60,3,65,0.03225806451612903,0.9538461538461539,0.19729266806259052,0.8145781466262569
40,71,32,143,0.36036036036036034,0.7762237762237763,0.20318001437546873,0.7929484605228867
161,425,5,591,0.27474402730375425,0.9915397631133672,0.2399661069459558,0.807124470637983
0,58,1,59,0.0,0.9830508474576272,0.22074765723423256,0.8084461450408506
22,75,9,106,0.2268041237113402,0.9150943396226415,0.20552919871680495,0.9328713868356818
2,0,0,2,1.0,1.0,0.3075700150433356,0.9423951963594913
2,14,1,17,0.125,0.9411764705882353,0.28845236798451207,0.937275907264543
6,97,2,105,0.05825242718446602,0.9809523809523809,0.2921658483657031,0.9411482254225755
18,113,19,150,0.13740458015267176,0.8733333333333333,0.26031502262174755,0.9550210192953692
22,37,4,63,0.3728813559322034,0.9365079365079365,0.27433464099724025,0.9471593297803077
5,24,2,31,0.1724137931034483,0.9354838709677419,0.29896518286916146,0.9403640474246098
1,22,0,23,0.043478260869565216,1.0,0.28087684751087977,0.9474020583324251
36,73,8,117,0.3302752293577982,0.9316239316239316,0.18520188027627946,0.9376340485644151
15,91,2,108,0.14150943396226415,0.9814814814814815,0.18756037084231722,0.9433919072634503
32,90,3,125,0.26229508196721313,0.976,0.21120621204500667,0.9429708546318715
144,264,11,419,0.35294117647058826,0.9737470167064439,0.24155554185957712,0.9611984504250997
7,85,13,105,0.07608695652173914,0.8761904761904762,0.19787965253151385,0.9531966056193808
4,35,1,40,0.10256410256410256,0.975,0.18702146310189588,0.9591489865717617
0,13,1,14,0.0,0.9285714285714286,0.1808102829776723,0.9489449049391087
1,14,1,16,0.06666666666666667,0.9375,0.1431519168789392,0.949784343278547
27,227,14,268,0.1062992125984252,0.9477611940298507,0.13812188525553365,0.9449671593568855
46,110,15,171,0.2948717948717949,0.9122807017543859,0.1427757013847596,0.935864402464655
3,23,0,26,0.11538461538461539,1.0,0.10883904980104919,0.9396148286494487
3,77,46,126,0.0375,0.6349206349206349,0.10332662744080072,0.9051477084680427
5,46,1,52,0.09803921568627451,0.9807692307692307,0.10268021502968243,0.9059718842922185
12,171,23,206,0.06557377049180328,0.8883495145631068,0.11204789652851146,0.900225896576744
18,146,2,166,0.10975609756097561,0.9879518072289156,0.11820352951341276,0.9074332976094462
16,130,4,150,0.1095890410958904,0.9733333333333334,0.11867350501305064,0.9110864603670866
7,109,2,118,0.0603448275862069,0.9830508474576272,0.08516965254368093,0.9211964811818353
47,169,6,222,0.2175925925925926,0.972972972972973,0.09977079214482053,0.9173354773208315
10,91,1,102,0.09900990099009901,0.9901960784313726,0.10855792085769182,0.9680891121080799
2,57,1,60,0.03389830508474576,0.9833333333333333,0.09939493362890199,0.9684554124743802
2,29,8,39,0.06451612903225806,0.7948717948717948,0.09924384199182412,0.9551014525184784
6,154,4,164,0.0375,0.975609756097561,0.08892154234025618,0.9533383023568565
20,105,15,140,0.16,0.8928571428571429,0.0961231078979861,0.9418417037174006
35,85,20,140,0.2916666666666667,0.8571428571428571,0.12916908490948037,0.9238548479581478
15,91,2,108,0.14150943396226415,0.9814814814814815,0.11830006224800486,0.9250703491736488
9,57,1,67,0.13636363636363635,0.9850746268656716,0.1236363101585102,0.9243387132356915
5,123,4,132,0.0390625,0.9696969696969697,0.12437405228926081,0.9223906612876397
14,35,1,50,0.2857142857142857,0.98,0.1559737889581219,0.9488375477345262
17,83,1,101,0.17,0.9900990099009901,0.17490236038669332,0.9509074411350159
6,23,1,30,0.20689655172413793,0.9666666666666667,0.18160186777585588,0.9614516588220908
11,80,5,96,0.12087912087912088,0.9479166666666666,0.15720364694906364,0.9744193458969208
18,36,1,55,0.3333333333333333,0.9818181818181818,0.18460706114493067,0.9744674459450209
0,4,59,63,0.0,0.06349206349206349,0.16512654166441118,0.8428127940345054
9,185,13,207,0.04639175257731959,0.9371980676328503,0.16617357774688538,0.8381700937396311
33,191,10,234,0.14732142857142858,0.9572649572649573,0.1464031695836201,0.8349222304917678
43,107,2,152,0.2866666666666667,0.9868421052631579,0.16306983625028676,0.834456958400649
2,56,7,65,0.034482758620689655,0.8923076923076924,0.13843929437836558,0.8238342477779383
30,193,6,229,0.13452914798206278,0.9737991266375546,0.14038929825021443,0.827531742059494
8,58,2,68,0.12121212121212122,0.9705882352941176,0.11008626794718414,0.8259274639846276
4,10,1,15,0.2857142857142857,0.9333333333333333,0.1509025944777964,0.9501905025333803
20,65,2,87,0.23529411764705882,0.9770114942528736,0.17788864663061627,0.9558781349076695
1,61,3,65,0.016129032258064516,0.9538461538461539,0.15914687572870712,0.9553897344192689
41,73,29,143,0.35964912280701755,0.7972027972027972,0.1695729408916144,0.9282984046963602
165,421,5,591,0.2815699658703072,0.9915397631133672,0.20487111335584546,0.9424744148114568
0,58,1,59,0.0,0.9830508474576272,0.18565266364412222,0.9437960892143241
23,74,9,106,0.23711340206185566,0.9150943396226415,0.20220998947979857,0.9358683898326847
2,0,0,2,1.0,1.0,0.3042508058063292,0.9453921993564942
2,14,1,17,0.125,0.9411764705882353,0.2884945032853207,0.9402729102615458
8,95,2,105,0.07766990291262135,0.9809523809523809,0.2972860562359717,0.9441452284195784
17,113,20,150,0.13076923076923078,0.8666666666666667,0.2645889288020022,0.9540686383429883
22,37,4,63,0.3728813559322034,0.9365079365079365,0.2776334130965588,0.9462069488279267
5,24,2,31,0.1724137931034483,0.9354838709677419,0.30226395496847996,0.9394116664722288
1,21,0,22,0.045454545454545456,1.0,0.28236891709691536,0.949400060330427
34,64,11,109,0.3469387755102041,0.8990825688073395,0.18907445645551596,0.9349832844457613
21,67,2,90,0.23863636363636365,0.9777777777777777,0.20530822268928217,0.9402120426156958
29,74,3,106,0.2815533980582524,0.9716981132075472,0.2301691535946854,0.9391764347280522
150,218,13,381,0.4076086956521739,0.9658792650918635,0.2686544841001643,0.95428206400691
4,79,13,96,0.04819277108433735,0.8645833333333334,0.22099371113818653,0.9446220559358849
4,28,1,33,0.125,0.9696969696969697,0.21334064991369675,0.94981686113069
0,12,2,14,0.0,0.8571428571428571,0.20684714342019023,0.9294086978653838
1,8,1,10,0.1111111111111111,0.9,0.17315747707746268,0.9295397594643353
25,193,14,232,0.11467889908256881,0.9396551724137931,0.155449267855492,0.9240936729837662
45,95,15,155,0.32142857142857145,0.9032258064516129,0.161145721194109,0.9143119148757756
3,21,0,24,0.125,1.0,0.1207730503866556,0.9191863055769378
2,44,76,122,0.043478260869565216,0.3770491803278688,0.12009954892740242,0.8495385694333002
3,37,8,48,0.075,0.8333333333333334,0.11295669178454529,0.8300580499527807
13,151,24,188,0.07926829268292683,0.8723404255319149,0.12428073359639198,0.8322291311512175
16,119,2,137,0.11851851851851852,0.9854014598540146,0.12533893465459303,0.844429339701791
15,122,4,141,0.10948905109489052,0.9716312056737588,0.12459752779921043,0.8489973444532147
5,96,2,103,0.04950495049504951,0.9805825242718447,0.08575129623727872,0.8600483041418192
47,169,6,222,0.2175925925925926,0.972972972972973,0.09897880946479194,0.8561873002808154
7,71,1,79,0.08974358974358974,0.9873417721518988,0.10558814216108116,0.9433719562556767
3,48,1,52,0.058823529411764705,0.9807692307692307,0.10327721779133325,0.9644342273179479
3,26,8,37,0.10344827586206896,0.7837837837837838,0.10673150110263928,0.9517832784967862
13,142,4,159,0.08387096774193549,0.9748427672955975,0.10178185099169886,0.9502748938455837
21,95,15,131,0.1810344827586207,0.8854961832061069,0.1120026269436603,0.9379698906359193
24,82,19,125,0.22641509433962265,0.848,0.13727550463574217,0.9190295300256557
14,84,2,100,0.14285714285714285,0.98,0.12659901181639224,0.9200333910295166
9,56,1,66,0.13846153846153847,0.9848484848484849,0.13355871877609918,0.9196772071290289
5,110,4,119,0.043478260869565216,0.9663865546218487,0.13136653755578495,0.9176225391079743
12,34,1,47,0.2608695652173913,0.9787234042553191,0.1538552931779739,0.9454710563181938
17,82,1,100,0.1717171717171717,0.99,0.1664047508887219,0.9476363752759654
5,22,1,28,0.18518518518518517,0.9642857142857143,0.1669977083782311,0.9588920225730523
9,60,9,78,0.13043478260869565,0.8846153846153846,0.15328623527381297,0.9641227918038215
19,33,1,53,0.36538461538461536,0.9811320754716981,0.18507587420630905,0.964284516871207
0,1,59,60,0.0,0.016666666666666666,0.1652956544260893,0.8259728285595187
9,159,13,181,0.05357142857142857,0.9281767955801105,0.16673753552635545,0.820514291553556
32,157,11,200,0.1693121693121693,0.945,0.15365790753989517,0.8156966623742247
40,92,12,144,0.30303030303030304,0.9166666666666666,0.17241692629891395,0.8052204718980344
0,56,7,63,0.0,0.8888888888888888,0.1459618998438875,0.7944494968413449
29,173,6,208,0.14356435643564355,0.9711538461538461,0.14783755324773717,0.8068121342039822
1,2,65,68,0.3333333333333333,0.04411764705882353,0.14325879866898258,0.6729529301450002
5,9,1,15,0.35714285714285715,0.9333333333333333,0.1942792068322479,0.8039053110973812
22,45,2,69,0.3283582089552239,0.9710144927536232,0.2335344611727901,0.8100249821221687
1,59,3,63,0.016666666666666666,0.9523809523809523,0.21172796079486114,0.8110794038908763
42,69,32,143,0.3783783783783784,0.7762237762237763,0.22249197155887193,0.791016133827606
164,419,5,588,0.28130360205831906,0.9914965986394558,0.2626782004243461,0.805674378077687
0,52,1,53,0.0,0.9811320754716981,0.24216900664782556,0.8070998394088088
21,65,9,95,0.2441860465116279,0.9052631578947369,0.2294336799590105,0.9301206266710821
2,0,0,2,1.0,1.0,0.3212704146528881,0.9396444361948916
2,14,1,17,0.125,0.9411764705882353,0.29221924194499893,0.9353818615998363
9,84,2,95,0.0967741935483871,0.9789473684210527,0.3036631743566733,0.9391770638912791
17,104,22,143,0.14049586776859505,0.8461538461538461,0.26967995855527566,0.9491670738812891
21,34,4,59,0.38181818181818183,0.9322033898305084,0.28403918423525604,0.9406966154800109
5,23,2,30,0.17857142857142858,0.9333333333333333,0.30954938831688866,0.9338682237459589
1,21,0,22,0.045454545454545456,1.0,0.2762710808623039,0.9515410465261372
36,63,10,109,0.36363636363636365,0.908256880733945,0.185361989953213,0.9384348866309864
21,67,2,90,0.23863636363636365,0.9777777777777777,0.20159575618697925,0.943663644800921
31,70,3,104,0.3069306930693069,0.9711538461538461,0.23296033508592323,0.9422638541154162
148,220,13,381,0.40217391304347827,0.9658792650918635,0.27173243255367285,0.9564370824618729
4,79,13,96,0.04819277108433735,0.8645833333333334,0.22534834900397774,0.9461621391512152
4,28,1,33,0.125,0.9696969696969697,0.2185749499891994,0.9510497246839621
0,12,2,14,0.0,0.8571428571428571,0.21208144349569294,0.930641561418656
0,9,1,10,0.0,0.9,0.16013339154764097,0.9294620070280925
23,195,14,232,0.10550458715596331,0.9396551724137931,0.14111456633615518,0.9240159205475232
45,94,15,154,0.3237410071942446,0.9025974025974026,0.14351603978257485,0.9142221428966026
3,21,0,24,0.125,1.0,0.10391976649064939,0.919096533597765
3,55,64,122,0.05172413793103448,0.47540983606557374,0.10442424746874898,0.8635003197023707
3,37,8,48,0.075,0.8333333333333334,0.09728139032589185,0.8440198002218514
14,152,22,188,0.08433734939759036,0.8829787234042553,0.10932958309697617,0.8477106382591939
17,119,2,138,0.125,0.9855072463768116,0.12718672595411903,0.859925959170167
13,124,4,141,0.0948905109489051,0.9716312056737588,0.1256704293531107,0.8644939639215907
6,96,2,104,0.058823529411764705,0.9807692307692307,0.08782507538418502,0.8756613679461375
47,169,6,222,0.2175925925925926,0.972972972972973,0.10105258861169823,0.8718003640851337
7,71,1,79,0.08974358974358974,0.9873417721518988,0.1064839388706347,0.9449334978117516
2,49,1,52,0.0392156862745098,0.9807692307692307,0.10137189405270754,0.9659957688740226
3,26,8,37,0.10344827586206896,0.7837837837837838,0.10410202640477591,0.9518250632139552
13,143,4,160,0.08333333333333333,0.975,0.09814964545239495,0.9503240280172679
20,97,14,131,0.17094017094017094,0.8931297709923665,0.10901388259400435,0.9391095373484974
29,77,19,125,0.27358490566037735,0.848,0.13969407920094903,0.9201425043814646
14,84,2,100,0.14285714285714285,0.98,0.12901758638159905,0.9211463653853256
9,56,1,66,0.13846153846153847,0.9848484848484849,0.135977293341306,0.9207901814848378
4,111,4,119,0.034782608695652174,0.9663865546218487,0.13534399654432636,0.9187355134637832
14,32,1,47,0.30434782608695654,0.9787234042553191,0.1640439322907389,0.9465840306740027
17,82,1,100,0.1717171717171717,0.99,0.1766701949170015,0.9487268878168598
7,20,1,28,0.25925925925925924,0.9642857142857143,0.18928720753401412,0.9588920225730523
8,61,9,78,0.11594202898550725,0.8846153846153846,0.16676679658046126,0.9641227918038215
19,33,1,53,0.36538461538461536,0.9811320754716981,0.19855643551295735,0.964284516871207
0,1,59,60,0.0,0.016666666666666666,0.17877621573273755,0.8259728285595187
9,160,13,182,0.05325443786982249,0.9285714285714286,0.18141504847190476,0.820570667695173
33,156,11,200,0.1746031746031746,0.945,0.16288009825993588,0.8157530385158415
40,93,12,145,0.3007518796992481,0.9172413793103448,0.1813136279716611,0.805358949845891
2,54,7,63,0.03571428571428571,0.8888888888888888,0.14937863175095054,0.7945879747892015
31,171,6,208,0.15346534653465346,0.9711538461538461,0.15473910568654287,0.8069506121518388
1,2,65,68,0.3333333333333333,0.04411764705882353,0.1501603511077883,0.6730914080928568
5,9,1,15,0.35714285714285715,0.9333333333333333,0.20118075927105358,0.8040437890452378
22,45,2,69,0.3283582089552239,0.9710144927536232,0.2404812979975395,0.8101070839284085
2,58,3,63,0.03333333333333333,0.9523809523809523,0.22029989210184794,0.8111615056971158
42,69,32,143,0.3783783783783784,0.7762237762237763,0.23138939191315225,0.791016133827606
167,416,5,588,0.2864493996569468,0.9914965986394558,0.267208693904961,0.8056743780776872
0,52,1,53,0.0,0.9811320754716981,0.24528507297143906,0.8070998394088089
23,65,8,96,0.26136363636363635,0.9166666666666666,0.23500368769005378,0.9317496993527864
2,0,0,2,1.0,1.0,0.3268404223839313,0.9412735088765959
2,14,1,17,0.125,0.9411764705882353,0.2977892496760422,0.9370109342815406
10,83,2,95,0.10752688172043011,0.9789473684210527,0.308388328017056,0.9408061365729834
17,106,20,143,0.13821138211382114,0.8601398601398601,0.2740787571221192,0.9527941485609954
21,34,4,59,0.38181818181818183,0.9322033898305084,0.2877028688594385,0.9443236901597171
5,23,2,30,0.17857142857142858,0.9333333333333333,0.3132130729410712,0.937495298425665
1,23,0,24,0.041666666666666664,1.0,0.2741194874609162,0.9515410465261372
36,70,11,117,0.33962264150943394,0.905982905982906,0.17977986481940675,0.9381100330951238
25,83,2,110,0.23148148148148148,0.9818181818181818,0.19499150503104698,0.9439159918422592
33,89,3,125,0.27049180327868855,0.976,0.22253749079762802,0.9432085088490617
151,255,13,419,0.37192118226600984,0.9689737470167065,0.2547899673850799,0.9578238060419245
5,87,13,105,0.05434782608695652,0.8761904761904762,0.21170648491324082,0.949207025996573
4,35,1,40,0.10256410256410256,0.975,0.20172795769333432,0.9548521872868955
0,12,2,14,0.0,0.8571428571428571,0.19577557674095333,0.9344440240215894
1,14,1,16,0.06666666666666667,0.9375,0.15678186604912944,0.9389464660240315
24,231,14,269,0.09411764705882353,0.9479553903345725,0.13715846113160687,0.9341089243835159
46,110,15,171,0.2948717948717949,0.9122807017543859,0.1406413170734792,0.9250061674912853
4,22,0,26,0.15384615384615385,1.0,0.10948774158492836,0.9294384893460415
4,54,68,126,0.06896551724137931,0.4603174603174603,0.11157598317841733,0.8700280585070393
4,40,8,52,0.09090909090909091,0.8461538461538461,0.10991098151341563,0.8516214651004459
13,168,25,206,0.0718232044198895,0.8786407766990292,0.12017143928768557,0.8546925964656132
16,148,2,166,0.0975609756097561,0.9879518072289156,0.12458491199384121,0.8618999974983155
15,131,4,150,0.10273972602739725,0.9733333333333334,0.12581663756078032,0.86552541792671
7,109,2,118,0.0603448275862069,0.9830508474576272,0.09231278509141061,0.8756354387414588
48,168,6,222,0.2222222222222222,0.972972972972973,0.10208079485942037,0.8717744348804548
10,91,1,102,0.09900990099009901,0.9901960784313726,0.10637284968066604,0.9474713803252994
2,57,1,60,0.03389830508474576,0.9833333333333333,0.09822845170575958,0.9670684499223691
3,28,8,39,0.0967741935483871,0.7948717948717948,0.1017928787241164,0.9551014525184784
13,147,4,164,0.08125,0.975609756097561,0.0994627393512941,0.9533383023568563
20,106,14,140,0.15873015873015872,0.9,0.10746137259454572,0.9428621118806658
29,89,22,140,0.2457627118644068,0.8428571428571429,0.13394964177714572,0.9228344397948823
15,91,2,108,0.14150943396226415,0.9814814814814815,0.12241924345429457,0.9240499410103836
10,55,1,66,0.15384615384615385,0.9848484848484849,0.1302529938623024,0.923285999069971
3,125,4,132,0.0234375,0.9696969696969697,0.12875859313591015,0.9213379471219191
15,34,1,50,0.30612244897959184,0.98,0.1586654867689394,0.9477848335688056
16,84,1,101,0.16,0.9900990099009901,0.1699154867689394,0.9498547269692955
6,23,1,30,0.20689655172413793,0.9666666666666667,0.1767964000537936,0.959378536493105
10,82,4,96,0.10869565217391304,0.9583333333333334,0.15721539152658018,0.9758751351325607
18,36,1,55,0.3333333333333333,0.9818181818181818,0.18461880572244718,0.9759232351806607
0,4,59,63,0.0,0.06349206349206349,0.16264078374442523,0.8443008892726007
9,186,13,208,0.046153846153846156,0.9375,0.16588597605211755,0.8397013221730336
34,189,11,234,0.15246636771300448,0.9529914529914529,0.1439351072997479,0.8358429583146696
37,102,12,151,0.26618705035971224,0.9205298013245033,0.15910468592256394,0.8259044999466001
2,60,2,64,0.03225806451612903,0.96875,0.1341563306071341,0.8262021189942191
34,189,6,229,0.15246636771300448,0.9737991266375546,0.14040928996986143,0.8284115180376793
1,1,65,67,0.5,0.029850746268656716,0.16421881377938524,0.6924161701020329
5,9,1,15,0.35714285714285715,0.9333333333333333,0.21523922194265058,0.8166792086507856
23,62,2,87,0.27058823529411763,0.9770114942528736,0.24730127753411793,0.8223237078297677
0,62,3,65,0.0,0.9538461538461539,0.22552036786083157,0.8224458079518678
39,71,32,142,0.35454545454545455,0.7746478873239436,0.23814299703022335,0.8016055345232164
163,423,5,591,0.2781569965870307,0.9915397631133672,0.273271415897495,0.8048612149679831
0,58,1,59,0.0,0.9830508474576272,0.25149050622420865,0.8061828893708507
23,75,8,106,0.23469387755102042,0.9245283018867925,0.21358963158864014,0.9339939687448701
2,0,0,2,1.0,1.0,0.30542636628251774,0.9435177782686797
2,14,1,17,0.125,0.9411764705882353,0.2846280469547866,0.9383984891737313
9,94,2,105,0.08737864077669903,0.9809523809523809,0.2971107099228864,0.9422708073317636
17,113,20,150,0.13076923076923078,0.8666666666666667,0.26514267795485447,0.9554163472378671
22,37,4,63,0.3728813559322034,0.9365079365079365,0.27867472928987913,0.9475546577228054
5,24,2,31,0.1724137931034483,0.9354838709677419,0.3033052711618004,0.9407593753671074
1,23,0,24,0.041666666666666664,1.0,0.2761543145850048,0.9505886655737562
34,73,10,117,0.3177570093457944,0.9145299145299145,0.17869103020583257,0.9383786533637439
26,82,2,110,0.24074074074074073,0.9818181818181818,0.1952254217402241,0.9441846121108792
34,88,3,125,0.2786885245901639,0.976,0.22116844259013657,0.9434771291176819
156,250,13,419,0.3842364532019704,0.9689737470167065,0.25834064908299836,0.9590448072629257
5,87,13,105,0.05434782608695652,0.8761904761904762,0.21283585910510588,0.9504280272175742
4,35,1,40,0.10256410256410256,0.975,0.2028573318851994,0.9560731885078969
0,12,2,14,0.0,0.8571428571428571,0.19690495093281843,0.9356650252425907
1,14,1,16,0.06666666666666667,0.9375,0.1610349019786573,0.9389464660240314
25,230,14,269,0.09803921568627451,0.9479553903345725,0.14064896982801928,0.9341089243835159
47,109,15,171,0.30128205128205127,0.9122807017543859,0.14387661649828892,0.9250061674912854
3,23,0,26,0.11538461538461539,1.0,0.10546921109580963,0.9294384893460416
4,56,66,126,0.06666666666666667,0.47619047619047616,0.10722904546433965,0.8722956322031843
5,39,8,52,0.11363636363636363,0.8461538461538461,0.10881079704609123,0.8538890387965911
13,168,25,206,0.0718232044198895,0.8786407766990292,0.11907125482036116,0.8569601701617585
18,146,2,166,0.10975609756097561,0.9879518072289156,0.12522688780526245,0.8641675711944607
15,131,4,150,0.10273972602739725,0.9733333333333334,0.1258983892825657,0.867792991622855
7,109,2,118,0.0603448275862069,0.9830508474576272,0.09147878589744506,0.8779030124376037
49,167,6,222,0.22685185185185186,0.972972972972973,0.10740267682133597,0.8740420085766001
10,91,1,102,0.09900990099009901,0.9901960784313726,0.11202313886754059,0.9474713803252995
3,56,1,60,0.05084745762711865,0.9833333333333333,0.10305329515193418,0.967068449922369
2,29,8,39,0.06451612903225806,0.7948717948717948,0.1020094272394154,0.9551014525184784
14,146,4,164,0.0875,0.975609756097561,0.0988299847307046,0.9533383023568563
20,106,14,140,0.15873015873015872,0.9,0.10682861797395624,0.9428621118806658
30,90,20,140,0.25,0.8571428571428571,0.13392221403306953,0.9248752561214131
15,91,2,108,0.14150943396226415,0.9814814814814815,0.12173044004884272,0.9260907573369141
10,56,1,67,0.15151515151515152,0.9850746268656716,0.12923119012385023,0.9253591213989569
2,126,4,132,0.015625,0.9696969696969697,0.12419941046283325,0.923411069450905
14,35,1,50,0.2857142857142857,0.98,0.15579914713169438,0.9498579558977914
17,83,1,101,0.17,0.9900990099009901,0.16758486141740864,0.9519278492982812
5,24,1,30,0.1724137931034483,0.9666666666666667,0.1695396663278786,0.9614516588220908
11,81,4,96,0.11956521739130435,0.9583333333333334,0.15090612595520778,0.9759074411350159
17,37,1,55,0.3148148148148148,0.9818181818181818,0.1756640375055722,0.9759555411831161
0,4,59,63,0.0,0.06349206349206349,0.1540190158605505,0.8443008892726007
7,188,13,208,0.035897435897435895,0.9375,0.1569150781316128,0.8397013221730335
34,189,11,234,0.15246636771300448,0.9529914529914529,0.1378796612742869,0.8358429583146697
40,98,13,151,0.2898550724637681,0.9139072847682119,0.15500181448339664,0.8249584261528442
2,60,2,64,0.03225806451612903,0.96875,0.13497956754235102,0.8252560452004633
34,189,6,229,0.15246636771300448,0.9737991266375546,0.13967973187402247,0.8274654442439234
1,1,65,67,0.5,0.029850746268656716,0.16613475832904892,0.6914700963082769
5,9,1,15,0.35714285714285715,0.9333333333333333,0.21715516649231423,0.8157331348570297
24,61,2,87,0.2823529411764706,0.9770114942528736,0.25236309581789057,0.8213776340360118
0,62,3,65,0.0,0.9538461538461539,0.23058218614460424,0.821499734158112
43,67,32,142,0.39090909090909093,0.7746478873239436,0.2450184744939361,0.8016055345232164
159,427,5,591,0.2713310580204778,0.9915397631133672,0.27917175928027166,0.8048612149679831
0,58,1,59,0.0,0.9830508474576272,0.2573908496069853,0.8061828893708507
24,74,8,106,0.24489795918367346,0.9245283018867925,0.22094770091893862,0.9339939687448701
2,0,0,2,1.0,1.0,0.31278443561281616,0.9435177782686797
2,14,1,17,0.125,0.9411764705882353,0.2903054440161775,0.9383984891737313
8,95,2,105,0.07766990291262135,0.9809523809523809,0.3014011444322663,0.9422708073317636
19,111,20,150,0.14615384615384616,0.8666666666666667,0.2664361094672313,0.9554163472378671
21,38,4,63,0.3559322033898305,0.9365079365079365,0.27852198737713885,0.9475546577228054
5,24,2,31,0.1724137931034483,0.9354838709677419,0.30315252924906,0.9407593753671074
1,23,0,24,0.041666666666666664,1.0,0.272209746716224,0.9515410465261372
34,73,10,117,0.3177570093457944,0.9145299145299145,0.1747464623370518,0.939331034316125
24,84,2,110,0.2222222222222222,0.9818181818181818,0.18863535122594066,0.9451369930632604
33,89,3,125,0.27049180327868855,0.976,0.21479437444051058,0.9444295100700629
158,248,13,419,0.3891625615763547,0.9689737470167065,0.252806608511858,0.9590448072629257
6,86,13,105,0.06521739130434782,0.8761904761904762,0.2112759210710747,0.9504280272175742
4,35,1,40,0.10256410256410256,0.975,0.20129739385116818,0.9560731885078967
0,12,2,14,0.0,0.8571428571428571,0.19534501289878722,0.9356650252425907
2,13,1,16,0.13333333333333333,0.9375,0.16899877346843567,0.9389464660240315
26,229,14,269,0.10196078431372549,0.9479553903345725,0.15181856805293611,0.9341089243835159
47,109,15,171,0.30128205128205127,0.9122807017543859,0.1562171749105594,0.9250061674912853
2,24,0,26,0.07692307692307693,1.0,0.1116115342458054,0.9294384893460415
5,60,61,126,0.07692307692307693,0.5158730158730159,0.113283775048481,0.8779645664435473
5,39,8,52,0.11363636363636363,0.8461538461538461,0.11486552663023257,0.8595579730369539
14,167,25,206,0.07734806629834254,0.8786407766990292,0.12591525038713866,0.8626291044021211
21,143,2,166,0.12804878048780488,0.9879518072289156,0.12516031426634888,0.8698365054348234
15,131,4,150,0.10273972602739725,0.9733333333333334,0.12527159165401627,0.8734619258632179
6,110,2,118,0.05172413793103448,0.9830508474576272,0.08962046117529958,0.8835719466779667
50,166,6,222,0.23148148148148148,0.972972972972973,0.11170023325507164,0.8797109428169627
10,91,1,102,0.09900990099009901,0.9901960784313726,0.11485549383607482,0.9474713803252994
2,57,1,60,0.03389830508474576,0.9833333333333333,0.10346434261441513,0.9670684499223691
2,29,8,39,0.06451612903225806,0.7948717948717948,0.1016312087192602,0.9551014525184784
13,147,4,164,0.08125,0.975609756097561,0.0949456686495738,0.9533383023568563
20,104,16,140,0.16129032258064516,0.8857142857142857,0.10331003958575205,0.9408212955541353
30,90,20,140,0.25,0.8571428571428571,0.1316351627384614,0.9228344397948823
16,91,2,109,0.14953271028037382,0.981651376146789,0.11992819542401748,0.9240742116768562
10,56,1,67,0.15151515151515152,0.9850746268656716,0.12742894549902498,0.9233425757388989
3,125,4,132,0.0234375,0.9696969696969697,0.12593454477263272,0.9213945237908469
15,34,1,50,0.30612244897959184,0.98,0.16044973333653756,0.9478414102377333
17,83,1,101,0.17,0.9900990099009901,0.17312830476510896,0.9499113036382232
6,23,1,30,0.20689655172413793,0.9666666666666667,0.1796434803570365,0.9614759294885633
10,77,9,96,0.11494252873563218,0.90625,0.16034955589069824,0.9684912356110124
20,34,1,55,0.37037037037037035,0.9818181818181818,0.19189779304641202,0.9685150649926398
0,4,59,63,0.0,0.06349206349206349,0.1702527714013904,0.8368604130821244
8,187,13,208,0.041025641025641026,0.9375,0.17276536297648198,0.8322608459825573
35,188,11,234,0.15695067264573992,0.9529914529914529,0.15145510921450311,0.8284024821241935
45,95,11,151,0.32142857142857145,0.9271523178807947,0.1730877622757276,0.8194100975498798
1,57,7,65,0.017241379310344827,0.8923076923076924,0.1459941662166143,0.8087873869271692
34,189,6,229,0.15246636771300448,0.9737991266375546,0.15135471464195321,0.8184372621611056
1,2,64,67,0.3333333333333333,0.04477611940298507,0.1460637093509479,0.6845741103875059
5,9,1,15,0.35714285714285715,0.9333333333333333,0.19708411751421323,0.8088371489362588
23,62,2,87,0.27058823529411763,0.9770114942528736,0.22987877383828131,0.8144816481152407
1,61,3,65,0.016129032258064516,0.9538461538461539,0.20976139664004198,0.8146037482373408
45,66,32,143,0.40540540540540543,0.7762237762237763,0.2217580872081611,0.7930425280006241
163,423,5,591,0.2781569965870307,0.9915397631133672,0.2590317468191162,0.8072185381157204
0,58,1,59,0.0,0.9830508474576272,0.2372508371458299,0.808540212518588
22,75,9,106,0.2268041237113402,0.9150943396226415,0.22203237862840228,0.9328713868356818
2,0,0,2,1.0,1.0,0.31386911332227985,0.9423951963594913
2,14,1,17,0.125,0.9411764705882353,0.2930707939945488,0.937275907264543
10,93,2,105,0.0970873786407767,0.9809523809523809,0.3046362720492219,0.9411482254225755
16,113,21,150,0.12403100775193798,0.86,0.264439929527298,0.9531162573906072
22,37,4,63,0.3728813559322034,0.9365079365079365,0.27797198086232267,0.9452545678755458
5,24,2,31,0.1724137931034483,0.9354838709677419,0.3026025227342438,0.9384592855198479
1,23,0,24,0.041666666666666664,1.0,0.269030644200461,0.9508766840069359
35,72,10,117,0.32710280373831774,0.9145299145299145,0.17290247330593503,0.9386666717969236
25,83,2,110,0.23148148148148148,0.9818181818181818,0.18811411351757523,0.9444726305440589
34,88,3,125,0.2786885245901639,0.976,0.2168310594715099,0.9437651475508618
156,250,13,419,0.3842364532019704,0.9689737470167065,0.2551106856764426,0.9593328256961055
7,85,13,105,0.07608695652173914,0.8761904761904762,0.21513279326671522,0.950716045650754
4,35,1,40,0.10256410256410256,0.975,0.20597528410920604,0.9560731885078969
0,12,2,14,0.0,0.8571428571428571,0.20002290315682508,0.9356650252425907
1,14,1,16,0.06666666666666667,0.9375,0.1628177407180178,0.9389464660240315
28,227,14,269,0.10980392156862745,0.9479553903345725,0.14543523215903864,0.9341089243835159
48,108,15,171,0.3076923076923077,0.9122807017543859,0.1495786297450592,0.9250061674912853
2,24,0,26,0.07692307692307693,1.0,0.1056767188480744,0.9294384893460416
4,60,62,126,0.0625,0.5079365079365079,0.10373572505925455,0.8768307795954746
5,39,8,52,0.11363636363636363,0.8461538461538461,0.10531747664100612,0.8584241861888813
13,168,25,206,0.0718232044198895,0.8786407766990292,0.11557793441527606,0.8614953175540487
21,143,2,166,0.12804878048780488,0.9879518072289156,0.1243468078182958,0.868702718586751
14,133,3,150,0.09523809523809523,0.98,0.12226597548536262,0.8732805199675262
6,110,2,118,0.05172413793103448,0.9830508474576272,0.08569909409089502,0.8833905407822751
49,167,6,222,0.22685185185185186,0.972972972972973,0.10711749050929144,0.8795295369212711
10,91,1,102,0.09900990099009901,0.9901960784313726,0.11233319065073415,0.9484237612776804
3,56,1,60,0.05084745762711865,0.9833333333333333,0.10336334693512773,0.9680208308747499
2,29,8,39,0.06451612903225806,0.7948717948717948,0.10231947902260895,0.9560538334708593
14,146,4,164,0.0875,0.975609756097561,0.09652679609577967,0.9542906833092373
20,106,14,140,0.15873015873015872,0.9,0.10559709088036018,0.9428621118806658
29,91,20,140,0.24166666666666667,0.8571428571428571,0.13273173784259334,0.924875256121413
16,91,2,109,0.14953271028037382,0.981651376146789,0.12168614618952504,0.9261150280033866
10,56,1,67,0.15151515151515152,0.9850746268656716,0.12918689626453256,0.9253833920654293
6,122,4,132,0.046875,0.9696969696969697,0.1286194023178013,0.9234353401173775
15,34,1,50,0.30612244897959184,0.98,0.16313459088170615,0.949882226564264
17,83,1,101,0.17,0.9900990099009901,0.17492030516742044,0.9519521199647538
7,22,1,30,0.2413793103448276,0.9666666666666667,0.18672732682665885,0.9614759294885634
10,77,9,96,0.11494252873563218,0.90625,0.16862387855079677,0.9684912356110124
19,35,1,55,0.35185185185185186,0.9818181818181818,0.1975266130610079,0.9685150649926398
0,4,59,63,0.0,0.06349206349206349,0.1758815914159863,0.8368604130821244
9,186,13,208,0.046153846153846156,0.9375,0.1757785694379643,0.8322608459825573
34,189,11,234,0.15246636771300448,0.9529914529914529,0.15382770068559465,0.8284024821241934
45,94,12,151,0.3237410071942446,0.9205298013245033,0.1757907017133439,0.8184640237561238
3,55,7,65,0.05172413793103448,0.8923076923076924,0.14869710565423058,0.8078413131334133
33,190,6,229,0.14798206278026907,0.9737991266375546,0.15341703908917873,0.8174911883673497
1,2,64,67,0.3333333333333333,0.04477611940298507,0.15077153644367608,0.68362803659375
5,9,1,15,0.35714285714285715,0.9333333333333333,0.2017919446069414,0.8078910751425029
22,63,2,87,0.25882352941176473,0.9770114942528736,0.23217332792950116,0.813535574321485
1,61,3,65,0.016129032258064516,0.9538461538461539,0.2126965657216526,0.8136576744435849
44,66,33,143,0.4,0.7692307692307693,0.22359070755104624,0.7920435270016232
166,420,5,591,0.2832764505119454,0.9915397631133672,0.2566696093483192,0.8062195371167195
0,58,1,59,0.0,0.9830508474576272,0.23552931466542365,0.807541211519587
22,75,9,106,0.2268041237113402,0.9150943396226415,0.22031085614799606,0.9318723858366809
2,0,0,2,1.0,1.0,0.3121475908418736,0.9413961953604904
2,14,1,17,0.125,0.9411764705882353,0.2930299437830501,0.936276906265542
9,94,2,105,0.08737864077669903,0.9809523809523809,0.30320845928571216,0.9401492244235744
16,114,20,150,0.12307692307692308,0.8666666666666667,0.2636480197252726,0.9540686383429884
21,38,4,63,0.3559322033898305,0.9365079365079365,0.2740274129935419,0.9462069488279268
5,24,2,31,0.1724137931034483,0.9354838709677419,0.2986579548654631,0.9394116664722288
1,23,0,24,0.041666666666666664,1.0,0.2788687767553174,0.9507062809914864
35,74,8,117,0.3211009174311927,0.9316239316239316,0.1818831935312021,0.9409382712234766
22,86,2,110,0.2037037037037037,0.9818181818181818,0.19312657977458833,0.9467442299706119
34,88,3,125,0.2786885245901639,0.976,0.22065043966227688,0.9463231773390329
155,253,11,419,0.3799019607843137,0.9737470167064439,0.2541848211568102,0.9615537701352581
7,85,13,105,0.07608695652173914,0.8761904761904762,0.21050893182874694,0.9535519253295391
4,35,1,40,0.10256410256410256,0.975,0.20053040460884045,0.9591970866198618
0,13,1,14,0.0,0.9285714285714286,0.19457802365645946,0.9489930049872088
1,14,1,16,0.06666666666666667,0.9375,0.15823027354724145,0.9498324433266472
31,224,14,269,0.12156862745098039,0.9479553903345725,0.14649669122542383,0.9449949016861314
50,106,15,171,0.32051282051282054,0.9122807017543859,0.15247159064294621,0.9358921447939009
4,22,0,26,0.15384615384615385,1.0,0.1201779039374948,0.9396425709786946
5,73,48,126,0.0641025641025641,0.6190476190476191,0.11846584787761265,0.9029078771011436
5,46,1,52,0.09803921568627451,0.9807692307692307,0.11781943546649436,0.9037320529253193
12,169,25,206,0.06629834254143646,0.8786407766990292,0.12729062725812815,0.8965991026578338
20,144,2,166,0.12195121951219512,0.9879518072289156,0.13518842052177507,0.9038065036905361
15,132,3,150,0.10204081632653061,0.98,0.13239873321828224,0.9083843050713113
6,110,2,118,0.05172413793103448,0.9830508474576272,0.0940003499923128,0.9184943258860601
49,167,6,222,0.22685185185185186,0.972972972972973,0.10442973542169823,0.9146333220250563
10,91,1,102,0.09900990099009901,0.9901960784313726,0.10941649783420322,0.9676545305084497
2,57,1,60,0.03389830508474576,0.9833333333333333,0.1002535106054134,0.9680208308747501
3,28,8,39,0.0967741935483871,0.7948717948717948,0.10460720360640632,0.9560538334708594
13,146,4,163,0.08176100628930817,0.9754601226993865,0.09886574457456535,0.9542693071094981
20,106,14,140,0.15873015873015872,0.9,0.10696422206079793,0.9428407356809266
32,91,17,140,0.2601626016260163,0.8785714285714286,0.13674114544579533,0.9279151044114698
16,91,2,109,0.14953271028037382,0.981651376146789,0.12569555379272704,0.9291548762934434
9,57,1,67,0.13636363636363635,0.9850746268656716,0.1310318017032324,0.9284232403554861
3,125,4,132,0.0234375,0.9696969696969697,0.12953740097684013,0.9264751884074341
15,34,1,50,0.30612244897959184,0.98,0.1594442946098694,0.9529220748543207
17,83,2,102,0.17,0.9803921568627451,0.17204986513996823,0.9536266511633719
6,23,1,30,0.20689655172413793,0.9666666666666667,0.17893077842482238,0.9631504606871815
11,81,4,96,0.11956521739130435,0.9583333333333334,0.15884543781986354,0.9745450185103106
17,37,1,55,0.3148148148148148,0.9818181818181818,0.1824571670390694,0.9745688478919382
0,4,59,63,0.0,0.06349206349206349,0.16297664755854993,0.8429141959814228
10,188,9,207,0.050505050505050504,0.9565217391304348,0.1668434404878429,0.8410320201862035
25,198,10,233,0.11210762331838565,0.9570815450643777,0.13912703682195623,0.8377579551954002
47,93,11,151,0.3357142857142857,0.9271523178807947,0.16280050620971134,0.8301522639122645
2,56,7,65,0.034482758620689655,0.8923076923076924,0.13816996433779016,0.8195295532895539
32,191,6,229,0.14349775784753363,0.9737991266375546,0.14158889868868005,0.8217389523330141
9,56,2,67,0.13846153846153847,0.9701492537313433,0.11639557349535487,0.820071962606323
5,9,1,15,0.35714285714285715,0.9333333333333333,0.16741598165862018,0.9443350011550756
22,63,2,87,0.25882352941176473,0.9770114942528736,0.19717576435957934,0.9472621090297099
2,60,3,65,0.03225806451612903,0.9538461538461539,0.18576868453068557,0.9467999102842494
42,73,28,143,0.3652173913043478,0.8041958041958042,0.1899834139006944,0.9292346940435363
167,419,5,591,0.28498293515358364,0.9915397631133672,0.22576915340539355,0.9434107041586327
0,58,1,59,0.0,0.9830508474576272,0.20526947371288876,0.9447323785615003
22,75,9,106,0.2268041237113402,0.9150943396226415,0.21788984303428902,0.9368673908316857
2,0,0,2,1.0,1.0,0.30972657772816653,0.9463912003554953
2,14,1,17,0.125,0.9411764705882353,0.290608930669343,0.9412719112605468
8,95,2,105,0.07766990291262135,0.9809523809523809,0.29709633615455616,0.9451442294185792
15,114,21,150,0.11627906976744186,0.86,0.26153371879214105,0.9531162573906073
21,38,4,63,0.3559322033898305,0.9365079365079365,0.27166932854017634,0.9452545678755458
5,25,2,32,0.16666666666666666,0.9375,0.29547885234970017,0.9387473039530276
1,21,0,22,0.045454545454545456,1.0,0.28008718200598076,0.9507062809914864
35,64,10,109,0.35353535353535354,0.908256880733945,0.18773508965388835,0.9376001210963356
18,70,2,90,0.20454545454545456,0.9777777777777777,0.19909872601752474,0.9428288792662702
31,70,3,104,0.3069306930693069,0.9711538461538461,0.23372937802281743,0.9417155189423836
165,203,13,381,0.4483695652173913,0.9658792650918635,0.27589277213221436,0.9558221472222402
7,76,13,96,0.08433734939759036,0.8645833333333334,0.23079810776044155,0.9461621391512153
4,28,1,33,0.125,0.9696969696969697,0.22402470874566321,0.9510497246839621
0,12,2,14,0.0,0.8571428571428571,0.21753120225215672,0.930641561418656
1,8,1,10,0.1111111111111111,0.9,0.1828991676201221,0.9294620070280925
30,187,14,231,0.1382488479262673,0.9393939393939394,0.17342822381738104,0.9239786015446869
49,93,15,157,0.34507042253521125,0.9044585987261147,0.17887675659822452,0.9144507090550109
3,21,0,24,0.125,1.0,0.13268110442431147,0.9193250997561735
2,57,63,122,0.03389830508474576,0.48360655737704916,0.12547552666533368,0.8648998460481326
3,37,8,48,0.075,0.8333333333333334,0.11833266952247654,0.8454193265676133
13,151,24,188,0.07926829268292683,0.8723404255319149,0.12965671133432324,0.8475904077660502
18,118,2,138,0.1323529411764706,0.9855072463768116,0.13269125848651744,0.8598057286770232
13,125,3,141,0.09420289855072464,0.9787234042553191,0.12639898000429706,0.8654242236572202
5,96,2,103,0.04950495049504951,0.9805825242718447,0.08417534114141681,0.8762990701637532
49,167,6,222,0.22685185185185186,0.972972972972973,0.09872560569168136,0.8724380663027494
7,71,1,79,0.08974358974358974,0.9873417721518988,0.10670350350008764,0.9444002398420136
2,49,1,52,0.0392156862745098,0.9807692307692307,0.10159145868216048,0.9654625109042846
2,27,8,37,0.06896551724137931,0.7837837837837838,0.10011963361908226,0.9528115620831229
13,144,4,161,0.08280254777070063,0.9751552795031055,0.09304100598968655,0.9513327096725935
20,97,14,131,0.17094017094017094,0.8931297709923665,0.10400347347389317,0.9391050477778861
29,78,18,125,0.27102803738317754,0.856,0.13564962874362574,0.9213075443104797
16,83,2,101,0.16161616161616163,0.9801980198019802,0.12633024442424143,0.9223396938574806
10,56,1,67,0.15151515151515152,0.9850746268656716,0.13515475324875023,0.9220158159594481
4,110,5,119,0.03508771929824561,0.957983193277311,0.1345650436807125,0.9187606677463167
14,32,1,47,0.30434782608695654,0.9787234042553191,0.16819108780150924,0.9466091849565361
18,81,2,101,0.18181818181818182,0.9801980198019802,0.18233617837972085,0.9473295764278039
5,22,1,28,0.18518518518518517,0.9642857142857143,0.18437118041472286,0.9574947111839965
9,61,8,78,0.12857142857142856,0.8974358974358975,0.16402023629875875,0.9634141251034105
19,33,1,53,0.36538461538461536,0.9811320754716981,0.19313001540853783,0.9635475616276559
0,1,59,60,0.0,0.016666666666666666,0.1714849937635162,0.8252035673135122
9,163,9,181,0.05232558139534884,0.9502762430939227,0.17394754549167382,0.8241025744301711
33,155,11,199,0.17553191489361702,0.9447236180904522,0.15554527246405386,0.8192454621209044
43,90,11,144,0.3233082706766917,0.9236111111111112,0.17575814230098383,0.8111616180222089
1,56,7,64,0.017543859649122806,0.890625,0.1518093815101178,0.8006386588385352
31,170,6,207,0.15422885572139303,0.9710144927536232,0.15547472824582703,0.8111498867410676
1,1,65,67,0.5,0.029850746268656716,0.17470549747659625,0.675252553997776
6,8,1,15,0.42857142857142855,0.9333333333333333,0.23592998727251463,0.8062049349501569
21,46,2,69,0.31343283582089554,0.9710144927536232,0.2732310236190213,0.8091675420443999
2,58,3,63,0.03333333333333333,0.9523809523809523,0.25291694053898073,0.8102614469430428
44,67,32,143,0.3963963963963964,0.7762237762237763,0.26335810135608145,0.7892061133877091
170,412,5,587,0.2920962199312715,0.9914821124361158,0.3025798671106741,0.8036142723071543
1,51,1,53,0.019230769230769232,0.9811320754716981,0.28329442618344214,0.8050596412668792
22,65,8,95,0.25287356321839083,0.9157894736842105,0.24799064950035513,0.9316223166119583
2,0,0,2,1.0,1.0,0.3296233025615796,0.9411461261357678
2,14,1,17,0.125,0.9411764705882353,0.3027043260157374,0.9368835515407125
8,85,2,95,0.08602150537634409,0.9789473684210527,0.31023120773616747,0.9406787538321553
18,106,19,143,0.14516129032258066,0.8671328671328671,0.27434047829705094,0.9536657668191684
21,34,4,59,0.38181818181818183,0.9322033898305084,0.28715790142375247,0.9451973778755102
5,24,2,31,0.1724137931034483,0.9354838709677419,0.30904119054842083,0.9386762058035164
1,21,0,22,0.045454545454545456,1.0,0.2774499050652911,0.9497836830481632
35,65,10,110,0.35,0.9090909090909091,0.18459276220814824,0.9367966700611502
20,69,2,91,0.2247191011235955,0.978021978021978,0.19883834808294762,0.9420603139802564
34,67,3,104,0.33663366336633666,0.9711538461538461,0.23305924590088475,0.9406605232947512
167,200,14,381,0.4550408719346049,0.963254593175853,0.2811921938600465,0.9565041804215032
4,79,13,96,0.04819277108433735,0.8645833333333334,0.2323868028042981,0.9462292371108455
4,28,1,33,0.125,0.9696969696969697,0.22643442185191714,0.9508288042104126
0,12,2,14,0.0,0.8571428571428571,0.21994091535841065,0.9304206409451066
1,8,1,10,0.1111111111111111,0.9,0.18581393123142656,0.9291219396464052
28,189,14,231,0.12903225806451613,0.9393939393939394,0.1721443822229866,0.9236036484138282
47,92,15,154,0.3381294964028777,0.9025974025974026,0.1723580726567782,0.9138098707629078
3,21,0,24,0.125,1.0,0.12520937666612036,0.9190592145949287
2,60,60,122,0.03225806451612903,0.5081967213114754,0.12293299001351918,0.868146841448949
3,37,8,48,0.075,0.8333333333333334,0.11579013287066202,0.8486663219684295
12,154,24,190,0.07228915662650602,0.8736842105263158,0.12611715524587716,0.8510293724517808
18,118,2,138,0.1323529411764706,0.9855072463768116,0.12915170239807136,0.8632446933627539
12,125,4,141,0.08759124087591241,0.9716312056737588,0.12323155708541371,0.8678500171170139
5,96,2,103,0.04950495049504951,0.9805825242718447,0.08199947909858112,0.8789907487847913
48,168,6,222,0.2222222222222222,0.972972972972973,0.09588836798747,0.8751297449237875
6,72,1,79,0.07692307692307693,0.9873417721518988,0.10226908404560542,0.9435790379009907
3,48,1,52,0.058823529411764705,0.9807692307692307,0.09995815967585751,0.9646413089632617
2,27,8,37,0.06896551724137931,0.7837837837837838,0.09948335404941085,0.9517983908571858
24,133,4,161,0.15286624203821655,0.9751552795031055,0.10241382560108883,0.9503195384466564
21,97,14,132,0.17796610169491525,0.8939393939393939,0.11532452000380353,0.9392207081988898
28,78,19,125,0.2641509433962264,0.848,0.14598823327540025,0.9202803475886263
16,83,2,101,0.16161616161616163,0.9801980198019802,0.13733022461739158,0.9213124971356274
9,56,1,66,0.13846153846153847,0.9848484848484849,0.14612143340860037,0.9209563132351397
4,111,4,119,0.034782608695652174,0.9663865546218487,0.14268701616344143,0.9189016452140851
13,32,1,46,0.28888888888888886,0.9782608695652174,0.1741046406845142,0.9466840860400042
18,81,2,101,0.18181818181818182,0.9801980198019802,0.1782406320816521,0.947404477511272
7,20,1,28,0.25925925925925924,0.9642857142857143,0.18985394030512984,0.9574539518464606
9,61,8,78,0.12857142857142856,0.8974358974358975,0.17048543818730158,0.9645162229087318
17,35,1,53,0.3269230769230769,0.9811320754716981,0.19410071180257518,0.9646496594329772
0,1,59,60,0.0,0.016666666666666666,0.1743204920223554,0.8263379711212888
9,163,9,181,0.05232558139534884,0.9502762430939227,0.17682663097945492,0.8240364980458708
33,155,11,199,0.17553191489361702,0.9447236180904522,0.16063277755155897,0.8192454621209044
45,88,11,144,0.3383458646616541,0.9236111111111112,0.18299387510062642,0.8111616180222089
0,57,7,64,0.0,0.890625,0.14595683806358942,0.8006386588385354
30,171,6,207,0.14925373134328357,0.9710144927536232,0.14891145274528297,0.8111498867410676
1,1,65,67,0.5,0.029850746268656716,0.1736367274705577,0.675252553997776
5,9,1,15,0.35714285714285715,0.9333333333333333,0.224657135633823,0.8062049349501569
21,46,2,69,0.31343283582089554,0.9710144927536232,0.26195817198032967,0.8091675420443999
3,57,3,63,0.05,0.9523809523809523,0.24402504128124153,0.8102614469430428
42,69,32,143,0.3783783783783784,0.7762237762237763,0.24974397181220212,0.7892061133877092
176,406,5,587,0.3024054982817869,0.9914821124361158,0.2929447572810288,0.8036142723071542
1,51,1,53,0.019230769230769232,0.9811320754716981,0.2743700484078125,0.8050596412668793
22,65,8,95,0.25287356321839083,0.9157894736842105,0.23906627172472547,0.9316223166119585
2,0,0,2,1.0,1.0,0.33090300641860304,0.941146126135768
2,14,1,17,0.125,0.9411764705882353,0.30398402987276085,0.9368835515407126
6,87,2,95,0.06451612903225806,0.9789473684210527,0.3060577625916548,0.9406787538321554
19,105,19,143,0.1532258064516129,0.8671328671328671,0.2738931094592597,0.9536657668191683
22,33,4,59,0.4,0.9322033898305084,0.28783518113329015,0.9451973778755102
5,24,2,31,0.1724137931034483,0.9354838709677419,0.3097184702579586,0.9386762058035164
1,23,0,24,0.041666666666666664,1.0,0.28066695659669166,0.9507424558190165
35,71,11,117,0.330188679245283,0.905982905982906,0.18497962506030355,0.937311442388003
21,88,2,111,0.1926605504587156,0.9819819819819819,0.19464541798297724,0.9431408011585384
31,92,3,126,0.25203252032520324,0.9761904761904762,0.2140065131195874,0.9424605290496949
166,238,14,418,0.41089108910891087,0.9665071770334929,0.2548480972780032,0.9578100682423989
5,87,13,105,0.05434782608695652,0.8761904761904762,0.20692199979405754,0.9491932881970475
4,35,1,40,0.10256410256410256,0.975,0.19776449063654838,0.9545504310541905
0,12,2,14,0.0,0.8571428571428571,0.19181210968416745,0.9341422677888841
1,14,1,16,0.06666666666666667,0.9375,0.15416610788722226,0.9386447097913262
29,225,15,269,0.1141732283464567,0.9442379182156134,0.14295363329975672,0.9332527006818451
48,108,15,171,0.3076923076923077,0.9122807017543859,0.15090503149505732,0.9241227329052606
2,24,0,26,0.07692307692307693,1.0,0.10319531546850964,0.9289074219004759
3,46,77,126,0.061224489795918366,0.3888888888888889,0.10417769599836132,0.8592929094288208
5,39,8,52,0.11363636363636363,0.8461538461538461,0.1057594475801129,0.8408863160222272
13,168,25,206,0.0718232044198895,0.8786407766990292,0.11601990535438285,0.8439574473873946
16,148,2,166,0.0975609756097561,0.9879518072289156,0.12043337806053846,0.8511648484200969
14,132,4,150,0.0958904109589041,0.9733333333333334,0.11782154700517382,0.8553213362940568
6,110,2,118,0.05172413793103448,0.9830508474576272,0.0812546656107062,0.8654313571088057
48,168,6,222,0.2222222222222222,0.972972972972973,0.10201168636772696,0.8615703532478018
9,91,1,101,0.09,0.9900990099009901,0.10612247353973862,0.9474575133923876
2,57,1,60,0.03389830508474576,0.9833333333333333,0.09473132231807893,0.9670545829894573
2,29,8,39,0.06451612903225806,0.7948717948717948,0.09368745440556014,0.9550875855855666
26,134,4,164,0.1625,0.975609756097561,0.1029644578898807,0.9533244354239445
21,106,13,140,0.16535433070866143,0.9071428571428571,0.1128878749969889,0.9438686531110194
30,91,19,140,0.24793388429752067,0.8642857142857143,0.1409178387636298,0.9269022055150318
16,91,2,109,0.14953271028037382,0.981651376146789,0.13053362277193714,0.9281419773970055
10,56,1,67,0.15151515151515152,0.9850746268656716,0.13932150155981596,0.92742420839196
5,123,4,132,0.0390625,0.9696969696969697,0.14005924369056655,0.9254761564439081
15,34,1,50,0.30612244897959184,0.98,0.17457443225447136,0.9519230428907945
18,82,2,102,0.18,0.9803921568627451,0.17707443225447136,0.9526062430001065
7,22,1,30,0.2413793103448276,0.9666666666666667,0.18793514363106656,0.9611096443606507
10,78,8,96,0.11363636363636363,0.9166666666666666,0.16874978353661554,0.9685926375579298
17,37,1,55,0.3148148148148148,0.9818181818181818,0.1923615127558214,0.9686164669395572
0,4,59,63,0.0,0.06349206349206349,0.17071649111079976,0.8369618150290418
10,189,9,208,0.05025125628140704,0.9567307692307693,0.17231488486528648,0.8351095006767275
35,187,11,233,0.15765765765765766,0.9527896995708155,0.15110562896215302,0.8312223149011296
45,95,12,152,0.32142857142857145,0.9210526315789473,0.17130971059480607,0.8227452398605871
0,63,2,65,0.0,0.9692307692307692,0.1368269519741164,0.8231115402268875
31,192,6,229,0.13901345291479822,0.9737991266375546,0.1404522504424642,0.8312733202227286
1,1,65,67,0.5,0.029850746268656716,0.16690727689749066,0.6952779722870822
5,8,2,15,0.38461538461538464,0.8666666666666667,0.2218523318425456,0.8100172013120256
23,62,2,87,0.27058823529411763,0.9770114942528736,0.2533290431300757,0.8129144477437545
3,59,3,65,0.04838709677419355,0.9538461538461539,0.23771896300386655,0.8130653697830887
45,65,34,144,0.4090909090909091,0.7638888888888888,0.2502421540984862,0.7906134065416518
175,411,5,591,0.2986348122866894,0.9915397631133672,0.29290427013944187,0.7938004056677371
2,56,1,59,0.034482758620689655,0.9830508474576272,0.27797131381171203,0.7951220800706047
22,77,8,107,0.2222222222222222,0.9252336448598131,0.23828877412917238,0.9230339227264841
2,0,0,2,1.0,1.0,0.32620086204126025,0.9420815417741032
2,14,1,17,0.125,0.9411764705882353,0.3054025427135292,0.936962252679155
10,93,2,105,0.0970873786407767,0.9809523809523809,0.3123597258373268,0.9408345708371874
15,112,22,149,0.11811023622047244,0.8523489932885906,0.27079105828440725,0.9534717286085732
23,36,4,63,0.3898305084745763,0.9365079365079365,0.2838190148826768,0.9456100390935118
5,25,2,32,0.16666666666666666,0.9375,0.3027024303178164,0.9391027751709936
1,23,0,24,0.041666666666666664,1.0,0.27719551834878026,0.9517012285898698
35,71,11,117,0.330188679245283,0.905982905982906,0.18150818681239209,0.9382702151588563
20,89,2,111,0.1834862385321101,0.9819819819819819,0.18986336374555068,0.9440995739293916
31,92,3,126,0.25203252032520324,0.9761904761904762,0.21477230909020523,0.943419301820548
166,238,14,418,0.41089108910891087,0.9665071770334929,0.2535374812884882,0.9578100682423989
5,87,13,105,0.05434782608695652,0.8761904761904762,0.2056113838045425,0.9491932881970475
4,35,1,40,0.10256410256410256,0.975,0.19645387464703337,0.9545504310541902
0,12,2,14,0.0,0.8571428571428571,0.19050149369465239,0.9341422677888842
1,14,1,16,0.06666666666666667,0.9375,0.1528554918977072,0.9386447097913262
30,224,15,269,0.11811023622047244,0.9442379182156134,0.14351606299604466,0.9332527006818451
48,108,15,171,0.3076923076923077,0.9122807017543859,0.15146746119134533,0.9241227329052607
2,24,0,26,0.07692307692307693,1.0,0.10375774516479762,0.928907421900476
3,60,63,126,0.047619047619047616,0.5,0.1027964910979535,0.8751659253018366
5,39,8,52,0.11363636363636363,0.8461538461538461,0.10437824267970505,0.8567593318952431
13,168,25,206,0.0718232044198895,0.8786407766990292,0.11463870045397498,0.8598304632604107
19,145,2,166,0.11585365853658537,0.9879518072289156,0.12166541357824909,0.8670378642931128
15,131,4,150,0.10273972602739725,0.9733333333333334,0.11946962640780977,0.8711943521670727
5,111,2,118,0.04310344827586207,0.9830508474576272,0.0816712179197461,0.8813043729818215
48,168,6,222,0.2222222222222222,0.972972972972973,0.10242823867676687,0.8774433691208177
11,89,1,101,0.11,0.9900990099009901,0.11133980330261721,0.9474575133923876
3,56,1,60,0.05084745762711865,0.9833333333333333,0.10236995958701078,0.9670545829894573
4,27,8,39,0.12903225806451613,0.7948717948717948,0.11054268153624316,0.9550875855855666
26,134,4,164,0.1625,0.975609756097561,0.11720644460244525,0.9533244354239445
21,106,13,140,0.16535433070866143,0.9071428571428571,0.12615138812834012,0.9438686531110194
33,87,20,140,0.275,0.8571428571428571,0.15927946694607414,0.9258817973517665
16,91,2,109,0.14953271028037382,0.981651376146789,0.1488952509543815,0.9271215692337401
10,56,1,67,0.15151515151515152,0.9850746268656716,0.15482598688511742,0.9264038002286947
6,122,4,132,0.046875,0.9696969696969697,0.15425849293838617,0.9244557482806428
15,33,2,50,0.3125,0.96,0.18046817035774104,0.9480454918703864
19,81,2,102,0.19,0.9803921568627451,0.18439674178631243,0.9487286919796983
8,21,1,30,0.27586206896551724,0.9666666666666667,0.20018356153729186,0.9572320933402426
10,77,9,96,0.11494252873563218,0.90625,0.17731820849952504,0.9642473994626916
16,38,1,55,0.2962962962962963,0.9818181818181818,0.19828443507322824,0.9642712288443193
0,4,59,63,0.0,0.06349206349206349,0.1766394134282066,0.8326165769338036
10,189,9,208,0.05025125628140704,0.9567307692307693,0.1771217357541219,0.8307642625814894
34,188,11,233,0.15315315315315314,0.9527896995708155,0.1543579004902866,0.8297342196630345
45,95,12,152,0.32142857142857145,0.9210526315789473,0.17313341069436824,0.8212571446224919
1,62,2,65,0.015873015873015872,0.9692307692307692,0.13599211739543948,0.8216234449887923
31,192,6,229,0.13901345291479822,0.9737991266375546,0.13943082084960606,0.8312733202227287
0,2,65,67,0.0,0.029850746268656716,0.09710277852156375,0.6952779722870821
6,8,1,15,0.42857142857142855,0.9333333333333333,0.1583272683174821,0.8195410108358351
23,62,2,87,0.27058823529411763,0.9770114942528736,0.1898039796050122,0.8224382572675643
2,60,3,65,0.03225806451612903,0.9538461538461539,0.1725332526568659,0.8225891793068982
46,66,32,144,0.4107142857142857,0.7777777777777778,0.18528835469768223,0.8021213430495884
178,408,5,591,0.3037542662116041,0.9915397631133672,0.2264142476031948,0.8053083421756738
2,56,1,59,0.034482758620689655,0.9830508474576272,0.21148129127546503,0.8066300165785413
22,77,8,107,0.2222222222222222,0.9252336448598131,0.24322732302149674,0.9345418592344208
2,0,0,2,1.0,1.0,0.32485997608272127,0.9440656687582303
2,14,1,17,0.125,0.9411764705882353,0.3040616567549902,0.9389463796632819
12,91,2,105,0.11650485436893204,0.9809523809523809,0.3160969124482477,0.9428186978213143
16,112,21,149,0.125,0.8590604026845637,0.27528058591763543,0.9544305013794266
23,36,4,63,0.3898305084745763,0.9365079365079365,0.287577191955203,0.946568811864365
5,25,2,32,0.16666666666666666,0.9375,0.3064606073903425,0.9400615479418468
1,23,0,24,0.041666666666666664,1.0,0.28167147143218596,0.9481957156464375
36,70,11,117,0.33962264150943394,0.905982905982906,0.18733184879067655,0.934764702215424
21,88,2,111,0.1926605504587156,0.9819819819819819,0.19699764171335019,0.9405940609859592
31,92,3,126,0.25203252032520324,0.9761904761904762,0.2205196245059937,0.9399137888771156
174,231,13,418,0.42962962962962964,0.9688995215311005,0.26211506610143526,0.9536875460277715
6,86,13,105,0.06521739130434782,0.8761904761904762,0.21332045614249218,0.9450707659824199
4,35,1,40,0.10256410256410256,0.975,0.20334192892258568,0.9548921945538487
0,12,2,14,0.0,0.8571428571428571,0.19738954797020472,0.9344840312885424
1,14,1,16,0.06666666666666667,0.9375,0.15839583727838083,0.9389864732909844
28,226,15,269,0.11023622047244094,0.9442379182156134,0.1466209329946273,0.9335944641815032
49,107,15,171,0.3141025641025641,0.9122807017543859,0.15548808210567883,0.9244644964049188
3,23,0,26,0.11538461538461539,1.0,0.11059593721353397,0.9289074219004759
4,56,66,126,0.06666666666666667,0.47619047619047616,0.11080297655100808,0.8717645647576189
5,39,8,52,0.11363636363636363,0.8461538461538461,0.11238472813275967,0.8533579713510253
12,169,25,206,0.06629834254143646,0.8786407766990292,0.12185591992439344,0.8564291027161929
17,147,2,166,0.10365853658536585,0.9879518072289156,0.12714047276992188,0.863636503748895
15,131,4,150,0.10273972602739725,0.9733333333333334,0.12606954499205852,0.8677929916228552
6,110,2,118,0.05172413793103448,0.9830508474576272,0.08858691268184,0.8779030124376038
48,168,6,222,0.2222222222222222,0.972972972972973,0.10384942794435525,0.8740420085766
10,90,1,101,0.1,0.9900990099009901,0.10861133270626001,0.9474575133923876
2,57,1,60,0.03389830508474576,0.9833333333333333,0.09722018148460032,0.9670545829894573
3,28,8,39,0.0967741935483871,0.7948717948717948,0.10157387448559328,0.9550875855855666
26,134,4,164,0.1625,0.975609756097561,0.10997979783054102,0.9533244354239445
22,105,13,140,0.1732283464566929,0.9071428571428571,0.12004960074901182,0.9438686531110194
35,87,18,140,0.28688524590163933,0.8714285714285714,0.1536440447448125,0.9279226136782971
14,93,2,109,0.1308411214953271,0.981651376146789,0.14058960178382748,0.9291623855602709
9,57,1,67,0.13636363636363635,0.9850746268656716,0.14578440697863268,0.9284446165552254
6,122,4,132,0.046875,0.9696969696969697,0.14763822053795472,0.9264965646071734
15,34,1,50,0.30612244897959184,0.98,0.17754511417098398,0.9529434510540599
19,81,1,101,0.19,0.9900990099009901,0.18147368559955537,0.9550133444545497
7,22,1,30,0.2413793103448276,0.9666666666666667,0.19120953758357465,0.9635167458150938
10,79,7,96,0.11235955056179775,0.9270833333333334,0.1662772953921687,0.9714674260872028
17,37,1,55,0.3148148148148148,0.9818181818181818,0.19255925158066692,0.9714912554688303
0,4,59,63,0.0,0.06349206349206349,0.17307873210014746,0.8398366035583148
9,190,9,208,0.04522613065326633,0.9567307692307693,0.17284317933632834,0.8379842892060004
34,188,11,233,0.15315315315315314,0.9527896995708155,0.15099042278969427,0.8340971034304028
47,94,11,152,0.3333333333333333,0.9276315789473685,0.17146661326588472,0.8251731847227426
1,57,7,65,0.017241379310344827,0.8923076923076924,0.13944690883238722,0.8145504741000319
32,191,6,229,0.14349775784753363,0.9737991266375546,0.1438952241589209,0.8212241588577778
1,0,66,67,1.0,0.014925373134328358,0.2417788220425188,0.6830966147600844
6,8,1,15,0.42857142857142855,0.9333333333333333,0.30300331183843715,0.8073596533088373
23,62,2,87,0.27058823529411763,0.9770114942528736,0.3351978982157017,0.8102568997405665
2,60,3,65,0.03225806451612903,0.9538461538461539,0.3179271712675554,0.8104078217799006
46,65,33,144,0.4144144144144144,0.7708333333333334,0.32951018285056694,0.788008072406467
180,406,5,591,0.30716723549488056,0.9915397631133672,0.37092816230550063,0.8021840825215634
2,56,1,59,0.034482758620689655,0.9830508474576272,0.35535459098738004,0.8035057569244308
22,77,8,107,0.2222222222222222,0.9252336448598131,0.24424347987626893,0.9335497957423573
2,0,0,2,1.0,1.0,0.32587613293749346,0.9430736052661668
2,14,1,17,0.125,0.9411764705882353,0.3050778136097624,0.9379543161712185
8,95,2,105,0.07766990291262135,0.9809523809523809,0.31156521909497553,0.941826634329251
18,111,20,149,0.13953488372093023,0.8657718120805369,0.27229671471019207,0.9553892741502799
23,36,4,63,0.3898305084745763,0.9365079365079365,0.28410575370729146,0.9475275846352185
5,25,2,32,0.16666666666666666,0.9375,0.302989169142431,0.9410203207127003
1,23,0,24,0.041666666666666664,1.0,0.2817528115103131,0.9517012285898697
39,71,7,117,0.35454545454545455,0.9401709401709402,0.18954501930252093,0.9431542200428612
20,89,2,111,0.1834862385321101,0.9819819819819819,0.20682876766425093,0.9489835788133965
31,92,3,126,0.25203252032520324,0.9761904761904762,0.2289637879048833,0.9483033067045531
171,234,13,418,0.4222222222222222,0.9688995215311005,0.268240273692997,0.9630358366260621
6,86,13,105,0.06521739130434782,0.8761904761904762,0.2170243562280007,0.9544190565807105
4,35,1,40,0.10256410256410256,0.975,0.2031049423085868,0.9597761994378535
0,12,2,14,0.0,0.8571428571428571,0.19715256135620582,0.9393680361725473
0,15,1,16,0.0,0.9375,0.14650321070685518,0.9389864732909844
27,227,15,269,0.1062992125984252,0.9442379182156134,0.13547649271632875,0.9335944641815033
49,107,15,171,0.3141025641025641,0.9122807017543859,0.1443436418273803,0.9244644964049188
3,23,0,26,0.11538461538461539,1.0,0.10050969799343647,0.9289074219004759
4,61,61,126,0.06153846153846154,0.5158730158730159,0.09998413659830986,0.8774334989979816
5,39,8,52,0.11363636363636363,0.8461538461538461,0.10156588818006144,0.8590269055913883
13,168,25,206,0.0718232044198895,0.8786407766990292,0.11182634595433137,0.8620980369565557
17,147,2,166,0.10365853658536585,0.9879518072289156,0.12663470832366935,0.869305437989258
17,130,3,150,0.11564625850340136,0.98,0.1279700005958088,0.8744143068155988
7,109,2,118,0.0603448275862069,0.9830508474576272,0.09171889537918634,0.8845243276303476
48,168,6,222,0.2222222222222222,0.972972972972973,0.10698141064170161,0.8806633237693438
12,88,1,101,0.12,0.9900990099009901,0.11533305899334996,0.9484098943447686
3,56,1,60,0.05084745762711865,0.9833333333333333,0.10636321527774352,0.9680069639418382
3,28,8,39,0.0967741935483871,0.7948717948717948,0.10992764229610033,0.9560399665379474
26,133,4,163,0.16352201257861634,0.9754601226993865,0.11847956743799326,0.9542554401765863
20,107,13,140,0.15748031496062992,0.9071428571428571,0.12445586121759734,0.9438472769112802
33,88,19,140,0.2727272727272727,0.8642857142857143,0.15479621052346387,0.9268808293152926
17,90,2,109,0.1588785046728972,0.981651376146789,0.14574710801641744,0.9281206011972664
9,57,1,67,0.13636363636363635,0.9850746268656716,0.14808477035407977,0.9274028321922209
6,122,4,132,0.046875,0.9696969696969697,0.14751727640734855,0.9254547802441689
16,33,1,50,0.32653061224489793,0.98,0.18033962193542155,0.9519016666910554
19,81,1,101,0.19,0.9900990099009901,0.18412219156704776,0.9539929362912846
7,22,1,30,0.2413793103448276,0.9666666666666667,0.19610776233621888,0.9624963376518286
9,78,9,96,0.10344827586206896,0.90625,0.17192504849833262,0.9684912356110124
18,36,1,55,0.3333333333333333,0.9818181818181818,0.1968471668783949,0.9685150649926398
0,4,59,63,0.0,0.06349206349206349,0.17736664739787544,0.8368604130821244
9,190,9,208,0.04522613065326633,0.9567307692307693,0.17713109463405635,0.8350080987298101
38,184,11,233,0.17117117117117117,0.9527896995708155,0.1549368887663811,0.8311209129542122
48,93,11,152,0.3404255319148936,0.9276315789473685,0.17642625046850877,0.8221969942465519
1,57,7,65,0.017241379310344827,0.8923076923076924,0.1444065460350112,0.8115742836238414
31,192,6,229,0.13901345291479822,0.9737991266375546,0.14948728561397254,0.8212241588577778
1,0,66,67,1.0,0.014925373134328358,0.24472538085206777,0.6830966147600844
6,8,1,15,0.42857142857142855,0.9333333333333333,0.3059498706479861,0.8073596533088373
22,63,2,87,0.25882352941176473,0.9770114942528736,0.33646378475634303,0.8102568997405665
3,59,3,65,0.04838709677419355,0.9538461538461539,0.318923202699632,0.8104078217799006
45,67,32,144,0.4017857142857143,0.7777777777777778,0.32768894303832063,0.7890001358985305
183,403,6,592,0.3122866894197952,0.9898648648648649,0.36983827305395645,0.8029368748352693
1,57,1,59,0.017241379310344827,0.9830508474576272,0.3524422625390345,0.8042585492381369
24,75,8,107,0.24242424242424243,0.9252336448598131,0.24421715431392627,0.9343025880560633
2,0,0,2,1.0,1.0,0.32584980737515074,0.9438263975798727
2,14,1,17,0.125,0.9411764705882353,0.3067321603163272,0.9387071084849244
9,94,2,105,0.08737864077669903,0.9809523809523809,0.31230238088811374,0.9425794266429569
18,112,19,149,0.13846153846153847,0.87248322147651,0.27468464148466004,0.9561087757427759
24,35,4,63,0.4067796610169492,0.9365079365079365,0.2881836374271106,0.9484863574060718
5,24,3,32,0.1724137931034483,0.90625,0.3103511251118397,0.9375148077692678
1,23,0,24,0.041666666666666664,1.0,0.2826268458519062,0.9505726118437327
39,71,7,117,0.35454545454545455,0.9401709401709402,0.19041905364411407,0.942025603296724
20,88,2,110,0.18518518518518517,0.9818181818181818,0.20794550867056907,0.9478315620438593
33,90,3,126,0.2682926829268293,0.9761904761904762,0.2370564449412221,0.9474377202966341
174,234,10,418,0.4264705882352941,0.9760765550239234,0.27939777171583435,0.9631347734288244
5,87,13,105,0.05434782608695652,0.8761904761904762,0.21962927933864634,0.9551329286231055
4,35,1,40,0.10256410256410256,0.975,0.20472464374435556,0.9607780899134281
0,13,1,14,0.0,0.9285714285714286,0.19877226279197463,0.950574008280775
1,14,1,16,0.06666666666666667,0.9375,0.15764672166643348,0.9501924453992121
29,225,15,269,0.1141732283464567,0.9442379182156134,0.147502156403758,0.944823836313131
48,108,15,171,0.3076923076923077,0.9122807017543859,0.15313067422739776,0.9356938685365466
3,23,0,26,0.11538461538461539,1.0,0.10868982096301512,0.9391115035331291
3,75,48,126,0.038461538461538464,0.6190476190476191,0.1064203513022411,0.9023768096555781
5,46,1,52,0.09803921568627451,0.9807692307692307,0.10577393889112281,0.9032009854797539
11,169,25,205,0.06111111111111111,0.8780487804878049,0.11450409762128154,0.8959834643249505
20,144,2,166,0.12195121951219512,0.9879518072289156,0.12240189088492846,0.9031908653576527
17,130,3,150,0.11564625850340136,0.98,0.12261232376449198,0.9082997341839935
7,109,2,118,0.0603448275862069,0.9830508474576272,0.08727696946362043,0.9184097549987423
48,168,6,222,0.2222222222222222,0.972972972972973,0.1025394847261357,0.9145487511377386
12,88,1,101,0.12,0.9900990099009901,0.11418783637448734,0.9675560926882201
2,57,1,60,0.03389830508474576,0.9833333333333333,0.10502484914569753,0.9679223930545204
3,28,8,39,0.0967741935483871,0.7948717948717948,0.11011957520816552,0.9560399665379476
26,133,4,163,0.16352201257861634,0.9754601226993865,0.11605825993193998,0.9542554401765864
20,107,13,140,0.15748031496062992,0.9071428571428571,0.12203455371154405,0.9438472769112802
31,90,19,140,0.256198347107438,0.8642857142857143,0.1500136279288628,0.9268808293152927
18,89,2,109,0.16822429906542055,0.981651376146789,0.14229963890646255,0.9281206011972662
10,56,1,67,0.15151515151515152,0.9850746268656716,0.14680180340862709,0.9274028321922207
7,121,4,132,0.0546875,0.9696969696969697,0.14977168839652052,0.9254547802441688
16,33,1,50,0.32653061224489793,0.98,0.1825940339245935,0.9519016666910554
20,80,1,101,0.2,0.9900990099009901,0.18780517498479116,0.9539929362912843
7,22,1,30,0.2413793103448276,0.9666666666666667,0.19979074575396227,0.9624963376518287
10,83,3,96,0.10752688172043011,0.96875,0.1785519649843897,0.9774198070395838
17,37,1,55,0.3148148148148148,0.9818181818181818,0.19949346723430317,0.9774436364212112
0,4,59,63,0.0,0.06349206349206349,0.17784844558928153,0.8457889845106958
10,189,9,208,0.05025125628140704,0.9567307692307693,0.1772146964866254,0.8439366701583815
26,197,10,233,0.11659192825112108,0.9570815450643777,0.14722345591608585,0.8406626051675783
47,94,11,152,0.3333333333333333,0.9276315789473685,0.16627107496370488,0.831738686459918
1,57,7,65,0.017241379310344827,0.8923076923076924,0.13425137053020733,0.8211159758372074
32,191,6,229,0.14349775784753363,0.9737991266375546,0.13939006711979357,0.8218372796425724
7,56,4,67,0.1111111111111111,0.9402985074626866,0.11028953801926446,0.8159058975917873
6,8,1,15,0.42857142857142855,0.9333333333333333,0.17151402781518282,0.9401689361405402
21,64,2,87,0.24705882352941178,0.9770114942528736,0.19962939456489778,0.9430661825722694
3,59,3,65,0.04838709677419355,0.9538461538461539,0.189885847211051,0.9426039838268088
46,68,30,144,0.40350877192982454,0.7916666666666666,0.19991090986769258,0.9231804249295658
184,402,6,592,0.31399317406143346,0.9898648648648649,0.2423040234035624,0.9371171638663046
2,56,1,59,0.034482758620689655,0.9830508474576272,0.22673045208544185,0.9384388382691722
22,82,3,107,0.21153846153846154,0.9719626168224299,0.24107721643220617,0.9429622824634213
2,0,0,2,1.0,1.0,0.32270986949343067,0.9524860919872308
1,15,1,17,0.0625,0.9411764705882353,0.29634432327494326,0.9473668028922825
10,93,2,105,0.0970873786407767,0.9809523809523809,0.30330150639874087,0.9512391210503149
19,110,20,149,0.14728682170542637,0.8657718120805369,0.26669837065239826,0.9618255703951535
25,34,4,63,0.423728813559322,0.9365079365079365,0.28237489058066806,0.9542031520584493
6,24,2,32,0.2,0.9375,0.3060202107777124,0.9476958881359313
1,21,0,22,0.045454545454545456,1.0,0.293995986533004,0.9436391545695212
41,59,9,109,0.41,0.9174311926605505,0.20971027224728972,0.9318436106638855
22,66,2,90,0.25,0.9777777777777777,0.23649598653300402,0.9370723688338202
33,68,3,104,0.32673267326732675,0.9711538461538461,0.26781109961113214,0.9359590085099335
179,187,11,377,0.4890710382513661,0.9708222811671088,0.31660110741753333,0.9527697839413987
4,79,13,96,0.04819277108433735,0.8645833333333334,0.2559533214685426,0.9431097758703737
4,28,1,33,0.125,0.9696969696969697,0.24206443257965368,0.9530664858270835
0,12,2,14,0.0,0.8571428571428571,0.2355709260861472,0.9326583225617775
1,8,1,10,0.1111111111111111,0.9,0.1928725133877345,0.9301681521816988
27,190,15,232,0.12442396313364056,0.9353448275862069,0.17493307954968315,0.9241063021543316
49,92,15,156,0.3475177304964539,0.9038461538461539,0.17790237343955845,0.9144909175389468
3,21,0,24,0.125,1.0,0.12589222511793471,0.918659163086503
3,56,63,122,0.05084745762711865,0.48360655737704916,0.12627146605261777,0.8642339093784622
3,37,8,48,0.075,0.8333333333333334,0.11912860890976064,0.8447533898979429
11,155,23,189,0.06626506024096386,0.8783068783068783,0.12859504608704117,0.847776821492803
21,115,2,138,0.15441176470588236,0.9855072463768116,0.13478085374343707,0.8599921424037761
16,122,3,141,0.11594202898550725,0.9787234042553191,0.13356914886513233,0.866189081927935
6,95,2,103,0.0594059405940594,0.9805825242718447,0.09241032173621881,0.8771514205601765
46,169,7,222,0.21395348837209302,0.9684684684684685,0.1051179629322321,0.872646916055672
10,68,1,79,0.1282051282051282,0.9873417721518988,0.11616905872909063,0.9446090895949363
4,48,1,53,0.07692307692307693,0.9811320754716981,0.11644378400381587,0.9657231956147025
3,26,8,37,0.10344827586206896,0.7837837837837838,0.12175567194968806,0.9522198963971177
25,131,4,160,0.16025641025641027,0.975,0.12259062131404919,0.9507188612004303
20,97,14,131,0.17094017094017094,0.8931297709923665,0.13044749873614397,0.9384911993057228
27,79,19,125,0.25471698113207547,0.848,0.15834907595586056,0.9195508386954593
17,82,2,101,0.1717171717171717,0.9801980198019802,0.15231531643372895,0.9212264888859609
10,55,1,66,0.15384615384615385,0.9848484848484849,0.15597832009673263,0.9208703049854732
7,108,4,119,0.06086956521739131,0.9663865546218487,0.1536849612816347,0.9187638020069233
15,31,1,47,0.32608695652173914,0.9787234042553191,0.18549048709015897,0.9466123192171426
20,79,1,100,0.20202020202020202,0.99,0.19145674305641497,0.9487551763599998
7,20,1,28,0.25925925925925924,0.9642857142857143,0.20407375567342756,0.9589203111161922
8,62,8,78,0.11428571428571428,0.8974358974358975,0.1840121461239474,0.9659825821784633
17,35,1,53,0.3269230769230769,0.9811320754716981,0.20618441829621956,0.9661160187027088
0,1,59,60,0.0,0.016666666666666666,0.1842063963181976,0.8278043303910205
9,163,9,181,0.05232558139534884,0.9502762430939227,0.18298582720076295,0.8255028573156026
34,154,11,199,0.18085106382978725,0.9447236180904522,0.1622378425304841,0.8206457450063357
47,84,12,143,0.35877862595419846,0.916083916083916,0.18463190309248362,0.8100863044468952
2,55,7,64,0.03508771929824561,0.890625,0.15260739738376738,0.7995633452632218
27,173,6,206,0.135,0.970873786407767,0.15556658105723672,0.8100544722592031
0,1,66,67,0.0,0.014925373134328358,0.10886328435394006,0.6720249433538646
6,8,1,15,0.42857142857142855,0.9333333333333333,0.1700877741498584,0.8029773243062456
21,47,2,70,0.3088235294117647,0.9714285714285714,0.2067303381522035,0.8059990854969097
2,58,3,63,0.03333333333333333,0.9523809523809523,0.18565637665271015,0.8070929903955524
49,61,32,142,0.44545454545454544,0.7746478873239436,0.1980386508670454,0.7868878434298422
187,335,67,589,0.35823754789272033,0.8862478777589134,0.2442029120948275,0.786262540252544
1,51,1,53,0.019230769230769232,0.9811320754716981,0.227664450556366,0.78772801011882
24,64,8,96,0.2727272727272727,0.9166666666666666,0.26662548951740495,0.9165481949091541
2,0,0,2,1.0,1.0,0.3482581425786294,0.9260720044329636
1,15,1,17,0.0625,0.9411764705882353,0.3130690669483773,0.9217502757414869
6,87,2,95,0.06451612903225806,0.9789473684210527,0.3175237520482237,0.92554547803293
16,107,19,142,0.13008130081300814,0.8661971830985915,0.272470431385147,0.9386239488578795
26,29,4,59,0.4727272727272727,0.9322033898305084,0.28882610636151157,0.9451890220109646
6,23,2,31,0.20689655172413793,0.9354838709677419,0.31563550386056427,0.9386678499389708
1,21,0,22,0.045454545454545456,1.0,0.29596525018113745,0.9537018935451788
41,59,9,109,0.41,0.9174311926605505,0.21167953589542315,0.9419063496395431
21,67,2,90,0.23863636363636365,0.9777777777777777,0.23684187355776085,0.9471351078094777
31,70,3,104,0.3069306930693069,0.9711538461538461,0.26404556480067154,0.9457353171239726
179,186,12,377,0.4904109589041096,0.9681697612732095,0.3077618213411776,0.948858322329829
4,80,13,97,0.047619047619047616,0.865979381443299,0.251610547272228,0.9387828144634522
4,28,1,33,0.125,0.9696969696969697,0.23772165838333906,0.9528869898579503
0,12,2,14,0.0,0.8571428571428571,0.23122815188983256,0.932478826592644
1,8,1,10,0.1111111111111111,0.9,0.18852973919141988,0.9299886562125655
26,190,15,231,0.12037037037037036,0.935064935064935,0.17163459729627797,0.9238868215393021
47,92,15,154,0.3381294964028777,0.9025974025974026,0.1760915692010738,0.9140930438883818
3,21,0,24,0.125,1.0,0.12389000364334386,0.9186402208493519
3,57,62,122,0.05,0.4918032786885246,0.12423013969776564,0.865186491884384
3,37,8,48,0.075,0.8333333333333334,0.1170872825549085,0.8457059724038646
15,152,23,190,0.08982035928143713,0.8789473684210526,0.12991876245225667,0.8488209025864639
20,116,2,138,0.14705882352941177,0.9855072463768116,0.13505414994058532,0.861036223497437
13,125,3,141,0.09420289855072464,0.9787234042553191,0.13131593968063593,0.8672731476674919
7,95,2,104,0.06862745098039216,0.9807692307692307,0.0928156474774237,0.8784405516920388
46,169,7,222,0.21395348837209302,0.9684684684684685,0.105523288673437,0.8739360471875343
10,68,1,79,0.1282051282051282,0.9873417721518988,0.11669544984559817,0.9447272605394448
3,49,1,53,0.057692307692307696,0.9811320754716981,0.1142229223730707,0.9658413665592113
1,28,8,37,0.034482758620689655,0.7837837837837838,0.10631755085010676,0.9522465687538871
25,131,4,160,0.16025641025641027,0.975,0.10820292038253512,0.9507455335571998
20,96,15,131,0.1724137931034483,0.8854961832061069,0.1193759053186385,0.937427359121598
29,78,19,126,0.27102803738317754,0.8492063492063492,0.1482902748047507,0.9186326617554721
16,83,2,101,0.16161616161616163,0.9801980198019802,0.14081351383961765,0.9203083119459737
10,55,1,66,0.15384615384615385,0.9848484848484849,0.1444765175026213,0.9199521280454859
6,110,4,120,0.05172413793103448,0.9666666666666667,0.1436239218224394,0.9178856410733386
15,31,1,47,0.32608695652173914,0.9787234042553191,0.1852816643797322,0.945734158283558
20,79,1,100,0.20202020202020202,0.99,0.19124792034598817,0.9478770154264151
8,19,1,28,0.2962962962962963,0.9642857142857143,0.20894542080210932,0.9591326627235018
8,62,8,78,0.11428571428571428,0.8974358974358975,0.18655366035961457,0.9660225981848659
18,33,1,52,0.35294117647058826,0.9807692307692307,0.21388580533881837,0.966104199751616
0,1,59,60,0.0,0.016666666666666666,0.19190778336079642,0.8277925114399277
9,159,13,181,0.05357142857142857,0.9281767955801105,0.19217168202370982,0.8222939584275626
36,153,11,200,0.19047619047619047,0.945,0.17279871544577427,0.8174763292482312
48,84,11,143,0.36363636363636365,0.9230769230769231,0.1958867385337974,0.8079158896877916
1,56,7,64,0.017543859649122806,0.890625,0.15606496186991548,0.7973929305041183
37,163,6,206,0.185,0.970873786407767,0.16616700268624202,0.8078840575000996
0,1,66,67,0.0,0.014925373134328358,0.11574683461901511,0.6699063635522563
6,8,1,15,0.42857142857142855,0.9333333333333333,0.1769713244149335,0.8008587445046373
21,47,2,70,0.3088235294117647,0.9714285714285714,0.2134359102492672,0.807037569625846
3,57,3,63,0.05,0.9523809523809523,0.19336788303838287,0.8080919913945536
47,62,33,142,0.43119266055045874,0.7676056338028169,0.2030187825975393,0.7858818072125384
188,334,67,589,0.36015325670498083,0.8862478777589134,0.25196298217694757,0.7852565040352404
0,52,1,53,0.0,0.9811320754716981,0.22553441074837613,0.7867219739015161
23,64,8,95,0.26436781609195403,0.9157894736842105,0.26330124161865526,0.9154168454086422
2,0,0,2,1.0,1.0,0.3449338946798798,0.9249406549324517
1,15,1,17,0.0625,0.9411764705882353,0.30974481904962764,0.9206189262409751
10,83,2,95,0.10752688172043011,0.9789473684210527,0.31796294500968914,0.924414128532418
18,104,21,143,0.14754098360655737,0.8531468531468531,0.2774412768748461,0.9366343027244232
26,29,4,59,0.4727272727272727,0.9322033898305084,0.29352327916374493,0.9431993758775082
6,21,3,30,0.2222222222222222,0.9,0.3252693109097767,0.9316090793815512
1,23,0,24,0.041666666666666664,1.0,0.2876158241991344,0.9592689612469074
42,67,8,117,0.3853211009174312,0.9316239316239316,0.19980455290162455,0.9495009514788977
26,82,2,110,0.24074074074074073,0.9818181818181818,0.22526751586458751,0.9553069102260331
38,85,3,126,0.3089430894308943,0.9761904761904762,0.2541456548540218,0.9546266381171894
181,224,12,417,0.4469135802469136,0.9712230215827338,0.2918335103822529,0.9572270505964102
6,86,13,105,0.06521739130434782,0.8761904761904762,0.23819628541120327,0.9486102705510587
4,35,1,40,0.10256410256410256,0.975,0.22733809598158533,0.958863726772257
0,12,2,14,0.0,0.8571428571428571,0.22138571502920437,0.9384555635069509
2,13,1,16,0.13333333333333333,0.9375,0.18538746251719035,0.9392950018463893
26,229,14,269,0.10196078431372549,0.9479553903345725,0.16556175445618818,0.9344574602058735
48,108,15,171,0.3076923076923077,0.9122807017543859,0.16538307135067581,0.9253274924292892
2,24,0,26,0.07692307692307693,1.0,0.11252728516155631,0.9294384893460416
4,60,62,126,0.0625,0.5079365079365079,0.11213908640379233,0.8768307795954746
5,39,8,52,0.11363636363636363,0.8461538461538461,0.1137208379855439,0.8584241861888813
19,170,17,206,0.10052910052910052,0.9174757281553398,0.1280821380611297,0.8670431677620931
24,140,2,166,0.14634146341463414,0.9879518072289156,0.1299404423584584,0.8742505687947953
15,130,4,149,0.10344827586206896,0.9731543624161074,0.13015294115107887,0.8778504219493003
5,111,2,118,0.04310344827586207,0.9830508474576272,0.0923545326630152,0.8879604427640491
46,169,7,222,0.21395348837209302,0.9684684684684685,0.11193030572716037,0.8834559382595445
15,86,1,102,0.1485148514851485,0.9901960784313726,0.12421814165361016,0.9523501626159537
4,55,1,60,0.06779661016949153,0.9833333333333333,0.117669605444057,0.9719472322130234
2,29,8,39,0.06451612903225806,0.7948717948717948,0.11252489523022235,0.9544323846010884
25,135,4,164,0.15625,0.975609756097561,0.11394040045670319,0.9526692344394663
21,106,13,140,0.16535433070866143,0.9071428571428571,0.12278412257764497,0.9432390194004304
27,94,19,140,0.2231404958677686,0.8642857142857143,0.1485037008050602,0.926272571804443
16,90,2,108,0.1509433962264151,0.9814814814814815,0.13950225906996336,0.9281315736634449
9,57,1,67,0.13636363636363635,0.9850746268656716,0.13776637119546162,0.9273999377254876
6,122,4,132,0.046875,0.9696969696969697,0.13477756974267713,0.9254518857774355
15,34,1,50,0.30612244897959184,0.98,0.16929275830658194,0.951898772224322
19,81,1,101,0.19,0.9900990099009901,0.1741141868780105,0.9539686656248119
7,22,1,30,0.2413793103448276,0.9666666666666667,0.1849748982546057,0.9624720669853561
11,82,3,96,0.11827956989247312,0.96875,0.1699947659724206,0.9773955363731112
16,37,1,54,0.3018867924528302,0.9814814814814815,0.1915581082904799,0.9773955363731112
0,4,59,63,0.0,0.06349206349206349,0.17207758880996044,0.8457408844625958
8,191,9,208,0.04020100502512563,0.9567307692307693,0.17112416095640695,0.8438885701102814
36,186,11,233,0.16216216216216217,0.9527896995708155,0.15055840569677414,0.8400013843346837
42,96,13,151,0.30434782608695654,0.9139072847682119,0.16689380942348223,0.8291168521728582
2,61,2,65,0.031746031746031744,0.9692307692307692,0.1369461981950828,0.8294831525391586
32,191,6,229,0.14349775784753363,0.9737991266375546,0.14054879647437718,0.8302044563445236
0,1,66,67,0.0,0.014925373134328358,0.09742211183825857,0.6921250122949302
6,8,1,15,0.42857142857142855,0.9333333333333333,0.15864660163417693,0.816388050843683
22,63,2,87,0.25882352941176473,0.9770114942528736,0.18987839083226823,0.8192852972754122
2,60,3,65,0.03225806451612903,0.9538461538461539,0.17132066259712062,0.8194362193147463
48,62,33,143,0.43636363636363634,0.7692307692307693,0.19018006406521776,0.7987681456665402
197,327,68,592,0.37595419847328243,0.8851351351351351,0.23935265931196786,0.7867544836528781
1,57,1,59,0.017241379310344827,0.9830508474576272,0.22131603380665515,0.7880761580557456
26,72,8,106,0.2653061224489796,0.9245283018867925,0.25921690844222367,0.918019433591812
2,0,0,2,1.0,1.0,0.3408495615034482,0.9275432431156216
1,15,1,17,0.0625,0.9411764705882353,0.3128033430160532,0.9224239540206732
12,91,2,105,0.11650485436893204,0.9809523809523809,0.3248385987093108,0.9262962721787057
26,115,8,149,0.18439716312056736,0.9463087248322147,0.28884338824601524,0.9515931229789122
26,33,4,63,0.4406779661016949,0.9365079365079365,0.29808964076435984,0.9589320946035981
6,21,4,31,0.2222222222222222,0.8709677419354839,0.32737261832319947,0.9429202223861491
1,23,0,24,0.041666666666666664,1.0,0.2876020873709723,0.9638772561777831
42,67,8,117,0.3853211009174312,0.9316239316239316,0.1997908160734625,0.9541092464097733
20,88,2,110,0.18518518518518517,0.9818181818181818,0.21731727109991753,0.9599152051569085
39,84,3,126,0.3170731707317073,0.9761904761904762,0.24458292517116004,0.9592349330480651
180,224,13,417,0.44554455445544555,0.9688249400479616,0.27905709693441283,0.9614927624508899
7,85,13,105,0.07608695652173914,0.8761904761904762,0.22697266699441915,0.9528759824055383
4,35,1,40,0.10256410256410256,0.975,0.22192024814889685,0.9585211436958608
0,12,2,14,0.0,0.8571428571428571,0.2159678671965159,0.9381129804305548
2,13,1,16,0.13333333333333333,0.9375,0.17996961468450187,0.9389524187699931
27,228,14,269,0.10588235294117647,0.9479553903345725,0.16864063864964352,0.9341148771294775
49,107,15,171,0.3141025641025641,0.9122807017543859,0.16821626627405162,0.9249849093528931
3,23,0,26,0.11538461538461539,1.0,0.12105056069250446,0.9294384893460415
5,46,75,126,0.09803921568627451,0.40476190476190477,0.12418659771600951,0.8620915505705314
5,39,8,52,0.11363636363636363,0.8461538461538461,0.1257683492977611,0.843684957163938
15,176,15,206,0.07853403141361257,0.9271844660194175,0.13698749664256288,0.8536909012891608
25,139,2,166,0.1524390243902439,0.9879518072289156,0.13971688107926442,0.860898302321863
15,130,4,149,0.10344827586206896,0.9731543624161074,0.13936915578224904,0.8644981554763681
4,112,2,118,0.034482758620689655,0.9830508474576272,0.0994234692848384,0.8746081762911169
46,169,7,222,0.21395348837209302,0.9684684684684685,0.11350473685447805,0.8701036717866123
16,85,1,102,0.15841584158415842,0.9901960784313726,0.12212996912560434,0.9537371251679648
3,56,1,60,0.05084745762711865,0.9833333333333333,0.1131601254099979,0.9733341947650345
2,29,8,39,0.06451612903225806,0.7948717948717948,0.11115756792694728,0.9544323846010884
25,135,4,164,0.15625,0.975609756097561,0.11170199301405528,0.9526692344394663
20,107,13,140,0.15748031496062992,0.9071428571428571,0.11942085574242113,0.9432390194004305
28,91,21,140,0.23529411764705882,0.85,0.14810819274618817,0.9242317554779123
15,91,2,108,0.14150943396226415,0.9814814814814815,0.1377590421162126,0.9260907573369143
9,57,1,67,0.13636363636363635,0.9850746268656716,0.13460872708470945,0.9253591213989569
6,122,4,132,0.046875,0.9696969696969697,0.1340412331379782,0.923411069450905
16,33,1,50,0.32653061224489793,0.98,0.17147187359692678,0.9498579558977915
20,80,1,101,0.2,0.9900990099009901,0.1777218735969268,0.9519278492982813
7,22,1,30,0.2413793103448276,0.9666666666666667,0.1897074443660979,0.9604312506588256
11,79,6,96,0.12222222222222222,0.9375,0.17355431644826408,0.9729312506588256
17,36,1,54,0.32075471698113206,0.9814814814814815,0.19916078545095947,0.9729312506588255
0,4,59,63,0.0,0.06349206349206349,0.17968026597044,0.8412765987483101
9,186,13,208,0.046153846153846156,0.9375,0.17957724399241806,0.836677031648743
38,184,11,233,0.17117117117117117,0.9527896995708155,0.15738303812474277,0.8327898458731451
44,95,13,152,0.31654676258992803,0.9144736842105263,0.17403257563758961,0.8219862279173646
2,61,2,65,0.031746031746031744,0.9692307692307692,0.14408496440919022,0.8223525282836651
35,188,6,229,0.15695067264573992,0.9737991266375546,0.1490461716125499,0.8275381178033158
0,1,66,67,0.0,0.014925373134328358,0.1032240691866739,0.6894586737537224
6,7,2,15,0.46153846153846156,0.8666666666666667,0.16915813512073985,0.8041979027786658
22,63,2,87,0.25882352941176473,0.9770114942528736,0.19953951844329962,0.8098424019576477
2,60,3,65,0.03225806451612903,0.9538461538461539,0.17969478892115073,0.8099933239969818
49,61,34,144,0.44545454545454544,0.7638888888888888,0.19811018647323894,0.788481210379605
200,323,69,592,0.3824091778202677,0.8834459459459459,0.2482049216267012,0.7762262356246301
0,58,1,59,0.0,0.9830508474576272,0.22578339696302407,0.7775479100274977
27,71,8,106,0.2755102040816326,0.9245283018867925,0.26514199754611445,0.907491185563564
2,0,0,2,1.0,1.0,0.34206507446919143,0.926538804611183
1,15,1,17,0.0625,0.9411764705882353,0.31401885598179646,0.9214195155162346
11,92,2,105,0.10679611650485436,0.9809523809523809,0.32466714912304295,0.925291833674267
26,116,7,149,0.18309859154929578,0.9530201342281879,0.2871877271365787,0.9523105830084527
26,33,4,63,0.4406779661016949,0.9365079365079365,0.29551183974821116,0.9598908673744513
5,23,3,31,0.17857142857142858,0.9032258064516129,0.3210220438298438,0.9484872900878779
1,23,0,24,0.041666666666666664,1.0,0.2923241744145747,0.9648360289486363
42,68,7,117,0.38181818181818183,0.9401709401709402,0.20401248610288633,0.9562890204016278
22,86,2,110,0.2037037037037037,0.9818181818181818,0.224184443774844,0.9620949791487632
35,88,3,126,0.2845528455284553,0.9761904761904762,0.24680433710276484,0.9614147070399195
185,221,11,417,0.45566502463054187,0.973621103117506,0.2829283116503847,0.963398929824683
7,85,13,105,0.07608695652173914,0.8761904761904762,0.230843881710391,0.9547821497793316
4,35,1,40,0.10256410256410256,0.975,0.22086535449048444,0.9604273110696543
0,12,2,14,0.0,0.8571428571428571,0.2149129735381035,0.940019147804348
2,13,1,16,0.13333333333333333,0.9375,0.179415138040268,0.9396375849227853
27,227,15,269,0.1062992125984252,0.9442379182156134,0.16550021073951396,0.934268975836704
50,106,15,171,0.32051282051282054,0.9122807017543859,0.17063735002299468,0.9251390080601197
3,23,0,26,0.11538461538461539,1.0,0.12202586298786235,0.928907421900476
4,64,58,126,0.058823529411764705,0.5396825396825397,0.11955965911500886,0.8808348595421993
5,39,8,52,0.11363636363636363,0.8461538461538461,0.12114141069676042,0.8624282661356059
18,171,17,206,0.09523809523809523,0.9174757281553398,0.13474685287363117,0.8710472477088177
24,140,2,166,0.14634146341463414,0.9879518072289156,0.13660515717095986,0.8782546487415199
17,128,4,149,0.11724137931034483,0.9731543624161074,0.13816832384409122,0.8823855693415906
6,110,2,118,0.05172413793103448,0.9830508474576272,0.0997699406181218,0.8924955901563393
48,167,7,222,0.22325581395348837,0.9684684684684685,0.11518011184224651,0.8879910856518347
15,86,1,102,0.1485148514851485,0.9901960784313726,0.1279931578527299,0.9523501626159537
2,57,1,60,0.03389830508474576,0.9833333333333333,0.11660200663107022,0.9719472322130234
3,28,8,39,0.0967741935483871,0.7948717948717948,0.11682144924682618,0.9544323846010884
25,135,4,164,0.15625,0.975609756097561,0.11823695447330704,0.9526692344394663
22,105,13,140,0.1732283464566929,0.9071428571428571,0.12623509263707106,0.9432390194004305
28,91,21,140,0.23529411764705882,0.85,0.15245937545364593,0.9242317554779123
17,89,2,108,0.16037735849056603,0.9814814814814815,0.14347673895894278,0.9260907573369143
9,57,1,67,0.13636363636363635,0.9850746268656716,0.14174085108444104,0.9253591213989569
7,121,4,132,0.0546875,0.9696969696969697,0.14471073607233448,0.923411069450905
16,33,1,50,0.32653061224489793,0.98,0.17753308160040748,0.9498579558977914
19,81,1,101,0.19,0.9900990099009901,0.18235451017183604,0.9519278492982812
9,20,1,30,0.3103448275862069,0.9666666666666667,0.20194257890462372,0.9604312506588254
11,82,3,96,0.11827956989247312,0.96875,0.18522621493968297,0.9773955363731112
20,34,1,55,0.37037037037037035,0.9818181818181818,0.21522521663679783,0.9774436364212112
0,4,59,63,0.0,0.06349206349206349,0.19574469715627835,0.8457889845106958
9,186,13,208,0.046153846153846156,0.9375,0.19452560374968494,0.8411894174111287
43,185,4,232,0.18859649122807018,0.9827586206896551,0.17482072931870957,0.8415835060810795
46,94,12,152,0.32857142857142857,0.9210526315789473,0.1946166476860565,0.8317197377493591
3,55,7,65,0.05172413793103448,0.8923076923076924,0.15767083487817474,0.8210970271266484
34,189,6,229,0.15246636771300448,0.9737991266375546,0.16255466313825062,0.8218183309320135
0,3,64,67,0.0,0.04477611940298507,0.10964461022819773,0.6879551791584139
6,8,1,15,0.42857142857142855,0.9333333333333333,0.1708691000241161,0.8122182177071667
22,63,2,87,0.25882352941176473,0.9770114942528736,0.2012504833466759,0.8178627168861486
3,59,3,65,0.04838709677419355,0.9538461538461539,0.18122056985326493,0.8137323644799342
50,62,32,144,0.44642857142857145,0.7777777777777778,0.1980573045471425,0.7932645282226243
198,326,68,592,0.37786259541984735,0.8851351351351351,0.24464851275983004,0.7922398771979733
2,56,1,59,0.034482758620689655,0.9830508474576272,0.22779371146092792,0.7935615516008407
28,70,8,106,0.2857142857142857,0.9245283018867925,0.2686100379915402,0.9192404348128133
2,0,0,2,1.0,1.0,0.3502426910527647,0.9287642443366227
1,15,1,17,0.0625,0.9411764705882353,0.32219647256536976,0.9236449552416744
13,90,2,105,0.1262135922330097,0.9809523809523809,0.3333145433452006,0.9275172733997069
29,113,7,149,0.20422535211267606,0.9530201342281879,0.2987140834429298,0.9525518957497654
26,33,4,63,0.4406779661016949,0.9365079365079365,0.30768770782605087,0.9598908673744513
4,25,2,31,0.13793103448275862,0.9354838709677419,0.3224660329492036,0.9530955850187535
1,23,0,24,0.041666666666666664,1.0,0.28458734676799724,0.9638772561777831
41,69,7,117,0.37272727272727274,0.9401709401709402,0.19497695715760763,0.9553302476307746
20,88,2,110,0.18518518518518517,0.9818181818181818,0.21250341218406268,0.9611362063779098
39,84,3,126,0.3170731707317073,0.9761904761904762,0.24670387901536067,0.9604559342690662
187,218,12,417,0.4617283950617284,0.9712230215827338,0.28449606422538626,0.9630563467482871
8,84,13,105,0.08695652173913043,0.8761904761904762,0.23396442931644845,0.9544395667029356
4,35,1,40,0.10256410256410256,0.975,0.22398590209654196,0.9600847279932582
0,12,2,14,0.0,0.8571428571428571,0.218033521144161,0.939676564727952
2,13,1,16,0.13333333333333333,0.9375,0.1838343869450268,0.9392950018463891
35,219,15,269,0.1377952755905512,0.9442379182156134,0.17706439986007907,0.933926392760308
49,107,15,171,0.3141025641025641,0.9122807017543859,0.17664002748448718,0.9247964249837236
3,23,0,26,0.11538461538461539,1.0,0.12716234467347104,0.9289074219004759
5,63,58,126,0.07352941176470588,0.5396825396825397,0.1252441861056961,0.8808348595421993
5,39,8,52,0.11363636363636363,0.8461538461538461,0.12682593768744768,0.8624282661356057
17,172,17,206,0.08994708994708994,0.9174757281553398,0.1396755219656034,0.8710472477088177
25,139,2,166,0.1524390243902439,0.9879518072289156,0.1424049064023049,0.8782546487415199
18,128,3,149,0.1232876712328767,0.9798657718120806,0.14033239149406568,0.883344342112444
6,110,2,118,0.05172413793103448,0.9830508474576272,0.10284975918384717,0.8934543629271926
47,168,6,221,0.2186046511627907,0.9728506787330317,0.11759547858072936,0.8895758884604829
16,85,1,102,0.15841584158415842,0.9901960784313726,0.1297221114120797,0.9539349654246019
4,54,1,59,0.06896551724137931,0.9830508474576272,0.12334056192708195,0.9734916798965706
2,29,8,39,0.06451612903225806,0.7948717948717948,0.11970756751067739,0.9559768322846356
26,134,4,164,0.1625,0.975609756097561,0.12114484974064256,0.9542136821230135
20,106,14,140,0.15873015873015872,0.9,0.12620806224025427,0.942804286149859
32,89,19,140,0.2644628099173554,0.8642857142857143,0.15659930109544298,0.9258378385538715
15,91,2,108,0.14150943396226415,0.9814814814814815,0.1455856986382249,0.9270708103750785
8,58,1,67,0.12121212121212122,0.9850746268656716,0.14027088144221958,0.9263391744371213
7,121,4,132,0.0546875,0.9696969696969697,0.13823116469345112,0.9244314776141703
17,32,1,50,0.3469387755102041,0.98,0.1785772570474434,0.9508783640610566
20,80,1,101,0.2,0.9900990099009901,0.18393439990458624,0.9529482574615465
8,21,1,30,0.27586206896551724,0.9666666666666667,0.20066752993820888,0.9624720669853561
9,82,5,96,0.0989010989010989,0.9479166666666666,0.17701585693588656,0.9744193458969208
19,35,1,55,0.35185185185185186,0.9818181818181818,0.2070647737772562,0.9744674459450209
0,4,59,63,0.0,0.06349206349206349,0.18974875646123893,0.8428127940345053
8,187,13,208,0.041025641025641026,0.9375,0.18779706232204477,0.8382132269349382
44,184,4,232,0.19298245614035087,0.9827586206896551,0.16580330241206573,0.8386073156048891
49,91,12,152,0.35,0.9210526315789473,0.18723187384063714,0.8287435472731686
4,54,7,65,0.06896551724137931,0.8923076923076924,0.15767522359433173,0.818120836650458
35,188,6,229,0.15695067264573992,0.9737991266375546,0.16596801984356618,0.8218183309320134
0,3,64,67,0.0,0.04477611940298507,0.11570346957901591,0.6879551791584139
6,8,1,15,0.42857142857142855,0.9333333333333333,0.17692795937493427,0.8122182177071667
22,63,2,87,0.25882352941176473,0.9770114942528736,0.2080419434300948,0.8178627168861486
2,60,3,65,0.03225806451612903,0.9538461538461539,0.18508131605520597,0.8137323644799341
49,64,31,144,0.4336283185840708,0.7847222222222222,0.1970282187100732,0.7942565917146878
195,331,66,592,0.37072243346007605,0.8885135135135135,0.2401363495984585,0.7937145661726621
1,57,1,59,0.017241379310344827,0.9830508474576272,0.22017787912197348,0.7950362405755297
31,67,8,106,0.3163265306122449,0.9245283018867925,0.2653673834951513,0.9207151237875022
2,0,0,2,1.0,1.0,0.3470000365563758,0.9302389333113117
1,15,1,17,0.0625,0.9411764705882353,0.3189538180689809,0.9251196442163634
13,90,2,105,0.1262135922330097,0.9809523809523809,0.3323760363142495,0.9289919623743959
29,114,6,149,0.20279720279720279,0.959731543624161,0.29940016263041125,0.9539932940032443
26,33,4,63,0.4406779661016949,0.9365079365079365,0.3093938101506425,0.9608496401453047
5,24,2,31,0.1724137931034483,0.9354838709677419,0.3315612978353716,0.9540543577896067
1,23,0,24,0.041666666666666664,1.0,0.29395227311343347,0.9644164036362438
43,69,5,117,0.38392857142857145,0.9572649572649573,0.2059420690318008,0.9583113975312377
17,91,2,110,0.1574074074074074,0.9818181818181818,0.21950027009000186,0.9641173562783731
40,83,3,126,0.3252032520325203,0.9761904761904762,0.252280065973067,0.9636921862103459
187,219,11,417,0.4605911330049261,0.973621103117506,0.28598770195099643,0.9649187773649945
8,83,13,104,0.08791208791208792,0.875,0.23361150671765835,0.9567468645320647
4,35,1,40,0.10256410256410256,0.975,0.22275331728804035,0.9626992454844457
0,13,1,14,0.0,0.9285714285714286,0.2168009363356594,0.9524951638517928
2,13,1,16,0.13333333333333333,0.9375,0.18100161660776828,0.9496715985282275
36,221,12,269,0.14007782101167315,0.9553903345724907,0.17852596140837765,0.9458961917788429
45,111,15,171,0.28846153846153844,0.9122807017543859,0.17327714518395165,0.9367662240022586
3,22,1,26,0.12,0.9615384615384616,0.1246212690403908,0.9350401323481093
5,72,49,126,0.06493506493506493,0.6111111111111112,0.12133883718653037,0.8973417196496966
5,46,1,52,0.09803921568627451,0.9807692307692307,0.12069242477541206,0.8981658954738725
20,169,17,206,0.10582010582010581,0.9174757281553398,0.1358095827497129,0.8965807954144313
23,141,2,166,0.1402439024390244,0.9879518072289156,0.13679680690766877,0.9037881964471335
22,124,3,149,0.1506849315068493,0.9798657718120806,0.13831210840697966,0.9072846874813606
7,109,2,118,0.0603448275862069,0.9830508474576272,0.10572400685336085,0.9173947082961094
49,166,6,221,0.22790697674418606,0.9728506787330317,0.12113928924538743,0.9190107393239051
15,86,1,102,0.1485148514851485,0.9901960784313726,0.13307925875254223,0.973165734655371
2,56,1,59,0.034482758620689655,0.9830508474576272,0.12399976488603012,0.9734916798965705
2,29,8,39,0.06451612903225806,0.7948717948717948,0.11809919677348044,0.9559768322846356
25,135,4,164,0.15625,0.975609756097561,0.12038578213933408,0.9542136821230134
20,106,14,140,0.15873015873015872,0.9,0.12153510031409256,0.942804286149859
32,92,16,140,0.25806451612903225,0.8857142857142857,0.14978077010592478,0.9288990630436675
18,88,2,108,0.16981132075471697,0.9814814814814815,0.14148139067885776,0.9301320348648746
8,58,1,67,0.12121212121212122,0.9850746268656716,0.13758100063985385,0.9294003989269173
6,122,4,132,0.046875,0.9696969696969697,0.1393513208368982,0.9274927021039662
17,32,1,50,0.3469387755102041,0.98,0.17969741319089047,0.9539395885508526
20,80,1,101,0.2,0.9900990099009901,0.18594741319089048,0.9560094819513426
8,21,1,30,0.27586206896551724,0.9666666666666667,0.20268054322451312,0.9655332914751521
10,84,2,96,0.10638297872340426,0.9791666666666666,0.18101175216656626,0.9788836316112065
19,35,1,55,0.35185185185185186,0.9818181818181818,0.2070175423232998,0.9789317316593066
0,4,59,63,0.0,0.06349206349206349,0.1897015250072825,0.847277079748791
9,186,13,208,0.046153846153846156,0.9375,0.18959850302926054,0.842677512649224
49,179,4,232,0.2149122807017544,0.9827586206896551,0.170737575199482,0.8430716013191747
50,91,11,152,0.3546099290780142,0.9276315789473685,0.1928247079249126,0.8341476826115145
2,55,7,64,0.03508771929824561,0.890625,0.1584283722581595,0.8232845873734193
33,190,6,229,0.14798206278026907,0.9737991266375546,0.16437109855199733,0.822517795940689
9,57,1,67,0.13636363636363635,0.9850746268656716,0.13358706776796656,0.8229830023760447
6,8,1,15,0.42857142857142855,0.9333333333333333,0.1948115575638849,0.9472460409247975
22,63,2,87,0.25882352941176473,0.9770114942528736,0.22519294088644473,0.9528905401037794
2,60,3,65,0.03225806451612903,0.9538461538461539,0.1990994814313554,0.948760187697565
50,66,28,144,0.43103448275862066,0.8055555555555556,0.2100172748142992,0.9313207557844488
197,322,73,592,0.37957610789980734,0.8766891891891891,0.2592299017573794,0.9293299256686186
1,57,1,59,0.017241379310344827,0.9830508474576272,0.24055266126167593,0.9306516000714862
31,72,3,106,0.30097087378640774,0.9716981132075472,0.2640679808935004,0.9287406695488969
2,0,0,2,1.0,1.0,0.34570063395472495,0.9382644790727065
1,15,1,17,0.0625,0.9411764705882353,0.31765441546733,0.9331451899777582
8,95,2,105,0.07766990291262135,0.9809523809523809,0.3241418209525432,0.9370175081357907
28,114,7,149,0.19718309859154928,0.9530201342281879,0.29073448035724725,0.9580838765175951
26,33,4,63,0.4406779661016949,0.9365079365079365,0.29946331724323116,0.9666294118488449
5,24,2,31,0.1724137931034483,0.9354838709677419,0.3216308049279602,0.959834129493147
1,21,0,22,0.045454545454545456,1.0,0.296567132259105,0.9587688561961263
40,61,8,109,0.39603960396039606,0.926605504587156,0.21028707568201874,0.9482839282800057
15,74,2,91,0.16853932584269662,0.978021978021978,0.22543555080240396,0.9535475721991118
35,67,3,105,0.3431372549019608,0.9714285714285714,0.2594175646605788,0.952411447646198
191,176,14,381,0.5204359673024523,0.963254593175853,0.30190533388467017,0.953073433863438
6,78,13,97,0.07142857142857142,0.865979381443299,0.24717435058225828,0.9436128612366937
4,28,1,33,0.125,0.9696969696969697,0.23857646698437468,0.9535695711934038
0,12,2,14,0.0,0.8571428571428571,0.2320829604908682,0.9331614079280977
1,8,1,10,0.1111111111111111,0.9,0.19137889008382744,0.929360621558504
34,183,14,231,0.15668202764976957,0.9393939393939394,0.18968499034198075,0.923842330325927
47,93,15,155,0.3357142857142857,0.9032258064516129,0.18862456617231288,0.9140990781863615
3,21,0,24,0.125,1.0,0.13213371370053398,0.9193484220183825
4,57,61,122,0.06557377049180328,0.5,0.13129731356670996,0.8670656532407683
3,37,8,48,0.075,0.8333333333333334,0.12415445642385282,0.8475851337602488
15,156,16,187,0.08771929824561403,0.9144385026737968,0.13668578474465481,0.8557702259789546
22,113,2,137,0.16296296296296298,0.9854014598540146,0.14409319215206223,0.8679704345295279
16,122,3,141,0.11594202898550725,0.9787234042553191,0.1382731923428819,0.8735889295097251
4,97,2,103,0.039603960396039604,0.9805825242718447,0.09597171729741817,0.8846398891983297
47,168,6,221,0.2186046511627907,0.9728506787330317,0.10934381032067399,0.88076141473162
10,68,1,79,0.1282051282051282,0.9873417721518988,0.11829114713686327,0.9503816678961768
3,48,1,52,0.058823529411764705,0.9807692307692307,0.11598022276711537,0.9714439389584479
2,27,8,37,0.06896551724137931,0.7837837837837838,0.11330111119508184,0.9527789791170175
25,132,4,161,0.1592356687898089,0.9751552795031055,0.11276864059891697,0.9513152390668876
22,96,13,131,0.1864406779661017,0.9007633587786259,0.1228398761675733,0.9401780897130744
32,75,19,126,0.29906542056074764,0.8492063492063492,0.15990579904824592,0.9214100647037178
16,83,2,101,0.16161616161616163,0.9801980198019802,0.1517645862558703,0.9224596848564247
11,54,1,66,0.16923076923076924,0.9848484848484849,0.15762539211667617,0.9221035009559371
6,108,4,118,0.05263157894736842,0.9661016949152542,0.15674082776461956,0.9200081386910833
16,30,1,47,0.34782608695652173,0.9787234042553191,0.1965780520096399,0.9478566559013026
20,79,1,100,0.20202020202020202,0.99,0.20269012818541035,0.9499773302580018
7,20,1,28,0.25925925925925924,0.9642857142857143,0.21309278265586146,0.9590519524733001
8,68,2,78,0.10526315789473684,0.9743589743589743,0.18540674513214558,0.9769308989236752
20,33,1,54,0.37735849056603776,0.9814814814814815,0.21622707783927078,0.9771142505921754
0,1,59,60,0.0,0.016666666666666666,0.19205125366344658,0.838802562280487
10,162,9,181,0.05813953488372093,0.9502762430939227,0.19283810451149694,0.8365417834488682
50,144,4,198,0.25773195876288657,0.9797979797979798,0.17996751476954906,0.8366952942406769
53,85,11,149,0.38405797101449274,0.9261744966442953,0.20597291034016202,0.8275773651898619
1,55,7,63,0.017857142857142856,0.8888888888888888,0.17148689371128828,0.8168063901331726
33,166,6,205,0.1658291457286432,0.9707317073170731,0.18013917768756063,0.8162882091271867
0,3,64,67,0.0,0.04477611940298507,0.12623082189241236,0.6824731574016872
6,8,1,15,0.42857142857142855,0.9333333333333333,0.18745531168833068,0.8134255383540683
21,47,2,70,0.3088235294117647,0.9714285714285714,0.2232673109066227,0.8164472995447323
3,57,3,63,0.05,0.9523809523809523,0.19359131679763886,0.8125305813422999
50,63,31,144,0.4424778761061947,0.7847222222222222,0.20193701752502485,0.7923231135677179
199,322,68,589,0.381957773512476,0.8845500848896435,0.2539513933329296,0.7917032844249686
0,52,1,53,0.0,0.9811320754716981,0.2302615153716949,0.7931890513042007
32,55,8,95,0.367816091954023,0.9157894736842105,0.28280667136512677,0.917619530487233
2,0,0,2,1.0,1.0,0.3644393244263512,0.9271433400110425
1,15,1,17,0.0625,0.9411764705882353,0.32925024879609904,0.9228216113195657
9,85,2,96,0.09574468085106383,0.9791666666666666,0.33578520320339394,0.9266481419318108
31,107,5,143,0.2246376811594203,0.965034965034965,0.3046651753538548,0.9524071051907741
25,30,4,59,0.45454545454545453,0.9322033898305084,0.3150348440728517,0.9592147201823262
5,23,2,30,0.17857142857142858,0.9333333333333333,0.34054504815448433,0.9523863284482742
1,21,0,22,0.045454545454545456,1.0,0.30140149848740794,0.9573514157052009
42,60,7,109,0.4117647058823529,0.9357798165137615,0.21736788504202975,0.9481771037785954
15,74,2,91,0.16853932584269662,0.978021978021978,0.23251636016241498,0.9534407476977016
36,65,3,104,0.3564356435643564,0.9711538461538461,0.26679218719033276,0.9520409570121966
193,174,14,381,0.5258855585831063,0.963254593175853,0.299061552702205,0.9554205681178554
6,78,13,97,0.07142857142857142,0.865979381443299,0.25115425418957965,0.9453450602514785
4,28,1,33,0.125,0.9696969696969697,0.24350119296508987,0.954840940715101
0,12,2,14,0.0,0.8571428571428571,0.23700768647158338,0.9344327774497947
1,8,1,10,0.1111111111111111,0.9,0.19405717293283456,0.929321375090686
35,182,15,232,0.16129032258064516,0.9353448275862069,0.19302160103825575,0.9232246393141473
47,92,15,154,0.3381294964028777,0.9025974025974026,0.19040643715804453,0.9134308616632268
3,21,0,24,0.125,1.0,0.1331370716461722,0.9186802054952478
7,62,53,122,0.10144927536231885,0.5655737704918032,0.13742574363670754,0.8757651182164626
3,37,8,48,0.075,0.8333333333333334,0.1302828864938504,0.8562845987359432
17,154,16,187,0.09941520467836257,0.9144385026737968,0.14448505859075933,0.8644696909546489
23,113,2,138,0.16911764705882354,0.9855072463768116,0.15277170658328967,0.8766850118656219
18,120,3,141,0.13043478260869565,0.9787234042553191,0.14836377230158262,0.8828819513897808
3,98,2,103,0.0297029702970297,0.9805825242718447,0.10430284000074719,0.8940226830575583
48,167,6,221,0.22325581395348837,0.9728506787330317,0.11833938485124552,0.8901442085908485
9,69,1,79,0.11538461538461539,0.9873417721518988,0.1203301477115736,0.9503967802565764
3,48,1,52,0.058823529411764705,0.9807692307692307,0.11801922334182571,0.9714590513188475
3,26,8,37,0.10344827586206896,0.7837837837837838,0.11859537636806948,0.952794091477417
25,131,4,160,0.16025641025641027,0.975,0.11732948539629615,0.9512930562807298
21,97,13,131,0.17796610169491525,0.9007633587786259,0.12411967383718467,0.9401559069269164
34,74,18,126,0.3148148148148148,0.8571428571428571,0.1648499373397254,0.9225216687656325
15,84,2,101,0.15151515151515152,0.9801980198019802,0.15460127127710585,0.9235712889183393
10,55,1,66,0.15384615384615385,0.9848484848484849,0.16009577677161135,0.9232151050178518
6,108,4,118,0.05263157894736842,0.9661016949152542,0.15921121241955474,0.9211197427529978
17,29,1,47,0.3695652173913043,0.9787234042553191,0.19722791835230266,0.9489682599632172
20,79,1,100,0.20202020202020202,0.99,0.20319417431855863,0.9511111171060743
8,19,1,28,0.2962962962962963,0.9642857142857143,0.2200984878330416,0.9601857393213727
8,68,2,78,0.10526315789473684,0.9743589743589743,0.19016253684445902,0.9769308989236752
19,34,1,54,0.3584905660377358,0.9814814814814815,0.21973045320482823,0.9771142505921754
0,1,59,60,0.0,0.016666666666666666,0.19775243122680622,0.838802562280487
9,159,13,181,0.05357142857142857,0.9281767955801105,0.19788669545881482,0.8333847195183236
51,143,4,198,0.26288659793814434,0.9797979797979798,0.18264689267979195,0.8335382303101324
52,81,11,144,0.39097744360902253,0.9236111111111112,0.20964078433533775,0.8240541033260053
1,55,7,63,0.017857142857142856,0.8888888888888888,0.16986376241545872,0.813283128269316
36,161,6,203,0.18274111675126903,0.9704433497536946,0.18093204225210616,0.8127237533257045
0,3,64,67,0.0,0.04477611940298507,0.12971910424671534,0.6789087016002051
6,8,1,15,0.42857142857142855,0.9333333333333333,0.1909435940426337,0.809861082552586
21,47,2,70,0.3088235294117647,0.9714285714285714,0.22740817987696743,0.8160399076737948
2,58,3,63,0.03333333333333333,0.9523809523809523,0.19461485636199444,0.8121231894713622
53,60,30,143,0.4690265486725664,0.7902097902097902,0.20576472851392927,0.7930658579140307
193,328,68,589,0.3704414587332054,0.8845500848896435,0.2561339164962239,0.7924460287712813
1,51,1,53,0.019230769230769232,0.9811320754716981,0.23277529542186678,0.793972989588139
38,48,8,94,0.4418604651162791,0.9148936170212766,0.2958982190099067,0.918275489247895
2,0,0,2,1.0,1.0,0.3775308720711311,0.9277992987717045
1,15,1,17,0.0625,0.9411764705882353,0.3423417964408791,0.9234775700802279
10,85,2,97,0.10526315789473684,0.979381443298969,0.35261748566393664,0.9273347830685159
31,108,6,145,0.22302158273381295,0.9586206896551724,0.3174739191012576,0.9513934829892848
25,30,4,59,0.45454545454545453,0.9322033898305084,0.3294887756458647,0.958201097980837
5,22,3,30,0.18518518518518517,0.9,0.35319654935363837,0.9466108014848801
1,23,0,24,0.041666666666666664,1.0,0.305337542334615,0.9638772561777831
43,67,7,117,0.39090909090909093,0.9401709401709402,0.21832455532162798,0.9553302476307745
23,84,2,109,0.21495327102803738,0.981651376146789,0.24010359403991902,0.9611123769962823
35,88,3,126,0.2845528455284553,0.9761904761904762,0.26549741247186204,0.9604321048874388
197,206,14,417,0.48883374689826303,0.9664268585131894,0.29307728375913905,0.9623473512138674
7,84,13,104,0.07692307692307693,0.875,0.24353360709681832,0.953560503141305
4,35,1,40,0.10256410256410256,0.975,0.22862897150252756,0.9592056644316277
0,12,2,14,0.0,0.8571428571428571,0.2226765905501466,0.9387975011663215
3,12,1,16,0.2,0.9375,0.19540386327741932,0.9384159382847587
35,219,15,269,0.1377952755905512,0.9442379182156134,0.1843812925006356,0.933071158580305
48,107,16,171,0.3096774193548387,0.9064327485380117,0.18797051733297604,0.9231057689156673
3,23,0,26,0.11538461538461539,1.0,0.13462064140245497,0.9279019319852116
5,50,71,126,0.09090909090909091,0.4365079365079365,0.13661864340045698,0.8652602086292026
5,39,8,52,0.11363636363636363,0.8461538461538461,0.13820039498220854,0.8468536152226092
18,171,17,206,0.09523809523809523,0.9174757281553398,0.1518058371590793,0.8554725967958209
24,140,2,166,0.14634146341463414,0.9879518072289156,0.14414033193259845,0.8626799978285232
18,129,3,150,0.12244897959183673,0.98,0.14194800393278212,0.8677888666548642
3,113,2,118,0.02586206896551724,0.9830508474576272,0.10140295387716476,0.8787343093576664
51,164,6,221,0.2372093023255814,0.9728506787330317,0.11880648058301703,0.8748558348909565
14,87,1,102,0.13861386138613863,0.9901960784313726,0.12562144779402387,0.953954140880019
5,53,1,59,0.08620689655172414,0.9830508474576272,0.12170295249621822,0.9735108553519876
3,28,8,39,0.0967741935483871,0.7948717948717948,0.12192239511197421,0.9559960077400527
25,135,4,164,0.15625,0.975609756097561,0.12333790033845503,0.9542328575784306
19,107,14,140,0.15079365079365079,0.9,0.12738713908157132,0.9428042861498591
35,86,19,140,0.2892561983471074,0.8642857142857143,0.16501487185036992,0.9258378385538715
16,91,2,109,0.14953271028037382,0.981651376146789,0.15248964441534027,0.9270950810415511
12,54,1,67,0.18181818181818182,0.9850746268656716,0.15866169019134646,0.9263634451035939
6,121,4,131,0.047244094488188976,0.9694656488549618,0.15309557561084142,0.9244227024460702
18,31,1,50,0.3673469387755102,0.98,0.19174882492900186,0.9508695888929567
20,80,1,101,0.2,0.9900990099009901,0.19799882492900187,0.9529394822934466
8,21,1,30,0.27586206896551724,0.9666666666666667,0.21586574181069706,0.9624632918172561
10,83,3,96,0.10752688172043011,0.96875,0.18990441086402887,0.9773867612050112
18,36,1,55,0.3333333333333333,0.9818181818181818,0.2161616427287374,0.9774105905866388
0,4,59,63,0.0,0.06349206349206349,0.1901876167547114,0.8457559386761232
8,187,13,208,0.041025641025641026,0.9375,0.1892992662600617,0.8411894174111287
51,177,4,232,0.2236842105263158,0.9827586206896551,0.16877601936731965,0.8415835060810795
48,92,12,152,0.34285714285714286,0.9210526315789473,0.18918418263262576,0.831719737749359
2,61,2,65,0.031746031746031744,0.9692307692307692,0.15431046302984214,0.8320860381156594
34,189,6,229,0.15246636771300448,0.9737991266375546,0.16073038960020988,0.8328073419210243
1,1,65,67,0.5,0.029850746268656716,0.1845399134097337,0.696811993985378
6,8,1,15,0.42857142857142855,0.9333333333333333,0.24576440320565207,0.8210750325341307
22,63,2,87,0.25882352941176473,0.9770114942528736,0.2768783872608126,0.8267195317131127
2,60,3,65,0.03225806451612903,0.9538461538461539,0.24953179497364306,0.8225891793068982
48,61,34,143,0.44036697247706424,0.7622377622377622,0.2634617706336318,0.7999013408295861
197,323,72,592,0.37884615384615383,0.8783783783783784,0.31304750236222073,0.7869224278506731
1,57,1,59,0.017241379310344827,0.9830508474576272,0.29372964687612646,0.7882441022535407
36,63,8,107,0.36363636363636365,0.9252336448598131,0.274249127395607,0.9161559449094201
2,0,0,2,1.0,1.0,0.35588178045683144,0.9256797544332296
1,15,1,17,0.0625,0.9411764705882353,0.32783556196943653,0.9205604653382812
12,91,2,105,0.11650485436893204,0.9809523809523809,0.33987081766269406,0.9244327834963136
42,98,9,149,0.3,0.9395973154362416,0.31981839302311343,0.9497698625246679
24,35,4,63,0.4067796610169492,0.9365079365079365,0.32380889404751284,0.9580740851146048
5,23,3,31,0.17857142857142858,0.9032258064516129,0.34685604394195335,0.9466705078280313
1,23,0,24,0.041666666666666664,1.0,0.30633991579870046,0.9657948017194897
44,66,7,117,0.4,0.9401709401709402,0.22062563008441474,0.9572477931724811
22,85,2,109,0.205607476635514,0.981651376146789,0.2410695553180596,0.9630299225379889
36,87,3,126,0.2926829268292683,0.9761904761904762,0.26901177648784413,0.9623496504291454
197,206,14,417,0.48883374689826303,0.9664268585131894,0.29420231175902456,0.9623473512138674
6,85,13,104,0.06593406593406594,0.875,0.24308877638398796,0.953560503141305
4,35,1,40,0.10256410256410256,0.975,0.2281841407896972,0.9592056644316278
0,12,2,14,0.0,0.8571428571428571,0.22223175983731625,0.9387975011663215
3,12,1,16,0.2,0.9375,0.19366033126588764,0.9384159382847587
35,219,15,269,0.1377952755905512,0.9442379182156134,0.18397287397375012,0.933071158580305
48,107,16,171,0.3096774193548387,0.9064327485380117,0.1864006586202602,0.9231057689156671
3,23,0,26,0.11538461538461539,1.0,0.1330507826897391,0.9279019319852116
5,63,58,126,0.07352941176470588,0.5396825396825397,0.13413583209411623,0.8799994376541459
5,39,8,52,0.11363636363636363,0.8461538461538461,0.1357175836758678,0.8615928442475524
21,168,17,206,0.1111111111111111,0.9174757281553398,0.1515905995488837,0.8702118258207643
26,138,2,166,0.15853658536585366,0.9879518072289156,0.14566725460114852,0.8774192268534665
20,127,3,150,0.1360544217687075,0.98,0.14541856119802796,0.8825280956798075
3,113,2,118,0.02586206896551724,0.9830508474576272,0.10487351114241061,0.8934735383826097
51,164,6,221,0.2372093023255814,0.9728506787330317,0.12227703784826291,0.8895950639158998
13,88,1,102,0.12871287128712872,0.9901960784313726,0.130160389208609,0.9539541408800188
2,56,1,59,0.034482758620689655,0.9830508474576272,0.11885273134922703,0.9735108553519876
3,28,8,39,0.0967741935483871,0.7948717948717948,0.11680460026883789,0.9559960077400526
25,135,4,164,0.15625,0.975609756097561,0.11647794521657308,0.9542328575784305
19,107,14,140,0.15079365079365079,0.9,0.11858354936299353,0.9428042861498591
36,82,22,140,0.3050847457627119,0.8428571428571429,0.1584725031911642,0.9227766140640756
15,92,2,109,0.14018691588785046,0.981651376146789,0.14461216227148835,0.9240338565517553
13,53,1,67,0.19696969696969696,0.9850746268656716,0.15436313736899812,0.923302220613798
6,122,4,132,0.046875,0.9696969696969697,0.15613345756604244,0.9213945237908469
18,31,1,50,0.3673469387755102,0.98,0.19478670688420288,0.9478414102377334
19,81,1,101,0.19,0.9900990099009901,0.19960813545563144,0.9499113036382233
8,21,1,30,0.27586206896551724,0.9666666666666667,0.2174750523373267,0.9594351131620327
10,84,2,96,0.10638297872340426,0.9791666666666666,0.1890890856174256,0.978907902277679
18,36,1,55,0.3333333333333333,0.9818181818181818,0.2166814309667803,0.9789317316593065
0,4,59,63,0.0,0.06349206349206349,0.18854290282825215,0.8472770797487911
9,186,13,208,0.046153846153846156,0.9375,0.18843988085023014,0.842677512649224
51,177,4,232,0.2236842105263158,0.9827586206896551,0.16791663395748807,0.8430716013191747
46,92,13,151,0.3333333333333333,0.9139072847682119,0.18839282443367855,0.8321870691573493
1,62,2,65,0.015873015873015872,0.9692307692307692,0.1512515311347498,0.8325533695236497
31,192,6,229,0.13901345291479822,0.9737991266375546,0.15591302744780608,0.8317865780909194
1,1,65,67,0.5,0.029850746268656716,0.1797225512573299,0.695791230155273
6,8,1,15,0.42857142857142855,0.9333333333333333,0.24094704105324824,0.8200542687040258
21,64,2,87,0.24705882352941178,0.9770114942528736,0.26964775210690045,0.8256987678830077
2,60,3,65,0.03225806451612903,0.9538461538461539,0.24230115981973094,0.8215684154767933
53,58,32,143,0.4774774774774775,0.7762237762237763,0.2628931804117515,0.8018993428275881
195,328,69,592,0.372848948374761,0.8834459459459459,0.3138897421977151,0.7896443680726134
1,57,1,59,0.017241379310344827,0.9830508474576272,0.2964937316827932,0.790966042475481
37,62,8,107,0.37373737373737376,0.9252336448598131,0.2784562136452752,0.9188778851313604
2,0,0,2,1.0,1.0,0.36008886670649964,0.9284016946551699
1,15,1,17,0.0625,0.9411764705882353,0.33372332048801223,0.9232824055602215
11,92,2,105,0.10679611650485436,0.9809523809523809,0.3443716136292588,0.9271547237182539
42,100,7,149,0.29577464788732394,0.9530201342281879,0.31841406654495114,0.9524113462903128
25,34,4,63,0.423728813559322,0.9365079365079365,0.3256826187141741,0.9599916306563114
6,23,2,31,0.20689655172413793,0.9354838709677419,0.35277621477328747,0.9531963483006135
1,23,0,24,0.041666666666666664,1.0,0.303231795105834,0.9648360289486364
43,66,8,117,0.3944954128440367,0.9316239316239316,0.21673113979783926,0.9550680191806267
18,89,2,109,0.16822429906542055,0.981651376146789,0.23183461109289932,0.9608501485461343
35,88,3,126,0.2845528455284553,0.9761904761904762,0.2586153920768534,0.9601698764372907
199,204,14,417,0.49379652605459057,0.9664268585131894,0.2852017089857509,0.9611263499928663
7,84,13,104,0.07692307692307693,0.875,0.2380793398294835,0.9523395019203039
4,35,1,40,0.10256410256410256,0.975,0.22317470423519273,0.9579846632106265
0,12,2,14,0.0,0.8571428571428571,0.21722232328281174,0.9375764999453203
3,12,1,16,0.2,0.9375,0.18943726430509225,0.9384159382847586
35,219,15,269,0.1377952755905512,0.9442379182156134,0.18509026095153946,0.9330711585803051
48,107,16,171,0.3096774193548387,0.9064327485380117,0.18867948578387997,0.9231057689156673
3,23,0,26,0.11538461538461539,1.0,0.13462064140245494,0.9279019319852116
6,52,68,126,0.10344827586206896,0.4603174603174603,0.13840995553659666,0.8686615691734202
5,39,8,52,0.11363636363636363,0.8461538461538461,0.13999170711834824,0.8502549757668268
17,172,17,206,0.08994708994708994,0.9174757281553398,0.15284129139650396,0.8588739573400387
28,136,2,166,0.17073170731707318,0.9879518072289156,0.1486601067275144,0.8660813583727409
20,127,3,150,0.1360544217687075,0.98,0.1484114133243939,0.8711902271990818
3,113,2,118,0.02586206896551724,0.9830508474576272,0.10786636326877651,0.882135669901884
51,164,6,221,0.2372093023255814,0.9728506787330317,0.12526988997462882,0.8782571954351742
14,87,1,102,0.13861386138613863,0.9901960784313726,0.13029354504949592,0.9539541408800188
3,55,1,59,0.05172413793103448,0.9830508474576272,0.12144894137730602,0.9735108553519876
4,27,8,39,0.12903225806451613,0.7948717948717948,0.12703253682265261,0.9559960077400526
24,136,4,164,0.15,0.975609756097561,0.12407086434878502,0.9542328575784305
20,107,13,140,0.15748031496062992,0.9071428571428571,0.12713170623334538,0.9438246943131244
37,85,18,140,0.30327868852459017,0.8714285714285714,0.16676265188464148,0.9278786548804021
18,89,2,109,0.16822429906542055,0.981651376146789,0.15690765141890423,0.9291358973680818
12,54,1,67,0.18181818181818182,0.9850746268656716,0.16307969719491042,0.9284042614301244
6,122,4,132,0.046875,0.9696969696969697,0.16238696320476262,0.9264965646071734
18,31,1,50,0.3673469387755102,0.98,0.1964319175920475,0.95294345105406
19,81,1,101,0.19,0.9900990099009901,0.2021462033063332,0.9550133444545498
8,21,1,30,0.27586206896551724,0.9666666666666667,0.21905788244988855,0.9635167458150941
10,84,2,96,0.10638297872340426,0.9791666666666666,0.190929923906862,0.9789079022776789
20,34,1,55,0.37037037037037035,0.9818181818181818,0.2198079340932834,0.9789317316593065
0,4,59,63,0.0,0.06349206349206349,0.1938339081192574,0.8472770797487911
9,185,13,207,0.04639175257731959,0.9371980676328503,0.1937648727731602,0.8426343794539168
52,176,4,232,0.22807017543859648,0.9827586206896551,0.17386819229645825,0.8430284681238677
52,88,11,151,0.37142857142857144,0.9271523178807947,0.19978655964339703,0.8340360835495539
2,56,7,65,0.034482758620689655,0.8923076923076924,0.16530380102270734,0.8234133729268434
32,191,6,229,0.14349775784753363,0.9737991266375546,0.17060591232615438,0.8226465814941131
1,2,64,67,0.3333333333333333,0.04477611940298507,0.16531490703514912,0.6887834297205135
6,8,1,15,0.42857142857142855,0.9333333333333333,0.22653939683106747,0.8130464682692663
22,63,2,87,0.25882352941176473,0.9770114942528736,0.25688679352170246,0.8187341006435555
2,60,3,65,0.03225806451612903,0.9538461538461539,0.2289136348184929,0.814603748237341
53,58,32,143,0.4774774774774775,0.7762237762237763,0.24406347853976515,0.7930425280006241
196,328,68,592,0.37404580152671757,0.8851351351351351,0.2925724846691978,0.792017876975973
2,56,1,59,0.034482758620689655,0.9830508474576272,0.2769989133510772,0.7933395513788406
36,63,8,107,0.36363636363636365,0.9252336448598131,0.2813279176800815,0.9191191978726732
2,0,0,2,1.0,1.0,0.362960570741306,0.9286430073964826
1,15,1,17,0.0625,0.9411764705882353,0.33491435225391103,0.9235237183015342
10,93,2,105,0.0970873786407767,0.9809523809523809,0.3441756828431464,0.9273960364595667
45,99,5,149,0.3125,0.9664429530201343,0.32060747177493537,0.9545702045733321
25,34,4,63,0.423728813559322,0.9365079365079365,0.32770504492245023,0.9619091761980181
6,23,2,31,0.20689655172413793,0.9354838709677419,0.35233558679437144,0.95511389384232
1,23,0,24,0.041666666666666664,1.0,0.3057427513665845,0.9657948017194897
41,67,9,117,0.37962962962962965,0.9230769230769231,0.21711841274224591,0.9548057907304788
18,89,2,109,0.16822429906542055,0.981651376146789,0.232221884037306,0.9605879200959865
34,89,3,126,0.2764227642276423,0.9761904761904762,0.2564542622834186,0.959907647987143
200,203,14,417,0.49627791563275436,0.9664268585131894,0.2846923772150819,0.959905348771865
7,84,13,104,0.07692307692307693,0.875,0.2351487005527612,0.9511185006993027
4,35,1,40,0.10256410256410256,0.975,0.2202440649584704,0.9567636619896254
0,12,2,14,0.0,0.8571428571428571,0.21429168400608942,0.9363554987243191
3,12,1,16,0.2,0.9375,0.1886303083447138,0.9384159382847587
37,217,15,269,0.14566929133858267,0.9442379182156134,0.18540816438373695,0.933071158580305
48,107,16,171,0.3096774193548387,0.9064327485380117,0.19015882940190787,0.9231057689156671
2,24,0,26,0.07692307692307693,1.0,0.13025099530052536,0.9279019319852116
11,59,56,126,0.15714285714285714,0.5555555555555556,0.1417109639033511,0.8822670113502911
5,40,7,52,0.1111111111111111,0.8653846153846154,0.14293196512435233,0.8666076706909502
20,169,17,206,0.10582010582010581,0.9174757281553398,0.15804912309865315,0.8752266522641622
24,140,2,166,0.14634146341463414,0.9879518072289156,0.15038361787217233,0.8824340532968644
21,126,3,150,0.14285714285714285,0.98,0.1499818823748238,0.8875429221232054
3,113,2,118,0.02586206896551724,0.9830508474576272,0.10943683231920642,0.8984883648260077
52,163,6,221,0.24186046511627907,0.9728506787330317,0.13299931634680673,0.8946098903592977
14,87,1,102,0.13861386138613863,0.9901960784313726,0.1303523169529898,0.9567013936272717
2,56,1,59,0.034482758620689655,0.9830508474576272,0.11940540945435818,0.9735108553519876
4,27,8,39,0.12903225806451613,0.7948717948717948,0.12272143120355963,0.9559960077400527
24,135,4,163,0.1509433962264151,0.9754601226993865,0.1233788501766712,0.9542114813786914
22,104,14,140,0.1746031746031746,0.9,0.12791399756896144,0.9427829099501198
36,89,15,140,0.288,0.8928571428571429,0.1653622734310304,0.9298980950071936
15,92,2,109,0.14018691588785046,0.981651376146789,0.15083748068411204,0.9311553374948732
13,53,1,67,0.19696969696969696,0.9850746268656716,0.15917402862462038,0.9304237015569158
6,122,4,132,0.046875,0.9696969696969697,0.1609443488216647,0.9285160047339648
17,32,1,50,0.3469387755102041,0.98,0.1920738513139059,0.9549628911808512
21,79,1,101,0.21,0.9900990099009901,0.20051050899584658,0.9570541607810804
8,21,1,30,0.27586206896551724,0.9666666666666667,0.21497606533332408,0.9665779703048899
10,83,3,96,0.10752688172043011,0.96875,0.1891941912933855,0.9774198070395838
20,33,1,54,0.37735849056603776,0.9814814814814815,0.22307584481884085,0.9773955363731112
0,4,59,63,0.0,0.06349206349206349,0.19493731668031272,0.8457408844625959
8,190,9,207,0.04040404040404041,0.9565217391304348,0.1940128938808899,0.8438587086673766
52,176,4,232,0.22807017543859648,0.9827586206896551,0.17703166529923167,0.8442527973373272
49,91,12,152,0.35,0.9210526315789473,0.19703166529923166,0.8343890290056069
2,56,7,65,0.034482758620689655,0.8923076923076924,0.16254890667854202,0.8237663183828962
33,190,6,229,0.14798206278026907,0.9737991266375546,0.16832821825851904,0.8244876221882612
1,2,64,67,0.3333333333333333,0.04477611940298507,0.16203891008241839,0.6906725704627618
6,8,1,15,0.42857142857142855,0.9333333333333333,0.22326339987833674,0.8149356090115145
23,62,2,87,0.27058823529411763,0.9770114942528736,0.2561468562912049,0.8178627168861486
2,60,3,65,0.03225806451612903,0.9538461538461539,0.22817369758799527,0.8137323644799342
50,62,31,143,0.44642857142857145,0.7832167832167832,0.2419492077920769,0.7940415289996251
194,329,69,592,0.37093690248565964,0.8834459459459459,0.29001408548707264,0.7927755652336613
1,57,1,59,0.017241379310344827,0.9830508474576272,0.2713368449913692,0.7940972396365288
36,63,8,107,0.36363636363636365,0.9252336448598131,0.2756658493203735,0.9198768861303613
2,0,0,2,1.0,1.0,0.35729850238159805,0.9294006956541708
1,15,1,17,0.0625,0.9411764705882353,0.3275716116252955,0.9242814065592225
10,93,2,105,0.0970873786407767,0.9809523809523809,0.3368329422145309,0.928153724717255
44,99,6,149,0.3076923076923077,0.959731543624161,0.31701347596649315,0.953370119061166
24,35,4,63,0.4067796610169492,0.9365079365079365,0.32213387004239175,0.9609504034271648
6,23,2,31,0.20689655172413793,0.9354838709677419,0.349227466101505,0.9541551210714668
1,23,0,24,0.041666666666666664,1.0,0.3082267364423775,0.9623870733174399
44,68,5,117,0.39285714285714285,0.9572649572649573,0.2214920425648265,0.9562820672124338
18,89,2,109,0.16822429906542055,0.981651376146789,0.23659551385988656,0.9620641965779415
35,88,3,126,0.2845528455284553,0.9761904761904762,0.26342103557132485,0.9616703548307164
198,209,10,417,0.4864864864864865,0.9760191846522782,0.2867006176744364,0.9652375310597632
7,84,13,104,0.07692307692307693,0.875,0.23275456372838246,0.9570656182268333
4,35,1,40,0.10256410256410256,0.975,0.22189637429876446,0.9630179991792144
0,13,1,14,0.0,0.9285714285714286,0.2159439933463835,0.9528139175465612
3,12,1,16,0.2,0.9375,0.18839297293822024,0.949990352222996
39,218,11,268,0.1517509727626459,0.9589552238805971,0.18603964060925243,0.946748044756397
49,106,16,171,0.3161290322580645,0.9064327485380117,0.19055052442776801,0.9367826550917593
2,24,0,26,0.07692307692307693,1.0,0.13204146591870952,0.9402084858557195
7,74,45,126,0.08641975308641975,0.6428571428571429,0.1333981339420442,0.907045220549597
5,46,1,52,0.09803921568627451,0.9807692307692307,0.1327517215309259,0.9078693963737728
17,175,14,206,0.08854166666666667,0.9320388349514563,0.14540053105473544,0.9083647401423482
29,135,2,166,0.17682926829268292,0.9879518072289156,0.1420904265251187,0.9155721411750505
22,125,3,150,0.14965986394557823,0.98,0.14179169669410904,0.9185785377635366
4,112,2,118,0.034482758620689655,0.9830508474576272,0.10155651474591262,0.9295239804663388
51,164,6,221,0.2372093023255814,0.9728506787330317,0.12445454694627042,0.9256455059996291
14,87,1,102,0.13861386138613863,0.9901960784313726,0.13191084813194454,0.9752653539388048
3,55,1,59,0.05172413793103448,0.9830508474576272,0.12529440845262454,0.9755912991800042
2,29,8,39,0.06451612903225806,0.7948717948717948,0.12186218879056618,0.9559960077400526
25,135,4,164,0.15625,0.975609756097561,0.1189222933201829,0.9542328575784305
22,104,14,140,0.1746031746031746,0.9,0.12248562341412524,0.9428042861498591
37,89,14,140,0.29365079365079366,0.9,0.1595096284184258,0.9309398793701981
18,89,2,109,0.16822429906542055,0.981651376146789,0.14965462795268852,0.9321971218578777
11,55,1,67,0.16666666666666666,0.9850746268656716,0.15366217156419254,0.9314654859199204
7,121,4,132,0.0546875,0.9696969696969697,0.15408550900261617,0.9295577890969693
17,32,1,50,0.3469387755102041,0.98,0.1944316013566085,0.9560046755438558
21,79,1,101,0.21,0.9900990099009901,0.20211017278517993,0.9580745689443457
8,21,1,30,0.27586206896551724,0.9666666666666667,0.2165757291226574,0.9675983784681551
10,84,2,96,0.10638297872340426,0.9791666666666666,0.18982318413303037,0.978907902277679
19,35,1,55,0.35185185185185186,0.9818181818181818,0.2160556916739491,0.9789317316593065
0,4,59,63,0.0,0.06349206349206349,0.19224616786442533,0.8472770797487911
10,188,9,207,0.050505050505050504,0.9565217391304348,0.19164867507943253,0.8453949039535719
52,176,4,232,0.22807017543859648,0.9827586206896551,0.17466744649777427,0.8457889926235226
51,89,12,152,0.36428571428571427,0.9210526315789473,0.1967082628243049,0.8359252242918022
2,56,7,65,0.034482758620689655,0.8923076923076924,0.16222550420361523,0.8253025136690916
34,189,6,229,0.15246636771300448,0.9737991266375546,0.16880884548784386,0.8245357222363613
10,56,1,67,0.15151515151515152,0.9850746268656716,0.14018931686831523,0.8250009286717169
6,8,1,15,0.42857142857142855,0.9333333333333333,0.2014138066642336,0.9492639672204698
22,63,2,87,0.25882352941176473,0.9770114942528736,0.23117358936519278,0.9521910750951038
2,60,3,65,0.03225806451612903,0.9538461538461539,0.20320043066198315,0.9480607226888894
53,62,28,143,0.4608695652173913,0.8041958041958042,0.21699812365222274,0.9313668902055833
198,327,67,592,0.37714285714285717,0.8868243243243243,0.2659495662982467,0.9305835519222451
1,57,1,59,0.017241379310344827,0.9830508474576272,0.24663171081215243,0.9319052263251125
35,69,3,107,0.33653846153846156,0.9719626168224299,0.27306361224405384,0.9300320820332207
2,0,0,2,1.0,1.0,0.35469626530527837,0.9395558915570302
1,15,1,17,0.0625,0.9411764705882353,0.3266500468178834,0.9344366024620819
11,92,2,105,0.10679611650485436,0.9809523809523809,0.3372983399591299,0.9383089206201144
43,101,5,149,0.2986111111111111,0.9664429530201343,0.3141185608010898,0.9614870847378759
25,34,4,63,0.423728813559322,0.9365079365079365,0.3207736974320134,0.968584743621249
6,23,2,31,0.20689655172413793,0.9354838709677419,0.3478672934911267,0.961789461265551
1,21,0,22,0.045454545454545456,1.0,0.31058265666034307,0.962418401638242
42,60,7,109,0.4117647058823529,0.9357798165137615,0.22654904321496486,0.9532440897116364
20,69,2,91,0.2247191011235955,0.978021978021978,0.24972320051833566,0.9585077336307426
32,70,3,105,0.3137254901960784,0.9714285714285714,0.27630404562233474,0.9574022914538718
196,172,14,382,0.532608695652174,0.9633507853403142,0.30617251474911583,0.959159696352638
5,77,13,95,0.06097560975609756,0.8631578947368421,0.25254565380518174,0.9492960541963998
4,28,1,33,0.125,0.9696969696969697,0.24489259258069193,0.9544908593912051
0,12,2,14,0.0,0.8571428571428571,0.23839908608718544,0.9340826961258991
1,9,1,11,0.1,0.9090909090909091,0.193861270961135,0.9302699950654916
35,181,15,231,0.16203703703703703,0.935064935064935,0.18490669037734095,0.9241332746430568
48,92,15,155,0.34285714285714286,0.9032258064516129,0.1890683550432073,0.9143900225034913
2,22,0,24,0.08333333333333333,1.0,0.12488616042623009,0.9196256245977322
5,61,56,122,0.07575757575757576,0.5409836065573771,0.12699786985501268,0.8736007262863801
3,37,8,48,0.075,0.8333333333333334,0.11985501271215555,0.8541202068058604
20,153,17,190,0.11560693641618497,0.9105263157894737,0.1363702893430391,0.8617464151839486
24,111,2,137,0.17777777777777778,0.9854014598540146,0.1474814004541502,0.8726479224358208
18,120,3,141,0.13043478260869565,0.9787234042553191,0.14296679267867288,0.8788848466058757
4,98,2,104,0.0392156862745098,0.9807692307692307,0.09958944173829673,0.8899624786512498
51,164,6,221,0.2372093023255814,0.9728506787330317,0.12157172302290357,0.88608400418454
10,68,1,79,0.1282051282051282,0.9873417721518988,0.12906423051541108,0.9498494564123288
2,49,1,52,0.0392156862745098,0.9807692307692307,0.12395218569748391,0.9709117274745999
4,25,8,37,0.13793103448275862,0.7837837837837838,0.12714134256413728,0.9528056514737869
25,132,4,161,0.1592356687898089,0.9751552795031055,0.1244924698515703,0.9513419114236571
22,96,13,131,0.1864406779661017,0.9007633587786259,0.13249331204548545,0.9402047620698438
36,70,19,125,0.33962264150943394,0.848,0.17540859136476034,0.9212377291028108
15,84,2,101,0.15151515151515152,0.9801980198019802,0.1631665698204132,0.9222873492555177
13,52,1,66,0.2,0.9848484848484849,0.17342298007682347,0.92193116535503
7,108,4,119,0.06086956521739131,0.9663865546218487,0.17651639135437797,0.9198764973339755
16,30,1,47,0.34782608695652173,0.9787234042553191,0.20650139885062985,0.9477250145441948
21,78,1,100,0.21212121212121213,0.99,0.21405647646940174,0.9498456889008938
8,19,1,28,0.2962962962962963,0.9642857142857143,0.22975013623085808,0.9589203111161924
12,64,2,78,0.15789473684210525,0.9743589743589743,0.20378900699266828,0.9769715931674743
19,33,1,53,0.36538461538461536,0.9811320754716981,0.23434178754544885,0.9771050296917198
0,1,59,60,0.0,0.016666666666666666,0.20577035897402027,0.8387933413800315
10,158,13,181,0.05952380952380952,0.9281767955801105,0.20557810816065142,0.8333348043740688
51,144,4,199,0.26153846153846155,0.9798994974874372,0.19325130452949998,0.8335028176929429
50,83,11,144,0.37593984962406013,0.9236111111111112,0.21665396702990683,0.824018690708816
2,55,7,64,0.03508771929824561,0.890625,0.17933845603018533,0.8134957315251424
39,159,6,204,0.19696969696969696,0.9705882352941176,0.18492059319126986,0.8129570545158772
0,2,65,67,0.0,0.029850746268656716,0.13272279099346765,0.6770597217725857
6,8,1,15,0.42857142857142855,0.9333333333333333,0.19394728078938603,0.8080121027249666
23,45,2,70,0.3382352941176471,0.9714285714285714,0.23376320715993423,0.8141909278461752
2,58,3,63,0.03333333333333333,0.9523809523809523,0.20116247455920164,0.8102597071166774
49,62,31,142,0.44144144144144143,0.7816901408450704,0.21051984481882752,0.7899852827929573
198,325,66,589,0.37858508604206503,0.8879456706281834,0.25959089721080175,0.7896025214541263
1,51,1,53,0.019230769230769232,0.9811320754716981,0.23419962181952636,0.7911087843366378
37,50,8,95,0.42528735632183906,0.9157894736842105,0.2949549584369319,0.9176714596817169
2,0,0,2,1.0,1.0,0.3765876114981564,0.9271952692055265
1,15,1,17,0.0625,0.9411764705882353,0.33719685519563536,0.9228735405140499
9,84,2,95,0.0967741935483871,0.9789473684210527,0.34625983522635734,0.9266687428054928
44,92,7,143,0.3235294117647059,0.951048951048951,0.3294152595582523,0.9508628585489044
25,30,4,59,0.45454545454545453,0.9322033898305084,0.3402667407730222,0.9571853898635222
5,23,2,30,0.17857142857142858,0.9333333333333333,0.36302969210740216,0.95035699812947
1,21,0,22,0.045454545454545456,1.0,0.30816758858364285,0.9648360289486365
41,61,7,109,0.4019607843137255,0.9357798165137615,0.2227334149141751,0.955661717022031
21,66,2,89,0.2413793103448276,0.9775280898876404,0.24828760210629333,0.9608548054933745
34,68,3,105,0.3333333333333333,0.9714285714285714,0.2737152488931634,0.9594942612756875
193,177,14,384,0.5216216216216216,0.9635416666666666,0.30327757845549297,0.9600385645674738
4,79,13,96,0.04819277108433735,0.8645833333333334,0.25205087989369124,0.9497636212568165
4,29,1,34,0.12121212121212122,0.9705882352941176,0.24473635533778743,0.9547785304462987
0,12,2,14,0.0,0.8571428571428571,0.23824284884428093,0.9343703671809925
2,9,1,12,0.18181818181818182,0.9166666666666666,0.2067939056306318,0.9316399172028361
24,193,15,232,0.11059907834101383,0.9353448275862069,0.18811101534437272,0.9256137368740598
45,95,15,155,0.32142857142857145,0.9032258064516129,0.18641033507226387,0.9158704847344943
2,22,0,24,0.08333333333333333,1.0,0.12379772245965126,0.9210788180678277
5,61,56,122,0.07575757575757576,0.5409836065573771,0.1277355516986853,0.8748502856712624
4,36,8,48,0.1,0.8333333333333334,0.12470524866838227,0.8552424425340075
21,152,17,190,0.12138728323699421,0.9105263157894737,0.14204628913081002,0.8628686509120956
26,109,2,137,0.1925925925925926,0.9854014598540146,0.14358549067001158,0.8726879070817167
13,124,4,141,0.0948905109489051,0.9716312056737588,0.14134140961399605,0.8778716753799385
4,98,2,104,0.0392156862745098,0.9807692307692307,0.10102528316341579,0.8889493074253124
51,163,7,221,0.2383177570093458,0.9683257918552036,0.12316591511713185,0.8844244205474844
10,68,1,79,0.1282051282051282,0.9873417721518988,0.13065842260963936,0.9481898727752732
4,47,1,52,0.0784313725490196,0.9807692307692307,0.12757719011664215,0.9692521438375443
4,25,8,37,0.13793103448275862,0.7837837837837838,0.12994058315175136,0.9511460678367315
23,133,4,160,0.14743589743589744,0.975,0.1234896267007949,0.9496601450004436
22,95,14,131,0.18803418803418803,0.8931297709923665,0.13679586628440674,0.9384456543316733
34,71,20,125,0.3238095238095238,0.84,0.17745212878940878,0.9183357642217833
17,82,2,101,0.1717171717171717,0.9801980198019802,0.16793775946195533,0.9200317967856085
13,52,1,66,0.2,0.9848484848484849,0.17819416971836557,0.9196756128851208
7,108,4,119,0.06086956521739131,0.9663865546218487,0.17568534009956155,0.9176209448640662
15,31,1,47,0.32608695652173914,0.9787234042553191,0.2025647575337016,0.9454694620742855
22,77,1,100,0.2222222222222222,0.99,0.2132485182174623,0.9476123192171426
7,20,1,28,0.25925925925925924,0.9642857142857143,0.22342352839247243,0.9577774539733351
13,63,2,78,0.17105263157894737,0.9743589743589743,0.20160111521667584,0.9769715931674743
17,35,1,53,0.3269230769230769,0.9811320754716981,0.223773387388948,0.9771050296917198
0,1,59,60,0.0,0.016666666666666666,0.19520195881751942,0.8387933413800315
9,164,9,182,0.05202312138728324,0.9505494505494505,0.193938181127504,0.8365308979411175
48,147,4,199,0.24615384615384617,0.9798994974874372,0.18251916536066215,0.8366989112599914
50,84,11,145,0.373134328358209,0.9241379310344827,0.2040780376658031,0.8272900442649176
2,55,7,64,0.03508771929824561,0.890625,0.1720535319570869,0.8167670850812441
40,158,6,204,0.20202020202020202,0.9705882352941176,0.1764774705915518,0.8162284080719788
1,1,65,67,0.5,0.029850746268656716,0.20120274531682655,0.6803310753286873
6,8,1,15,0.42857142857142855,0.9333333333333333,0.2624272351127449,0.8112834562810682
24,44,2,70,0.35294117647058826,0.9714285714285714,0.3054155286960742,0.8142661878352283
2,58,3,63,0.03333333333333333,0.9523809523809523,0.2750125982931438,0.8103349671057305
51,59,32,142,0.4636363636363636,0.7746478873239436,0.28794146047573727,0.7889792465756535
199,323,67,589,0.38122605363984674,0.8862478777589134,0.3373897939531089,0.7883539433983554
3,49,1,53,0.057692307692307696,0.9811320754716981,0.31677152333483827,0.789860206280867
33,55,8,96,0.375,0.9166666666666666,0.2989143804776954,0.916548194909154
2,0,0,2,1.0,1.0,0.38054703353891994,0.9260720044329636
1,15,1,17,0.0625,0.9411764705882353,0.33905543690026446,0.9217502757414869
12,82,2,96,0.1276595744680851,0.9791666666666666,0.352530614205229,0.9255768063537319
44,92,7,143,0.3235294117647059,0.951048951048951,0.33251533536642075,0.9507769583144473
24,31,4,59,0.43636363636363634,0.9322033898305084,0.34039213289839065,0.9573420314675323
5,23,2,30,0.17857142857142858,0.9333333333333333,0.3576605787382651,0.95051363973348
1,23,0,24,0.041666666666666664,1.0,0.29989039678976903,0.9638772561777831
42,66,9,117,0.3888888888888889,0.9230769230769231,0.21258880948818176,0.9528882451887721
23,84,2,109,0.21495327102803738,0.981651376146789,0.2343678482064728,0.9586703745542797
36,87,3,126,0.2926829268292683,0.9761904761904762,0.25953614427223515,0.9579901024454361
199,207,11,417,0.49014778325123154,0.973621103117506,0.28428562638659616,0.9609330980010532
9,81,13,103,0.1,0.8737864077669902,0.23803865302097876,0.9519728796094894
4,35,1,40,0.10256410256410256,0.975,0.23298623417545644,0.957618040899812
0,12,2,14,0.0,0.8571428571428571,0.22703385322307548,0.9372098776345058
2,13,1,16,0.13333333333333333,0.9375,0.19052591671513897,0.9392703171949454
25,229,15,269,0.0984251968503937,0.9442379182156134,0.1738790489754756,0.9339255374904917
47,108,16,171,0.3032258064516129,0.9064327485380117,0.17538517463581055,0.9239601478258539
2,24,0,26,0.07692307692307693,1.0,0.11635307373178846,0.9277285616662103
5,61,60,126,0.07575757575757576,0.5238095238095238,0.112889870268585,0.8777318639580008
6,38,8,52,0.13636363636363635,0.8461538461538461,0.11771837509708982,0.8593252705514073
21,166,18,205,0.11229946524064172,0.9121951219512195,0.13376115584575293,0.8671898798097448
28,136,2,166,0.17073170731707318,0.9879518072289156,0.1391037807005729,0.8743972808424471
16,131,3,150,0.10884353741496598,0.98,0.1405921150669404,0.879506149668788
3,118,2,123,0.024793388429752067,0.983739837398374,0.10081605534953168,0.8905500195059827
51,163,7,221,0.2383177570093458,0.9683257918552036,0.12387243821899865,0.8860251326281546
14,87,1,102,0.13861386138613863,0.9901960784313726,0.13285190759450763,0.9526517832884186
3,55,1,59,0.05172413793103448,0.9830508474576272,0.12076055067556453,0.9722084977603874
4,27,8,39,0.12903225806451613,0.7948717948717948,0.12315094965040373,0.9554480224633267
25,135,4,164,0.15625,0.975609756097561,0.12108213431939327,0.9536848723017046
22,104,14,140,0.1746031746031746,0.9,0.13047636820342307,0.9422563008731332
34,87,19,140,0.2809917355371901,0.8642857142857143,0.1670761320759142,0.9251914261427532
18,89,2,109,0.16822429906542055,0.981651376146789,0.15706278094106776,0.9270950810415511
11,55,1,67,0.16666666666666666,0.9850746268656716,0.16107032455257175,0.9263634451035939
8,120,4,132,0.0625,0.9696969696969697,0.16260973341956683,0.9244557482806428
17,32,1,50,0.3469387755102041,0.98,0.19373923591180797,0.9509026347275292
19,81,1,101,0.19,0.9900990099009901,0.1985606644832365,0.9529725281280191
9,20,1,30,0.3103448275862069,0.9666666666666667,0.2179523291950983,0.9624963376518286
13,78,5,96,0.14285714285714285,0.9479166666666666,0.19821881595509153,0.9744436165633933
18,35,1,54,0.33962264150943394,0.9814814814814815,0.22270429344709347,0.9744193458969208
0,4,59,63,0.0,0.06349206349206349,0.19889476963756964,0.8427646939864053
12,182,13,207,0.061855670103092786,0.9371980676328503,0.19880272250944003,0.8381219936915311
51,177,4,232,0.2236842105263158,0.9827586206896551,0.18119492751174174,0.838516082361482
51,90,11,152,0.3617021276595745,0.9276315789473685,0.20572380289168093,0.8295921636538217
3,60,2,65,0.047619047619047616,0.9692307692307692,0.1681915486106582,0.8299584640201221
35,188,6,229,0.15695067264573992,0.9737991266375546,0.1702049100090292,0.8336559583016774
0,2,65,67,0.0,0.029850746268656716,0.12168738979339579,0.697708710414131
6,8,1,15,0.42857142857142855,0.9333333333333333,0.18291187958931415,0.8219717489628838
23,62,2,87,0.27058823529411763,0.9770114942528736,0.21273081747374628,0.827659381337173
2,60,3,65,0.03225806451612903,0.9538461538461539,0.1853842251865767,0.8235290289309585
51,58,33,142,0.46788990825688076,0.7676056338028169,0.20055390812904905,0.8006681796245939
196,332,64,592,0.3712121212121212,0.8918918918918919,0.24678149007091668,0.7896197685761829
3,55,1,59,0.05172413793103448,0.9830508474576272,0.23174912796881592,0.7909414429790503
34,66,8,108,0.34,0.9259259259259259,0.2803205565402445,0.9189521829300887
2,0,0,2,1.0,1.0,0.361953209601469,0.9284759924538984
1,15,1,17,0.0625,0.9411764705882353,0.3322263188451665,0.9233567033589499
16,87,2,105,0.1553398058252427,0.9809523809523809,0.3498094247464684,0.9272290215169825
45,98,6,149,0.3146853146853147,0.959731543624161,0.3279230542362447,0.9546755800628889
24,35,4,63,0.4067796610169492,0.9365079365079365,0.3330041313512201,0.9610493007223236
5,24,2,31,0.1724137931034483,0.9354838709677419,0.3502455106615649,0.9542540183666258
1,23,0,24,0.041666666666666664,1.0,0.2981868494141309,0.9648360289486364
42,68,7,117,0.38181818181818183,0.9401709401709402,0.20987516110244256,0.9562890204016279
24,84,2,110,0.2222222222222222,0.9818181818181818,0.2326926214199029,0.9620949791487631
35,88,3,126,0.2845528455284553,0.9761904761904762,0.2580864398518459,0.9614147070399195
200,205,12,417,0.49382716049382713,0.9712230215827338,0.28367813211020476,0.9630563467482871
7,83,13,103,0.07777777777777778,0.8737864077669902,0.23425655556998418,0.9540961283567233
4,35,1,40,0.10256410256410256,0.975,0.2292041367244619,0.959741289647046
0,12,2,14,0.0,0.8571428571428571,0.22325175577208095,0.9393331263817398
2,13,1,16,0.13333333333333333,0.9375,0.18775392027424545,0.9389515635001768
26,228,15,269,0.10236220472440945,0.9442379182156134,0.17063106063170075,0.9335829544140957
45,110,16,171,0.2903225806451613,0.9064327485380117,0.1714553085055159,0.9236175647494579
2,24,0,26,0.07692307692307693,1.0,0.11189758228112302,0.9277285616662102
6,57,63,126,0.09523809523809523,0.5,0.11439191334688266,0.874330503413783
6,45,1,52,0.11764705882352941,0.9807692307692307,0.11654662138394364,0.8751546792379589
22,166,17,205,0.11702127659574468,0.9170731707317074,0.13326394661190716,0.8837161526077946
30,134,2,166,0.18292682926829268,0.9879518072289156,0.14034873174547277,0.8909235536404968
16,130,4,150,0.1095890410958904,0.9733333333333334,0.14138113694139862,0.8950800415144569
2,119,2,123,0.01652892561983471,0.983739837398374,0.10226775765206626,0.9061239113516516
51,163,7,221,0.2383177570093458,0.9683257918552036,0.12532414052153323,0.9015990244738233
14,87,1,102,0.13861386138613863,0.9901960784313726,0.1315206785426823,0.9716270356783052
2,56,1,59,0.034482758620689655,0.9830508474576272,0.1196400642279909,0.9719529809195047
4,27,8,39,0.12903225806451613,0.7948717948717948,0.12135591872352967,0.9544956415109459
24,136,4,164,0.15,0.975609756097561,0.11665208597091645,0.9527324913493237
23,103,14,140,0.18253968253968253,0.9,0.12707360617717248,0.9422563008731332
36,86,18,140,0.29508196721311475,0.8714285714285714,0.16686689783335534,0.9262118343060186
19,88,2,109,0.17757009345794392,0.981651376146789,0.15818866018315506,0.9281154892048165
12,54,1,67,0.18181818181818182,0.9850746268656716,0.16436070595916122,0.9273838532668591
7,121,4,132,0.0546875,0.9696969696969697,0.167247097584777,0.9254761564439081
17,32,1,50,0.3469387755102041,0.98,0.19837660007701816,0.9519230428907947
20,80,1,101,0.2,0.9900990099009901,0.20551945721987527,0.9539929362912843
9,20,1,30,0.3103448275862069,0.9666666666666667,0.22377733508366449,0.9635167458150941
13,81,2,96,0.13829787234042554,0.9791666666666666,0.20137960724470888,0.9789079022776789
19,35,1,55,0.35185185185185186,0.9818181818181818,0.22627700130098144,0.9789317316593066
0,4,59,63,0.0,0.06349206349206349,0.20030297532695546,0.8472770797487911
9,185,13,207,0.04639175257731959,0.9371980676328503,0.19911786855228683,0.8426343794539168
49,178,5,232,0.21585903083700442,0.978448275862069,0.18039219074182974,0.8424127045770696
51,90,11,152,0.3617021276595745,0.9276315789473685,0.2034924946931975,0.8334887858694093
3,60,2,65,0.047619047619047616,0.9692307692307692,0.16596024041217475,0.8338550862357097
37,186,6,229,0.16591928251121077,0.9737991266375546,0.16990615615085836,0.8330882948029794
1,1,65,67,0.5,0.029850746268656716,0.19107017731487952,0.6970929468673329
5,9,1,15,0.35714285714285715,0.9333333333333333,0.24209058547814483,0.8213559854160858
22,63,2,87,0.25882352941176473,0.9770114942528736,0.27243798216877985,0.8270436177903749
2,60,3,65,0.03225806451612903,0.9538461538461539,0.24620927269436907,0.8235290289309585
49,63,31,143,0.4375,0.7832167832167832,0.2570375401715727,0.8028983438265891
198,329,65,592,0.3757115749525617,0.8902027027027027,0.30390790121921757,0.7916086200368654
3,55,1,59,0.05172413793103448,0.9830508474576272,0.28759430913633527,0.792930294439733
35,65,8,108,0.35,0.9259259259259259,0.2661657377077638,0.9209410343907712
2,0,0,2,1.0,1.0,0.35800247240164135,0.9304648439145807
1,15,1,17,0.0625,0.9411764705882353,0.3299562539142464,0.9253455548196324
12,91,2,105,0.11650485436893204,0.9809523809523809,0.34199150960750396,0.9292178729776649
45,97,7,149,0.31690140845070425,0.9530201342281879,0.324763139386176,0.9534754945507228
25,34,4,63,0.423728813559322,0.9365079365079365,0.3316227449014275,0.9600905279514703
4,25,2,31,0.13793103448275862,0.9354838709677419,0.34393801583738803,0.9532952455957725
1,23,0,24,0.041666666666666664,1.0,0.3072095039334682,0.9638772561777831
41,68,8,117,0.3761467889908257,0.9316239316239316,0.21808761664644333,0.9541092464097733
19,90,2,111,0.1743119266055046,0.9819819819819819,0.23406074901865828,0.9599386051803085
33,90,3,126,0.2682926829268293,0.9761904761904762,0.25435776197491816,0.959258333071465
195,210,12,417,0.48148148148148145,0.9712230215827338,0.2768631647620111,0.9618587455506858
7,83,13,103,0.07777777777777778,0.8737864077669902,0.22744158822179053,0.952898527159122
4,35,1,40,0.10256410256410256,0.975,0.21746306100188398,0.9585436884494447
0,12,2,14,0.0,0.8571428571428571,0.21151068004950305,0.9381355251841386
2,13,1,16,0.13333333333333333,0.9375,0.17682304352700412,0.9389749635235768
25,229,15,269,0.0984251968503937,0.9442379182156134,0.16598208213341686,0.9335829544140957
46,109,16,171,0.2967741935483871,0.9064327485380117,0.17005086936506794,0.9236175647494579
2,24,0,26,0.07692307692307693,1.0,0.11225681157101018,0.9277285616662103
4,66,56,126,0.05714285714285714,0.5555555555555556,0.10930896576602149,0.8822670113502911
6,38,8,52,0.13636363636363635,0.8461538461538461,0.11413747059452632,0.8638604179436975
22,168,15,205,0.11578947368421053,0.926829268292683,0.13067882397798497,0.8738156195365299
32,132,2,166,0.1951219512195122,0.9879518072289156,0.1395057693902962,0.8810230205692321
20,127,3,150,0.1360544217687075,0.98,0.14488137295005535,0.8861318893955731
4,117,2,123,0.03305785123966942,0.983739837398374,0.1072076097630957,0.8971757592327677
52,162,7,221,0.24299065420560748,0.9683257918552036,0.13093154937488577,0.8926508723549395
14,87,1,102,0.13861386138613863,0.9901960784313726,0.14257026426678313,0.9547423756229134
3,55,1,59,0.05172413793103448,0.9830508474576272,0.13047890734784,0.9742990900948821
2,29,8,39,0.06451612903225806,0.7948717948717948,0.12315414382613252,0.9554480224633267
24,136,4,164,0.15,0.975609756097561,0.11670815079477362,0.9536848723017046
22,104,14,140,0.1746031746031746,0.9,0.12221511548541178,0.9422563008731332
34,87,19,140,0.2809917355371901,0.8642857142857143,0.157634241813629,0.9251914261427532
17,90,2,109,0.1588785046728972,0.981651376146789,0.14561822045181325,0.9270950810415511
12,54,1,67,0.18181818181818182,0.9850746268656716,0.15179026622781944,0.9263634451035939
6,122,4,132,0.046875,0.9696969696969697,0.15109753223767167,0.9244557482806428
17,32,1,50,0.3469387755102041,0.98,0.19144362459166395,0.9509026347275292
21,79,1,101,0.21,0.9900990099009901,0.20001505316309248,0.9529725281280191
9,20,1,30,0.3103448275862069,0.9666666666666667,0.2194067178749543,0.9624963376518286
11,83,2,96,0.11702127659574468,0.9791666666666666,0.19598236659760496,0.978907902277679
21,33,1,55,0.3888888888888889,0.9818181818181818,0.22884099291417517,0.9789317316593065
0,4,59,63,0.0,0.06349206349206349,0.2028669669401492,0.8472770797487911
10,188,9,207,0.050505050505050504,0.9565217391304348,0.20338554558372784,0.8453949039535719
49,179,4,232,0.2149122807017544,0.9827586206896551,0.1845246177539493,0.8457889926235226
49,91,12,152,0.35,0.9210526315789473,0.2045246177539493,0.8359252242918022
3,55,7,65,0.05172413793103448,0.8923076923076924,0.16757880494606753,0.8253025136690916
40,183,6,229,0.17937219730941703,0.9737991266375546,0.176486079333735,0.8245357222363613
0,3,64,67,0.0,0.04477611940298507,0.12093052377817946,0.6906725704627618
5,9,1,15,0.35714285714285715,0.9333333333333333,0.17195093194144473,0.8149356090115145
23,62,2,87,0.27058823529411763,0.9770114942528736,0.2033913869113115,0.8178627168861486
3,59,3,65,0.04838709677419355,0.9538461538461539,0.17960207492165994,0.8137323644799342
52,61,30,143,0.46017699115044247,0.7902097902097902,0.19534164508600887,0.795040529998626
200,324,67,591,0.3816793893129771,0.8866328257191202,0.24247810956914354,0.7942298347716872
3,55,1,59,0.05172413793103448,0.9830508474576272,0.22424267251508886,0.7955515091745546
34,66,8,108,0.34,0.9259259259259259,0.27281410108651744,0.9214300529635462
2,0,0,2,1.0,1.0,0.364650835780395,0.9309538624873557
1,15,1,17,0.0625,0.9411764705882353,0.3349239450240925,0.9258345733924074
11,92,2,105,0.10679611650485436,0.9809523809523809,0.34326809069990116,0.9297068915504398
45,98,6,149,0.3146853146853147,0.959731543624161,0.3224835654905972,0.9539242848953499
25,34,4,63,0.423728813559322,0.9365079365079365,0.3284906260972179,0.9610493007223236
4,25,2,31,0.13793103448275862,0.9354838709677419,0.3408058970331785,0.9542540183666258
1,23,0,24,0.041666666666666664,1.0,0.2983364238069948,0.9648098646367578
41,67,9,117,0.37962962962962965,0.9230769230769231,0.2097120851826562,0.9538208536477468
17,92,2,111,0.1559633027522936,0.9819819819819819,0.22306398557584098,0.959650212418282
35,88,3,126,0.2845528455284553,0.9761904761904762,0.24830822961492002,0.9589961046213171
202,204,11,417,0.4975369458128079,0.973621103117506,0.2744298912045619,0.9609803274060807
5,85,13,103,0.05555555555555555,0.8737864077669902,0.22183371148973816,0.9520201090145168
4,35,1,40,0.10256410256410256,0.975,0.21678129264421586,0.9576652703048395
0,12,2,14,0.0,0.8571428571428571,0.2108289116918349,0.9372571070395334
3,12,1,16,0.2,0.9375,0.18516753603045924,0.939317546599973
27,227,15,269,0.1062992125984252,0.9442379182156134,0.17807266600847801,0.9339255374904918
48,107,16,171,0.3096774193548387,0.9064327485380117,0.18166189084081852,0.9239601478258539
3,23,0,26,0.11538461538461539,1.0,0.12706870077964819,0.9277285616662103
7,67,52,126,0.0945945945945946,0.5873015873015873,0.13264570635665376,0.8868021587425813
6,45,1,52,0.11764705882352941,0.9807692307692307,0.13480041439371473,0.8876263345667571
23,167,15,205,0.12105263157894737,0.926829268292683,0.15209364747642148,0.8975815361595894
28,136,2,166,0.17073170731707318,0.9879518072289156,0.14791246280743195,0.9047889371922916
16,131,3,150,0.10884353741496598,0.98,0.1482759377812235,0.9098978060186325
4,117,2,123,0.03305785123966942,0.983739837398374,0.10875885662191358,0.9209416758558272
49,164,8,221,0.2300469483568075,0.9638009049773756,0.12513918990365533,0.9157703765668808
14,87,1,102,0.13861386138613863,0.9901960784313726,0.1314276565881616,0.9733267324425644
2,56,1,59,0.034482758620689655,0.9830508474576272,0.11954704227347022,0.9736526776837638
5,26,8,39,0.16129032258064516,0.7948717948717948,0.12529528384514133,0.9548016100522084
23,136,4,163,0.14465408805031446,0.9754601226993865,0.1215699096641758,0.9530170836908471
22,117,1,140,0.15827338129496402,0.9928571428571429,0.12863131593274696,0.9548538183847246
34,88,18,140,0.2786885245901639,0.8714285714285714,0.16372141212567473,0.9388093518176099
18,89,2,109,0.16822429906542055,0.981651376146789,0.15488960508404803,0.9413594191275262
12,54,1,67,0.18181818181818182,0.9850746268656716,0.1610616508600542,0.940627783189569
6,122,4,132,0.046875,0.9696969696969697,0.16283197105709854,0.9387200863666179
17,32,1,50,0.3469387755102041,0.98,0.1893531786184641,0.9651669728135043
21,79,1,101,0.21,0.9900990099009901,0.1986883088969906,0.9672582424137334
8,21,1,30,0.27586206896551724,0.9666666666666667,0.2154866928499268,0.9635167458150938
10,84,2,96,0.10638297872340426,0.9791666666666666,0.1908716148689611,0.978907902277679
19,35,1,55,0.35185185185185186,0.9818181818181818,0.21710412240987984,0.9789317316593065
19,42,2,63,0.3114754098360656,0.9682539682539683,0.2356265835552918,0.9765287804290631
8,190,9,207,0.04040404040404041,0.9565217391304348,0.23470216075586903,0.9746466046338439
49,179,4,232,0.2149122807017544,0.9827586206896551,0.2158412329260905,0.9750406933037947
51,90,11,152,0.3617021276595745,0.9276315789473685,0.23751296544888684,0.9661167745961344
3,55,7,65,0.05172413793103448,0.8923076923076924,0.2054932610153893,0.9554940639734238
36,187,6,229,0.16143497757847533,0.9737991266375546,0.21335783228039948,0.9547272725406935
0,3,64,67,0.0,0.04477611940298507,0.16309328201584922,0.820864120767094
4,10,1,15,0.2857142857142857,0.9333333333333333,0.15941312142702352,0.8158754586355748
25,60,2,87,0.29411764705882354,0.9770114942528736,0.19565792237770682,0.8188025665102089
2,60,3,65,0.03225806451612903,0.9538461538461539,0.16956446292261748,0.8146722141039943
50,63,30,143,0.4424778761061947,0.7902097902097902,0.18110385555784894,0.795040529998626
200,321,70,591,0.3838771593090211,0.8815566835871405,0.2285542871832756,0.7935046716099757
2,56,1,59,0.034482758620689655,0.9830508474576272,0.21041825590359192,0.7948263460128432
34,66,8,108,0.34,0.9259259259259259,0.2589896844750205,0.9207048898018348
2,0,0,2,1.0,1.0,0.36103050080155114,0.9302286993256443
1,15,1,17,0.0625,0.9411764705882353,0.3279422655074335,0.9251094102306959
13,90,2,105,0.1262135922330097,0.9809523809523809,0.3413644837527022,0.9289817283887284
46,96,7,149,0.323943661971831,0.9530201342281879,0.32443102459065015,0.9522403489627853
25,34,4,63,0.423728813559322,0.9365079365079365,0.3301241180549789,0.9600905279514704
5,24,2,31,0.1724137931034483,0.9354838709677419,0.3498285515525158,0.9532952455957726
1,23,0,24,0.041666666666666664,1.0,0.3084014104175394,0.965411826342193
41,69,7,117,0.37272727272727274,0.9401709401709402,0.21879102080714977,0.9568648177951845
16,93,2,111,0.14678899082568808,0.9819819819819819,0.23083230521081952,0.9626941765657197
37,85,3,125,0.30327868852459017,0.976,0.2572607507296934,0.9622731239341408
199,206,11,416,0.49135802469135803,0.9735576923076923,0.2815363869100915,0.9624639053749222
5,84,13,102,0.056179775280898875,0.8725490196078431,0.2272244067554147,0.95394185248597
5,33,1,39,0.13157894736842105,0.9743589743589743,0.22051119515498505,0.9598026583467758
0,13,1,14,0.0,0.9285714285714286,0.2145588142026041,0.9495985767141227
3,12,1,16,0.2,0.9375,0.1898834895272794,0.94921701383256
26,227,15,268,0.10276679841897234,0.9440298507462687,0.1835946048977486,0.9437952807988866
48,106,16,170,0.3116883116883117,0.9058823529411765,0.18479597963542307,0.9337784740761975
3,23,0,26,0.11538461538461539,1.0,0.1310854925916027,0.93755594660367
6,77,43,126,0.07228915662650602,0.6587301587301587,0.13338683278383232,0.9070103950497151
6,45,1,52,0.11764705882352941,0.9807692307692307,0.13139656299170493,0.9079261459654661
25,165,15,205,0.13157894736842105,0.926829268292683,0.15019355547290794,0.9076772659256452
29,135,2,166,0.17682926829268292,0.9879518072289156,0.14688345094329122,0.9148846669583474
17,130,3,150,0.11564625850340136,0.98,0.14872337381249537,0.9200232597088805
4,117,2,123,0.03305785123966942,0.983739837398374,0.10891902231983216,0.93114575748848
49,165,7,221,0.22897196261682243,0.9683257918552036,0.12514578621014746,0.926620870610652
13,88,1,102,0.12871287128712872,0.9901960784313726,0.13320631687595072,0.9739731448536827
2,56,1,59,0.034482758620689655,0.9830508474576272,0.12132570256125931,0.9742990900948821
1,30,8,39,0.03225806451612903,0.7948717948717948,0.10713700501093189,0.9554480224633267
24,134,4,162,0.1518987341772152,0.9753086419753086,0.10357550013729364,0.9536418559985257
21,106,13,140,0.16535433070866143,0.9071428571428571,0.11067665330947365,0.9432336927332196
35,86,19,140,0.2892561983471074,0.8642857142857143,0.14727641718196477,0.9261688180028396
19,88,2,109,0.17757009345794392,0.981651376146789,0.13993329301641072,0.9280724729016375
12,54,1,67,0.18181818181818182,0.9850746268656716,0.14751976594941832,0.9273408369636803
9,119,4,132,0.0703125,0.9696969696969697,0.15263830043217694,0.9254331401407292
17,32,1,50,0.3469387755102041,0.98,0.1975926877170448,0.9518800265876157
22,78,1,101,0.22,0.9900990099009901,0.20732143997744262,0.9539929362912846
7,22,1,30,0.2413793103448276,0.9666666666666667,0.2181821513540378,0.9624963376518286
11,83,2,96,0.11702127659574468,0.9791666666666666,0.19357716253241453,0.978907902277679
18,36,1,55,0.3333333333333333,0.9818181818181818,0.21582905394318447,0.9789317316593065
20,41,2,63,0.32786885245901637,0.9682539682539683,0.23669343546330368,0.9765287804290631
8,189,9,206,0.04060913705583756,0.9563106796116505,0.23245009789985188,0.9746164532740176
50,178,4,232,0.21929824561403508,0.9827586206896551,0.21421573648611344,0.9750105419439683
48,94,10,152,0.3380281690140845,0.9342105263157895,0.2310769034881255,0.9670264728603682
2,61,2,65,0.031746031746031744,0.9692307692307692,0.20112929225972612,0.9673927732266687
37,186,6,229,0.16591928251121077,0.9737991266375546,0.2081147216762213,0.9666259817939383
11,50,6,67,0.18032786885245902,0.9104477611940298,0.18625679817895355,0.9564302074190595
4,10,1,15,0.2857142857142857,0.9333333333333333,0.1802347172154206,0.9514415452875402
24,61,2,87,0.2823529411764706,0.9770114942528736,0.21476954637551102,0.9543988045220007
2,60,3,65,0.03225806451612903,0.9538461538461539,0.18804952050438156,0.9502684521157863
51,65,27,143,0.4396551724137931,0.8111888111888111,0.2025676638471971,0.9326939213833606
198,388,5,591,0.3378839590443686,0.9915397631133672,0.2463016534612452,0.9358809205094462
2,56,1,59,0.034482758620689655,0.9830508474576272,0.22752500719117075,0.9372025949123136
31,69,8,108,0.31,0.9259259259259259,0.24604959735510518,0.9394137613025845
2,0,0,2,1.0,1.0,0.3480904136816358,0.9489375708263941
1,15,1,17,0.0625,0.9411764705882353,0.31668285065642576,0.9438182817314457
11,91,2,104,0.10784313725490197,0.9807692307692307,0.3274807181905362,0.9476644355775995
45,98,6,149,0.3146853146853147,0.959731543624161,0.3096278813721821,0.9688848259255066
25,34,4,63,0.423728813559322,0.9365079365079365,0.3218914320171754,0.9610231364104452
4,25,2,31,0.13793103448275862,0.9354838709677419,0.33666975714032815,0.9542278540547472
1,21,0,22,0.045454545454545456,1.0,0.3133728297749615,0.9644197628501295
43,57,9,109,0.43,0.9174311926605505,0.23194425834639004,0.9526242189444939
18,72,2,92,0.2,0.9782608695652174,0.2515871154892472,0.9579219902269199
36,65,3,104,0.3564356435643564,0.9711538461538461,0.28253721510750396,0.9568086299030333
196,170,11,377,0.5355191256830601,0.9708222811671088,0.31176348280528954,0.9576007018157949
3,78,14,95,0.037037037037037035,0.8526315789473684,0.25471682575863247,0.9462333002610606
6,26,1,33,0.1875,0.9696969696969697,0.25599233596271415,0.9514281054558656
0,12,2,14,0.0,0.8571428571428571,0.24949882946920762,0.9310199421905595
1,8,1,10,0.1111111111111111,0.9,0.2039432739136521,0.9285297718104809
23,196,11,230,0.1050228310502283,0.9521739130434783,0.1903751069208275,0.9248030637359468
47,94,15,156,0.3333333333333333,0.9038461538461539,0.18707477688782426,0.9151876791205622
3,21,0,24,0.125,1.0,0.12842918750452995,0.9193559246681181
6,59,57,122,0.09230769230769231,0.5327868852459017,0.13632499540033785,0.8736638255679086
4,43,1,48,0.0851063829787234,0.9791666666666666,0.12169733582586974,0.8750166394207224
17,155,16,188,0.09883720930232558,0.9148936170212766,0.13581693715477341,0.8832667479747823
24,111,2,137,0.17777777777777778,0.9854014598540146,0.14534074667858293,0.8954669565253558
17,121,3,141,0.12318840579710146,0.9787234042553191,0.14793582878527908,0.8992597409841903
4,98,2,104,0.0392156862745098,0.9807692307692307,0.10591902206259,0.9102487519732012
48,165,8,221,0.22535211267605634,0.9638009049773756,0.12025503815916949,0.9050774526842549
9,69,1,79,0.11538461538461539,0.9873417721518988,0.12355174145587279,0.9700138650993974
4,47,1,52,0.0784313725490196,0.9807692307692307,0.12259816853734366,0.9702428028283351
3,26,8,37,0.10344827586206896,0.7837837837837838,0.12325689233159273,0.9515128266515503
24,130,4,158,0.15584415584415584,0.9746835443037974,0.12012351776964673,0.9499816958586622
22,96,13,131,0.1864406779661017,0.9007633587786259,0.12915955665093248,0.9388445465048488
31,75,19,125,0.29245283018867924,0.848,0.16533629149581383,0.9198775135378158
15,84,2,101,0.15151515151515152,0.9801980198019802,0.15478815418711317,0.9222199585127593
12,53,1,66,0.18461538461538463,0.9848484848484849,0.16467826407722305,0.9218637746122716
6,108,5,119,0.05263157894736842,0.957983193277311,0.16099257927698715,0.9186086263991403
16,30,1,47,0.34782608695652173,0.9787234042553191,0.19590369514762326,0.9464571436093596
21,78,1,100,0.21212121212121213,0.99,0.20394327461577416,0.9486452087088172
7,20,1,28,0.25925925925925924,0.9642857142857143,0.21434592908622527,0.9577198309241155
9,67,2,78,0.11842105263157894,0.9743589743589743,0.18948424657806803,0.9757711129753976
19,34,1,54,0.3584905660377358,0.9814814814814815,0.21905216293843724,0.9759544646438977
20,38,2,60,0.3448275862068966,0.9666666666666667,0.24193962030865324,0.9733570620464951
9,162,9,180,0.05263157894736842,0.95,0.24193962030865324,0.9722166058640221
48,148,4,200,0.24489795918367346,0.98,0.2272356020553892,0.9723989766846908
48,85,12,145,0.3609022556390977,0.9172413793103448,0.24849003684365853,0.9620048880147402
3,53,7,63,0.05357142857142857,0.8888888888888888,0.21910606103111133,0.9512339129580507
36,163,6,205,0.18090452261306533,0.9707317073170731,0.22803227102846654,0.9507157319520648
0,3,64,67,0.0,0.04477611940298507,0.1768193330230757,0.8169006802265654
5,9,1,15,0.35714285714285715,0.9333333333333333,0.17857865744249862,0.8121387754646606
24,44,2,70,0.35294117647058826,0.9714285714285714,0.22148002851724433,0.8151999999544566
2,58,3,63,0.03333333333333333,0.9523809523809523,0.1912565105386243,0.811254421723164
52,60,31,143,0.4642857142857143,0.7832167832167832,0.20602557605956953,0.7921080508526551
192,391,5,588,0.3293310463121784,0.9914965986394558,0.24541980716539094,0.8067662951027362
2,50,1,53,0.038461538461538464,0.9811320754716981,0.22507080942945853,0.8082520619819684
33,56,8,97,0.3707865168539326,0.9175257731958762,0.27804031183716316,0.9329305839523814
2,0,0,2,1.0,1.0,0.3698770465310407,0.9424543934761909
1,15,1,17,0.0625,0.9411764705882353,0.3283854498923852,0.9381326647847142
11,82,2,95,0.11827956989247312,0.9789473684210527,0.3405206265436909,0.9419278670761572
45,95,4,144,0.32142857142857145,0.9722222222222222,0.32011246327838483,0.9689286440769341
24,31,4,59,0.43636363636363634,0.9322033898305084,0.335402833285736,0.9604581856756561
5,23,2,30,0.17857142857142858,0.9333333333333333,0.35541853187286315,0.953629793941604
1,21,0,22,0.045454545454545456,1.0,0.30231121331662897,0.9638772561777831
41,61,7,109,0.4019607843137255,0.9357798165137615,0.21687703964716118,0.9547029442511776
18,71,2,91,0.20224719101123595,0.978021978021978,0.23684092407733776,0.9599665881702837
37,64,3,104,0.36633663366336633,0.9711538461538461,0.27114421571024583,0.9585667974847787
193,174,12,379,0.5258855585831063,0.9683377308707124,0.3030111667351966,0.960755025576568
3,78,14,95,0.037037037037037035,0.8526315789473684,0.25019079188092347,0.9487726887822011
6,26,1,33,0.1875,0.9696969696969697,0.2523459642947166,0.9536602743149479
0,12,2,14,0.0,0.8571428571428571,0.2458524578012101,0.9332521110496418
1,8,1,10,0.1111111111111111,0.9,0.2043025044865509,0.928140708690533
23,196,11,230,0.1050228310502283,0.9521739130434783,0.19041331020640695,0.9244481279793187
47,94,15,156,0.3333333333333333,0.9038461538461539,0.18569855301640223,0.9148327433639342
2,22,0,24,0.08333333333333333,1.0,0.12247680655214897,0.9193559246681181
5,63,54,122,0.07352941176470588,0.5573770491803278,0.12769000294181596,0.8771767061299693
5,42,1,48,0.10638297872340426,0.9791666666666666,0.11610185704515942,0.8785295199827833
14,161,16,191,0.08,0.9162303664921466,0.12753042847373083,0.8869705927469675
29,106,2,137,0.21481481481481482,0.9854014598540146,0.14234524328854564,0.8991708012975409
16,122,3,141,0.11594202898550725,0.9787234042553191,0.14390512870787123,0.9029635857563754
2,101,2,105,0.019417475728155338,0.9809523809523809,0.0990600061928458,0.913978761057265
50,163,8,221,0.2347417840375587,0.9638009049773756,0.12068978486487798,0.9088074617683187
9,69,1,79,0.11538461538461539,0.9873417721518988,0.1266690996677222,0.9702309936214002
3,48,1,52,0.058823529411764705,0.9807692307692307,0.11987489262320226,0.9704599313503379
3,26,8,37,0.10344827586206896,0.7837837837837838,0.12322464631778354,0.9515389909634289
25,128,4,157,0.16339869281045752,0.9745222929936306,0.1158794860314468,0.9499848242690883
24,94,13,131,0.2033898305084746,0.9007633587786259,0.1283720291061564,0.938847674915275
31,77,18,126,0.28703703703703703,0.8571428571428571,0.16660339500742521,0.9211606000853431
17,82,2,101,0.1717171717171717,0.9801980198019802,0.15759987896165567,0.9235030450602866
12,53,1,66,0.18461538461538463,0.9848484848484849,0.16748998885176555,0.9231468611597988
5,109,5,119,0.043859649122807015,0.957983193277311,0.16535229166762871,0.9198917129466675
15,31,1,47,0.32608695652173914,0.9787234042553191,0.19715781747615305,0.9477402301568869
22,77,1,100,0.2222222222222222,0.99,0.20556117882069083,0.9499513311577967
6,21,1,28,0.2222222222222222,0.9642857142857143,0.20825152049408338,0.959025953373095
10,66,2,78,0.13157894736842105,0.9743589743589743,0.18604322196999537,0.9757711129753975
19,34,1,54,0.3584905660377358,0.9814814814814815,0.21272513544436172,0.9759544646438977
21,37,2,60,0.3620689655172414,0.9666666666666667,0.23807564700176978,0.9733570620464952
8,163,9,180,0.04678362573099415,0.95,0.23849335794579654,0.9722166058640221
49,148,4,201,0.24873096446700507,0.9800995024875622,0.22744250193797738,0.9724131913257711
46,87,11,144,0.3458646616541353,0.9236111111111112,0.2451057075711078,0.9629290643416442
2,54,7,63,0.03571428571428571,0.8888888888888888,0.2184617166414026,0.9521580892849549
32,168,6,206,0.16,0.970873786407767,0.22252186701734247,0.9516602052919252
0,2,65,67,0.0,0.029850746268656716,0.1713089290119516,0.8157129574043788
6,8,1,15,0.42857142857142855,0.9333333333333333,0.1808092808768355,0.810951052642474
18,50,2,70,0.2647058823529412,0.9714285714285714,0.21194103182282792,0.81401227713227
2,58,3,63,0.03333333333333333,0.9523809523809523,0.18116994166087483,0.8100524842598971
52,59,31,142,0.46846846846846846,0.7816901408450704,0.19868477120577957,0.789778059936177
195,388,5,588,0.3344768439108062,0.9914965986394558,0.24136513666242534,0.804436304186258
2,50,1,53,0.038461538461538464,0.9811320754716981,0.22400249929978797,0.8059017740525339
32,56,8,96,0.36363636363636365,0.9166666666666666,0.2759505512478399,0.9325897626808209
2,0,0,2,1.0,1.0,0.3575832043090644,0.9421135722046304
1,15,1,17,0.0625,0.9411764705882353,0.3286966496872156,0.937791843513154
13,80,2,95,0.13978494623655913,0.9789473684210527,0.3439040229591051,0.9415870458045968
46,93,5,144,0.33093525179856115,0.9652777777777778,0.3242564205776897,0.967813851080698
24,31,4,59,0.43636363636363634,0.9322033898305084,0.33881167664237977,0.9593433926794198
5,23,2,30,0.17857142857142858,0.9333333333333333,0.3588273752295069,0.9525150009453676
1,23,0,24,0.041666666666666664,1.0,0.30170310182066407,0.9629184834069298
43,68,6,117,0.38738738738738737,0.9487179487179487,0.21418701430457654,0.9555924760809225
20,89,2,111,0.1834862385321101,0.9819819819819819,0.23147076266630656,0.9614218348514577
34,89,3,126,0.2764227642276423,0.9761904761904762,0.25431617836040804,0.960741562742614
195,212,12,419,0.47911547911547914,0.9713603818615751,0.2781817128642404,0.9643203708896656
3,88,13,104,0.03296703296703297,0.875,0.22477990885710955,0.9555335228171032
6,33,1,40,0.15384615384615385,0.975,0.2221273889632103,0.9611786841074259
0,12,2,14,0.0,0.8571428571428571,0.21617500801082937,0.9407705208421197
3,12,1,16,0.2,0.9375,0.1894053812412026,0.9391679567395556
24,231,11,266,0.09411764705882353,0.9586466165413534,0.17663843960216166,0.9358343331051803
45,110,16,171,0.2903225806451613,0.9064327485380117,0.1786241276618072,0.9258689434405424
2,24,0,26,0.07692307692307693,1.0,0.12116807020574975,0.9299603174603173
6,62,58,126,0.08823529411764706,0.5396825396825397,0.12906353608440893,0.8820578231292515
7,44,1,52,0.13725490196078433,0.9807692307692307,0.12669335724364186,0.8828819989534274
17,173,17,207,0.08947368421052632,0.9178743961352657,0.1394753121308599,0.8915579330952
29,135,2,166,0.17682926829268292,0.9879518072289156,0.13616520760124318,0.8987653341279023
13,133,4,150,0.08904109589041095,0.9733333333333334,0.13543998600575566,0.9008634365267565
2,119,2,123,0.01652892561983471,0.983739837398374,0.09632660671642328,0.9119073063639511
49,164,8,221,0.2300469483568075,0.9638009049773756,0.1182014454926705,0.9067360070750048
13,87,1,101,0.13,0.9900990099009901,0.12416783204729236,0.971081217106212
2,56,1,59,0.034482758620689655,0.9830508474576272,0.1094860972844217,0.9714071623474114
3,28,8,39,0.0967741935483871,0.7948717948717948,0.11052902718983036,0.9538353621669157
25,133,4,162,0.15822784810126583,0.9753086419753086,0.10787168144819936,0.9520291957021146
22,105,13,140,0.1732283464566929,0.9071428571428571,0.11989843152909678,0.9425734133891895
31,90,19,140,0.256198347107438,0.8642857142857143,0.1541369203130401,0.9255085386588097
16,90,2,108,0.1509433962264151,0.9814814814814815,0.1428364128658412,0.9280343353022532
14,52,1,67,0.21212121212121213,0.9850746268656716,0.15456801459744293,0.9273165662972078
5,123,4,132,0.0390625,0.9696969696969697,0.1552222633659158,0.9254088694742568
18,31,1,50,0.3673469387755102,0.98,0.1938755126840763,0.9518557559211432
20,80,1,101,0.2,0.9900990099009901,0.199842962955324,0.953968665624812
5,24,1,30,0.1724137931034483,0.9666666666666667,0.19972659819057478,0.9624720669853561
11,83,2,96,0.11702127659574468,0.9791666666666666,0.17984415954604718,0.9788836316112065
20,34,1,55,0.37037037037037035,0.9818181818181818,0.21119087013804075,0.9789317316593066
21,40,2,63,0.3442622950819672,0.9682539682539683,0.23006816770386296,0.9765287804290631
11,186,9,206,0.05583756345177665,0.9563106796116505,0.23246460533983107,0.9746164532740177
53,175,4,232,0.2324561403508772,0.9827586206896551,0.21319449127916917,0.9750105419439683
47,92,12,151,0.3381294964028777,0.9205298013245033,0.23292727647958025,0.9650720835758987
2,61,2,65,0.031746031746031744,0.9692307692307692,0.21283188199994935,0.965438383942199
37,187,6,230,0.16517857142857142,0.9739130434782609,0.219711495547496,0.9646878663438556
0,2,65,67,0.0,0.029850746268656716,0.16680144263744312,0.828692518408209
6,8,1,15,0.42857142857142855,0.9333333333333333,0.178845604564509,0.8237038562766897
18,67,2,87,0.21176470588235294,0.9770114942528736,0.2011209106260199,0.8266611155111502
1,61,3,65,0.016129032258064516,0.9538461538461539,0.17021703804133237,0.8225307631049358
49,62,31,142,0.44144144144144143,0.7816901408450704,0.18497588733255577,0.8026965258935882
193,393,5,591,0.3293515358361775,0.9915397631133672,0.22749095934543373,0.8058835250196736
3,55,1,59,0.05172413793103448,0.9830508474576272,0.21128318313149988,0.8071889255881545
34,67,7,108,0.33663366336633666,0.9351851851851852,0.25937370646954794,0.9365224168619443
2,0,0,2,1.0,1.0,0.34100635953077246,0.9460462263857538
1,15,1,17,0.0625,0.9411764705882353,0.3196828301190077,0.9409269372908055
13,90,2,105,0.1262135922330097,0.9809523809523809,0.3354091958297142,0.9447992554488379
43,99,7,149,0.3028169014084507,0.9530201342281879,0.31560569011071554,0.9692749687892832
24,35,4,63,0.4067796610169492,0.9365079365079365,0.32666685085082575,0.9614132792742217
5,24,2,31,0.1724137931034483,0.9354838709677419,0.3439082301611706,0.9546179969185238
1,23,0,24,0.041666666666666664,1.0,0.3049775306482336,0.9657948017194897
43,67,7,117,0.39090909090909093,0.9401709401709402,0.21796454363524662,0.9572477931724812
21,88,2,111,0.1926605504587156,0.9819819819819819,0.23655890798649168,0.9630771519430165
37,86,3,126,0.3008130081300813,0.9761904761904762,0.26011471913406226,0.9623968798341729
191,216,12,419,0.4692874692874693,0.9713603818615751,0.28449705601639913,0.9630993696686644
5,86,13,104,0.054945054945054944,0.875,0.2318136619286467,0.954312521596102
6,33,1,40,0.15384615384615385,0.975,0.22916114203474747,0.9599576828864247
0,12,2,14,0.0,0.8571428571428571,0.22320876108236654,0.9395495196211184
3,12,1,16,0.2,0.9375,0.19593603380963923,0.9391679567395557
25,232,11,268,0.09727626459143969,0.9589552238805971,0.18230970725717127,0.9358784198679293
44,111,16,171,0.2838709677419355,0.9064327485380117,0.17988941577315046,0.9259130302032915
2,24,0,26,0.07692307692307693,1.0,0.12383735972109437,0.9300044042230665
4,62,60,126,0.06060606060606061,0.5238095238095238,0.12464607481552378,0.8798343361958556
7,44,1,52,0.13725490196078433,0.9807692307692307,0.1222758959747567,0.8806585120200314
18,172,17,207,0.09473684210526316,0.9178743961352657,0.13580973056122286,0.889334446161804
29,135,2,166,0.17682926829268292,0.9879518072289156,0.13249962603160612,0.8965418471945062
16,131,3,150,0.10884353741496598,0.98,0.13415209357782418,0.8995482437829924
3,118,2,123,0.024793388429752067,0.983739837398374,0.09714101081894082,0.910592113620187
49,164,8,221,0.2300469483568075,0.9638009049773756,0.11901584959518804,0.9054208143312407
13,87,1,101,0.13,0.9900990099009901,0.12892926950860797,0.9720335980585929
3,55,1,59,0.05172413793103448,0.9830508474576272,0.11671058893292942,0.9723595432997925
2,29,8,39,0.06451612903225806,0.7948717948717948,0.11239334420821441,0.9547877431192966
25,133,4,162,0.15822784810126583,0.9753086419753086,0.1097359984665834,0.9529815766544957
22,105,13,140,0.1732283464566929,0.9071428571428571,0.11893382832968723,0.9425734133891895
35,87,18,140,0.28688524590163933,0.8714285714285714,0.15637552225424253,0.9265289468220749
17,89,2,108,0.16037735849056603,0.9814814814814815,0.14642272370192236,0.9290547434655185
15,51,1,67,0.22727272727272727,0.9850746268656716,0.16031882759802624,0.928336974460473
5,123,4,132,0.0390625,0.9696969696969697,0.15851002217930704,0.9264292776375219
17,32,1,50,0.3469387755102041,0.98,0.19885611453329935,0.9528761640844085
20,80,1,101,0.2,0.9900990099009901,0.20482356480454705,0.9549890737880773
6,23,1,30,0.20689655172413793,0.9666666666666667,0.20963330841418207,0.9634924751486214
10,84,2,96,0.10638297872340426,0.9791666666666666,0.18384727024586275,0.9788836316112065
19,35,1,55,0.35185185185185186,0.9818181818181818,0.21120076929747503,0.9789317316593065
18,43,2,63,0.29508196721311475,0.9682539682539683,0.22088780357467325,0.9765287804290631
8,189,9,206,0.04060913705583756,0.9563106796116505,0.2211087517255072,0.9746164532740176
55,173,4,232,0.2412280701754386,0.9827586206896551,0.20600722239196925,0.9750105419439683
48,93,12,153,0.3404255319148936,0.9215686274509803,0.22606801266552548,0.9652204873082526
2,61,2,65,0.031746031746031744,0.9692307692307692,0.20104650981151032,0.965586787674553
36,188,6,230,0.16071428571428573,0.9739130434782609,0.20880812509592195,0.9648362700762093
0,2,65,67,0.0,0.029850746268656716,0.1585435748313717,0.8288409221405628
6,8,1,15,0.42857142857142855,0.9333333333333333,0.17761349788255937,0.8238522600090435
18,66,3,87,0.21428571428571427,0.9655172413793104,0.20242443748682745,0.8251674831187092
1,60,4,65,0.01639344262295082,0.9384615384615385,0.17030520497932922,0.8188393285146925
50,61,31,142,0.45045045045045046,0.7816901408450704,0.18602305048440876,0.7988566875709913
189,333,69,591,0.3620689655172414,0.883248730964467,0.233212041023153,0.7865735392472338
2,56,1,59,0.034482758620689655,0.9830508474576272,0.21517896572406786,0.7878789398157148
33,68,7,108,0.32673267326732675,0.9351851851851852,0.26185506190511454,0.9172124310895045
2,0,0,2,1.0,1.0,0.343487714966339,0.9267362406133139
1,15,1,17,0.0625,0.9411764705882353,0.32180404149695124,0.9232589876431605
12,91,2,105,0.11650485436893204,0.9809523809523809,0.3361056717463772,0.929329107998995
44,97,8,149,0.3120567375886525,0.9463087248322147,0.31633514133754886,0.9528460485685871
24,35,4,63,0.4067796610169492,0.9365079365079365,0.32272238355179284,0.9604545065033684
5,24,2,31,0.1724137931034483,0.9354838709677419,0.3424268170493298,0.9536592241476705
1,23,0,24,0.041666666666666664,1.0,0.30742802671690844,0.9648360289486364
42,68,7,117,0.38181818181818183,0.9401709401709402,0.21911633840522013,0.9562890204016279
22,87,2,111,0.2018348623853211,0.9819819819819819,0.2390213187459803,0.962118379172163
37,86,3,126,0.3008130081300813,0.9761904761904762,0.26535105499757305,0.9614381070633194
190,217,12,419,0.4668304668304668,0.9713603818615751,0.28908407873059677,0.9630993696686644
5,86,13,104,0.054945054945054944,0.875,0.23640068464284436,0.954312521596102
6,33,1,40,0.15384615384615385,0.975,0.22882205637456088,0.9599576828864247
0,12,2,14,0.0,0.8571428571428571,0.22286967542217995,0.9395495196211184
3,12,1,16,0.2,0.9375,0.196895649448154,0.9391679567395556
22,235,11,268,0.08560311284046693,0.9589552238805971,0.1802911137988891,0.9358784198679293
44,111,16,171,0.2838709677419355,0.9064327485380117,0.17787082231486825,0.9259130302032915
2,24,0,26,0.07692307692307693,1.0,0.12216976661381256,0.9300044042230665
5,63,58,126,0.07352941176470588,0.5396825396825397,0.12482467473090554,0.8821019098920007
6,45,1,52,0.11764705882352941,0.9807692307692307,0.1196533754419592,0.8829260857161765
17,174,16,207,0.08900523560209424,0.9227053140096618,0.13236840909940123,0.8922921509828629
30,134,2,166,0.18292682926829268,0.9879518072289156,0.12992938470915733,0.8994995520155652
14,133,3,150,0.09523809523809523,0.98,0.13130581076596137,0.9025059486040512
2,119,2,123,0.01652892561983471,0.983739837398374,0.09311409046280414,0.9135498184412458
50,163,8,221,0.2347417840375587,0.9638009049773756,0.11565962005058723,0.9083785191522995
13,87,1,101,0.13,0.9900990099009901,0.12372684694134353,0.9727237291835067
2,56,1,59,0.034482758620689655,0.9830508474576272,0.11184623262665215,0.9730496744247061
1,30,8,39,0.03225806451612903,0.7948717948717948,0.10373949390008567,0.9547877431192966
25,133,4,162,0.15822784810126583,0.9753086419753086,0.10021106801908185,0.9529815766544955
20,107,13,140,0.15748031496062992,0.9071428571428571,0.10910281369372966,0.9425734133891895
32,89,19,140,0.2644628099173554,0.8642857142857143,0.14452194002194688,0.9255085386588097
16,90,2,108,0.1509433962264151,0.9814814814814815,0.1325507417632121,0.9280343353022532
15,51,1,67,0.22727272727272727,0.9850746268656716,0.14644684565931598,0.9273165662972078
5,123,4,132,0.0390625,0.9696969696969697,0.1471010944277889,0.9254088694742568
17,32,1,50,0.3469387755102041,0.98,0.19205548171265677,0.9518557559211432
20,80,1,101,0.2,0.9900990099009901,0.1980229319839045,0.953968665624812
6,23,1,30,0.20689655172413793,0.9666666666666667,0.20508239437869133,0.9624720669853561
11,83,2,96,0.11702127659574468,0.9791666666666666,0.18401931818988984,0.9788836316112065
19,35,1,55,0.35185185185185186,0.9818181818181818,0.21272052613638076,0.9789317316593066
0,5,58,63,0.0,0.07936507936507936,0.18025299366884834,0.8495446534449361
8,189,9,206,0.04060913705583756,0.9563106796116505,0.1804739418196823,0.8476323262898907
51,177,4,232,0.2236842105263158,0.9827586206896551,0.16286614682198391,0.8480264149598413
51,91,11,153,0.3591549295774648,0.9281045751633987,0.18560256533305036,0.8391700671401854
2,56,7,65,0.034482758620689655,0.8923076923076924,0.16097202346112915,0.8285473565174748
32,192,6,230,0.14285714285714285,0.9739130434782609,0.16466286149847173,0.827796838919131
0,2,65,67,0.0,0.029850746268656716,0.1143983112339215,0.6918014909834848
6,8,1,15,0.42857142857142855,0.9333333333333333,0.17562280102983988,0.8137969558360924
20,64,3,87,0.23809523809523808,0.9655172413793104,0.20383510117832568,0.815112178945758
1,60,4,65,0.01639344262295082,0.9384615384615385,0.17422213433498776,0.8087840243417415
51,61,31,143,0.45535714285714285,0.7832167832167832,0.18796530766065608,0.7880857683493678
187,398,5,590,0.31965811965811963,0.9915254237288136,0.22870464495171752,0.8022597299809565
2,56,1,59,0.034482758620689655,0.9830508474576272,0.2132225900607956,0.8035651305494375
33,68,7,108,0.32673267326732675,0.9351851851851852,0.2598986862418423,0.9328986218232271
2,0,0,2,1.0,1.0,0.3415313393030668,0.9424224313470368
1,15,1,17,0.0625,0.9411764705882353,0.3164463052894613,0.9389451783768832
14,89,2,105,0.13592233009708737,0.9809523809523809,0.33352186064290945,0.9450152987327177
43,101,5,149,0.2986111111111111,0.9664429530201343,0.3111295703934763,0.9711904658474823
25,34,4,63,0.423728813559322,0.9365079365079365,0.32599681237936234,0.9633308248159285
5,24,2,31,0.1724137931034483,0.9354838709677419,0.3457012458768993,0.9565355424602304
1,23,0,24,0.041666666666666664,1.0,0.3052809248611382,0.9638772561777831
43,68,6,117,0.38738738738738737,0.9487179487179487,0.21776483734505075,0.9565512488517758
21,88,2,111,0.1926605504587156,0.9819819819819819,0.23635920169629585,0.962380607622311
36,87,3,126,0.2926829268292683,0.9761904761904762,0.2601405352100471,0.9617003355134675
190,217,12,419,0.4668304668304668,0.9713603818615751,0.28256500833874554,0.9643203708896656
4,87,13,104,0.04395604395604396,0.875,0.23315437055038377,0.9555335228171032
6,33,1,40,0.15384615384615385,0.975,0.22557574228210034,0.9611786841074258
0,12,2,14,0.0,0.8571428571428571,0.21962336132971938,0.9407705208421197
3,12,1,16,0.2,0.9375,0.19285373456009264,0.9391679567395557
22,234,12,268,0.0859375,0.9552238805970149,0.17760758449456185,0.9353453708274175
47,108,16,171,0.3032258064516129,0.9064327485380117,0.17911371015489677,0.9253799811627798
2,24,0,26,0.07692307692307693,1.0,0.12341265445384109,0.9294713551825547
5,68,53,126,0.0684931506849315,0.5793650793650794,0.12691795541511072,0.8872377950918517
8,43,1,52,0.1568627450980392,0.9807692307692307,0.12734889702252292,0.8880619709160277
21,171,15,207,0.109375,0.927536231884058,0.14297389702252292,0.8981181673076276
29,135,2,166,0.17682926829268292,0.9879518072289156,0.1396637924929062,0.9053255683403298
10,134,6,150,0.06944444444444445,0.96,0.13730764169925538,0.9060078711121848
4,117,2,123,0.03305785123966942,0.983739837398374,0.09871221952612061,0.9170517409493796
50,163,8,221,0.2347417840375587,0.9638009049773756,0.12125774911390373,0.9118804416604332
12,88,1,101,0.12,0.9900990099009901,0.1286158704446278,0.9705567174512776
3,55,1,59,0.05172413793103448,0.9830508474576272,0.11359606942076998,0.9708826626924771
2,29,8,39,0.06451612903225806,0.7948717948717948,0.10718765928252114,0.9519306002621538
25,133,4,162,0.15822784810126583,0.9753086419753086,0.10453031354089012,0.9501244337973528
23,104,13,140,0.18110236220472442,0.9071428571428571,0.12048144464950154,0.9425734133891895
33,87,20,140,0.275,0.8571428571428571,0.15504460875812023,0.9244881304955442
17,89,2,108,0.16037735849056603,0.9814814814814815,0.1444211193942641,0.9270139271389878
15,51,1,67,0.22727272727272727,0.9850746268656716,0.15974579471893943,0.9262961581339424
6,122,4,132,0.046875,0.9696969696969697,0.15905306072879163,0.9243884613109914
18,31,1,50,0.3673469387755102,0.98,0.2023146049778277,0.9508353477578778
21,79,1,101,0.21,0.9900990099009901,0.20971062667764687,0.9529482574615465
7,22,1,30,0.2413793103448276,0.9666666666666667,0.21832161926909016,0.9614516588220907
11,82,3,96,0.11827956989247312,0.96875,0.19593298639658632,0.9773955363731112
17,37,1,55,0.3148148148148148,0.9818181818181818,0.21799548015719328,0.9774436364212112
23,38,2,63,0.3770491803278688,0.9682539682539683,0.23939211630792778,0.9750406851909679
8,189,9,206,0.04060913705583756,0.9563106796116505,0.23849699303019029,0.9731283580359223
54,174,4,232,0.23684210526315788,0.9827586206896551,0.21985344538556853,0.9735224467058732
49,92,12,153,0.3475177304964539,0.9215686274509803,0.2394988354564905,0.9637323920701574
3,55,7,65,0.05172413793103448,0.8923076923076924,0.2124052393973772,0.9531096814474468
35,188,6,229,0.15695067264573992,0.9737991266375546,0.21792968264784388,0.9538309852528117
0,2,65,67,0.0,0.029850746268656716,0.17295613767429893,0.8178356373171655
5,9,1,15,0.35714285714285715,0.9333333333333333,0.17011237721929723,0.8128469751856461
19,65,3,87,0.2261904761904762,0.9655172413793104,0.1966239970956742,0.8141621982953117
2,60,3,65,0.03225806451612903,0.9538461538461539,0.16739770556038436,0.8100318458890973
49,62,32,143,0.44144144144144143,0.7762237762237763,0.18081537855252547,0.7892682957137824
192,393,5,590,0.3282051282051282,0.9915254237288136,0.22031266287739598,0.8034422573453711
2,56,1,59,0.034482758620689655,0.9830508474576272,0.20281724658810307,0.8047639317482387
31,70,7,108,0.3069306930693069,0.9351851851851852,0.24666448845514694,0.9340974230220284
2,0,0,2,1.0,1.0,0.3385012231490245,0.943621232545838
1,15,1,17,0.0625,0.9411764705882353,0.31511686940752787,0.9401439795756844
12,91,2,105,0.11650485436893204,0.9809523809523809,0.32715212510078545,0.9440162977337169
43,100,6,149,0.3006993006993007,0.959731543624161,0.30704610499476537,0.9702316930766288
25,34,4,63,0.423728813559322,0.9365079365079365,0.32069234575965017,0.962372052045075
6,23,2,31,0.20689655172413793,0.9354838709677419,0.3453228876315714,0.9555767696893771
1,23,0,24,0.041666666666666664,1.0,0.31259410878976096,0.9629502125375665
44,68,5,117,0.39285714285714285,0.9572649572649573,0.22585941491220993,0.9568452064325604
20,89,2,111,0.1834862385321101,0.9819819819819819,0.24314316327393995,0.9626745652030956
37,86,3,126,0.3008130081300813,0.9761904761904762,0.2643773197148832,0.9637844828543667
177,230,11,418,0.4348894348894349,0.9736842105263158,0.278545198168476,0.9649511927325103
5,86,13,104,0.054945054945054944,0.875,0.23184903718660071,0.9567792798995806
6,33,1,40,0.15384615384615385,0.975,0.22321481426666348,0.9627316608519614
0,13,1,14,0.0,0.9285714285714286,0.21726243331428255,0.9525275792193083
3,12,1,16,0.2,0.9375,0.18971141290611926,0.949704013895743
23,234,11,268,0.08949416342412451,0.9589552238805971,0.17628397360497847,0.9464144770241167
48,107,16,171,0.3096774193548387,0.9064327485380117,0.1775503180656581,0.936449087359479
2,24,0,26,0.07692307692307693,1.0,0.126412266927607,0.9402084858557195
5,82,39,126,0.05747126436781609,0.6904761904761905,0.12677315398800143,0.9138479416380324
9,42,1,52,0.17647058823529413,0.9807692307692307,0.1300052160435929,0.9146721174622082
22,170,15,207,0.11458333333333333,0.927536231884058,0.14637426366264053,0.9145242322211553
29,135,2,166,0.17682926829268292,0.9879518072289156,0.14306415913302378,0.9217316332538575
14,132,4,150,0.0958904109589041,0.9733333333333334,0.14397790878084946,0.9237856488899627
5,115,2,122,0.041666666666666664,0.9836065573770492,0.10569065839682487,0.9348104787241109
50,164,7,221,0.2336448598130841,0.9683257918552036,0.12807948452396875,0.9302855918462828
12,88,1,101,0.12,0.9900990099009901,0.13701216104285216,0.9730888517641113
3,55,1,59,0.05172413793103448,0.9830508474576272,0.11919123957081508,0.9734147970053108
1,30,8,39,0.03225806451612903,0.7948717948717948,0.10743048688264302,0.9544627345749876
25,134,4,163,0.15723270440251572,0.9754601226993865,0.10463097775547626,0.9526782082136263
22,105,13,140,0.1732283464566929,0.9071428571428571,0.11567925425516039,0.943222425900701
34,89,17,140,0.2764227642276423,0.8785714285714286,0.14921583962101406,0.9282174074998981
15,91,2,108,0.14150943396226415,0.9814814814814815,0.1360536359280398,0.9300967917322236
15,51,1,67,0.22727272727272727,0.9850746268656716,0.15137831125271511,0.929379022727178
10,118,4,132,0.078125,0.9696969696969697,0.15514986297685304,0.9274713259042271
18,31,1,50,0.3673469387755102,0.98,0.20301970215676463,0.9539182123511134
23,77,1,101,0.23,0.9900990099009901,0.21341503009926238,0.9560094819513426
7,22,1,30,0.2413793103448276,0.9666666666666667,0.22315088208328163,0.9645128833118868
11,83,2,96,0.11702127659574468,0.9791666666666666,0.20037924099301055,0.9788836316112065
18,36,1,55,0.3333333333333333,0.9818181818181818,0.22778265518887755,0.9789317316593066
20,41,2,63,0.32786885245901637,0.9682539682539683,0.2421535302154903,0.9765287804290631
8,184,13,205,0.041666666666666664,0.9365853658536586,0.23694519688215698,0.9717985513085903
52,176,4,232,0.22807017543859648,0.9827586206896551,0.217048516405455,0.9721926399785409
49,92,12,153,0.3475177304964539,0.9215686274509803,0.23383676361923414,0.9624025853428252
5,58,2,65,0.07936507936507936,0.9692307692307692,0.21069187347927007,0.9627688857091256
22,200,6,228,0.0990990990990991,0.9736842105263158,0.20813156240832073,0.9619856776890756
11,50,6,67,0.18032786885245902,0.9104477611940298,0.186273638911053,0.9517899033141966
5,9,1,15,0.35714285714285715,0.9333333333333333,0.1904556395801731,0.9468012411826773
20,65,2,87,0.23529411764705882,0.9770114942528736,0.21811670400594338,0.9525764023825651
2,60,3,65,0.03225806451612903,0.9538461538461539,0.19014354530273378,0.9484460499763507
50,66,27,143,0.43103448275862066,0.8111888111888111,0.20207450991161474,0.9326775047960408
188,397,5,590,0.3213675213675214,0.9915254237288136,0.23664628734053503,0.9358624554386186
3,55,1,59,0.05172413793103448,0.9830508474576272,0.2298784357450972,0.9372005464288059
31,69,8,108,0.31,0.9259259259259259,0.24840302590903166,0.939411712819077
2,0,0,2,1.0,1.0,0.34023976060290917,0.9489355223428865
1,15,1,17,0.0625,0.9411764705882353,0.31555488665332937,0.9438162332479381
13,90,2,105,0.1262135922330097,0.9809523809523809,0.328977104898598,0.9476885514059704
44,98,7,149,0.30985915492957744,0.9530201342281879,0.3116663437801633,0.9679501689830242
23,36,4,63,0.3898305084745763,0.9365079365079365,0.3214467705097426,0.9600905279514704
6,23,2,31,0.20689655172413793,0.9354838709677419,0.3436142581944716,0.9532952455957725
2,21,0,23,0.08695652173913043,1.0,0.326297156192929,0.9619649908626897
43,59,7,109,0.4215686274509804,0.9357798165137615,0.24366410297164046,0.9527906789360842
27,62,2,91,0.30337078651685395,0.978021978021978,0.27807421533119103,0.9580543228551902
38,63,3,104,0.37623762376237624,0.9711538461538461,0.2992137516450709,0.9584447219297999
176,191,14,381,0.47956403269754766,0.963254593175853,0.3183909361722642,0.9591067081470399
6,76,13,95,0.07317073170731707,0.8631578947368421,0.26910363810447835,0.9492430659908019
6,26,1,33,0.1875,0.9696969696969697,0.2754811891248865,0.954437871185607
0,12,2,14,0.0,0.8571428571428571,0.26305882887643933,0.934029707920301
1,8,1,10,0.1111111111111111,0.9,0.21870775511360083,0.9289183055611921
26,194,11,231,0.11818181818181818,0.9523809523809523,0.19225218820859571,0.9252553018981885
45,97,15,157,0.31690140845070425,0.9044585987261147,0.18377558602121402,0.9157274094085126
2,22,0,24,0.08333333333333333,1.0,0.1271712003977548,0.9209767532405336
5,68,49,122,0.0684931506849315,0.5983606557377049,0.12650297453741402,0.8831485762406569
8,39,1,48,0.1702127659574468,0.9791666666666666,0.12403336967419214,0.8845013900934707
23,153,15,191,0.13068181818181818,0.9214659685863874,0.1427022008430233,0.893690406013975
28,107,2,137,0.2074074074074074,0.9854014598540146,0.15645881459963706,0.9058906145645486
19,118,4,141,0.1386861313868613,0.9716312056737588,0.1593880022003575,0.9086406507492352
6,96,2,104,0.058823529411764705,0.9807692307692307,0.12251973376622328,0.9195421696125374
51,162,8,221,0.23943661971830985,0.9638009049773756,0.14482020324979136,0.9143708703235911
8,70,1,79,0.10256410256410256,0.9873417721518988,0.14968748208967295,0.9699396012399045
5,46,1,52,0.09803921568627451,0.9807692307692307,0.1393769749080769,0.9701685389688423
5,24,8,37,0.1724137931034483,0.7837837837837838,0.14533868561116692,0.9504996554256131
26,128,4,158,0.16883116883116883,0.9746835443037974,0.13982779438599,0.948968524632725
22,97,13,132,0.18487394957983194,0.9015151515151515,0.1464260541278429,0.9389519454672096
33,74,18,125,0.308411214953271,0.856,0.18208143777662952,0.9211277696430338
24,75,2,101,0.24242424242424243,0.9801980198019802,0.1825082410203342,0.9234702146179773
15,50,1,66,0.23076923076923078,0.9848484848484849,0.2008232593353525,0.9231140307174897
6,108,4,118,0.05263157894736842,0.9661016949152542,0.19433645408693737,0.9210186684526358
18,28,1,47,0.391304347826087,0.9787234042553191,0.2256065333330286,0.9488671856628551
21,78,1,100,0.21212121212121213,0.99,0.23179082523160624,0.9510552507623127
5,22,1,28,0.18518518518518517,0.9642857142857143,0.2318352874609424,0.9600224740152503
10,66,2,78,0.13157894736842105,0.9743589743589743,0.20657353494882094,0.9769308989236752
17,36,1,54,0.32075471698113206,0.9814814814814815,0.21776360274266232,0.9771142505921755
19,39,2,60,0.3275862068965517,0.9666666666666667,0.23159459933227963,0.9745168479947728
12,154,13,179,0.07228915662650602,0.9273743016759777,0.23440282471501359,0.9689843632463047
53,144,4,201,0.26903553299492383,0.9800995024875622,0.2169358511677045,0.9691809487080537
53,82,11,146,0.3925925925925926,0.9246575342465754,0.2427174769493303,0.9598463107432788
4,52,7,63,0.07142857142857142,0.8888888888888888,0.22646653212695694,0.9490753356865894
35,151,6,192,0.1881720430107527,0.96875,0.23455126007586144,0.9482740536353074
0,3,64,67,0.0,0.04477611940298507,0.18872915764998544,0.8144590019098078
5,9,1,15,0.35714285714285715,0.9333333333333333,0.1929515362566005,0.809697097147903
20,47,3,70,0.29850746268656714,0.9571428571428572,0.2252684371223235,0.813949747928886
4,56,3,63,0.06666666666666667,0.9523809523809523,0.19635859907542966,0.809989955056513
47,66,30,143,0.415929203539823,0.7902097902097902,0.1996924006393197,0.7907831344798295
187,395,5,587,0.32130584192439865,0.9914821124361158,0.235389153567295,0.8054393092722903
3,50,1,54,0.05660377358490566,0.9814814814814815,0.21659368650645971,0.8072580923410735
32,58,8,98,0.35555555555555557,0.9183673469387755,0.2673873373001105,0.9320568391319007
2,0,0,2,1.0,1.0,0.35922407199398804,0.9415806486557102
1,15,1,17,0.0625,0.9411764705882353,0.3255087201816213,0.9392997362907644
14,78,3,95,0.15217391304347827,0.968421052631579,0.3377240410925944,0.9415911791837109
47,93,5,145,0.3357142857142857,0.9655172413793104,0.3262647671175177,0.9666351007793567
21,34,4,59,0.38181818181818183,0.9322033898305084,0.3349093871023438,0.9581667118356985
6,22,2,30,0.21428571428571427,0.9333333333333333,0.3574353786310308,0.9512884049573916
3,20,0,23,0.13043478260869565,1.0,0.3374594568186791,0.9638319088169995
46,56,7,109,0.45098039215686275,0.9357798165137615,0.25902808426965945,0.9546575968903941
37,53,2,92,0.4111111111111111,0.9782608695652174,0.3088296715712468,0.95995536817282
41,60,3,104,0.40594059405940597,0.9711538461538461,0.3307601586560163,0.9585555774873151
180,190,14,384,0.4864864864864865,0.9635416666666666,0.34959966685722665,0.9601040009107384
12,70,13,95,0.14634146341463414,0.8631578947368421,0.3148155175629492,0.9496254235148678
6,26,1,33,0.1875,0.9696969696969697,0.31697068997674227,0.9545130090476146
0,12,2,14,0.0,0.8571428571428571,0.2983371496040714,0.9341048457823086
1,8,1,10,0.1111111111111111,0.9,0.24978439516896414,0.9289934434231997
26,194,11,231,0.11818181818181818,0.9523809523809523,0.20793735332192226,0.9252963123968762
47,93,15,155,0.3357142857142857,0.9032258064516129,0.19790502355833367,0.9155923067251285
3,21,0,24,0.125,1.0,0.146264096917407,0.920800640058462
7,67,48,122,0.0945945945945946,0.6065573770491803,0.13887168708597278,0.8841434232459388
7,40,1,48,0.14893617021276595,0.9791666666666666,0.13336256854493936,0.8854962370987527
37,138,14,189,0.21142857142857144,0.9259259259259259,0.1635666501775924,0.895322389782048
29,106,2,137,0.21481481481481482,0.9854014598540146,0.1783814649924072,0.9075225983326217
39,98,4,141,0.2846715328467153,0.9716312056737588,0.20216570994453537,0.9102726345173083
8,93,2,103,0.07920792079207921,0.9805825242718447,0.16552194352707733,0.9213235942059129
51,162,8,221,0.23943661971830985,0.9638009049773756,0.18187003205826444,0.9161522949169666
9,69,1,79,0.11538461538461539,0.9873417721518988,0.18484003502826743,0.9705500656459264
9,42,1,52,0.17647058823529413,0.9807692307692307,0.18877352331720001,0.9707790033748641
7,22,8,37,0.2413793103448276,0.7837837837837838,0.1930522003052366,0.9504729830688438
27,127,4,158,0.17532467532467533,0.9746835443037974,0.18741075180664524,0.9489418522759555
22,97,13,132,0.18487394957983194,0.9015151515151515,0.1731539541970905,0.9389252731104402
46,59,20,125,0.4380952380952381,0.84,0.22442357095468463,0.9188420553573194
33,66,2,101,0.3333333333333333,0.9801980198019802,0.23783738718540223,0.921184500332263
18,48,1,67,0.2727272727272727,0.9850746268656716,0.26031490966292475,0.9208606224342306
7,107,4,118,0.06140350877192982,0.9661016949152542,0.2438767554538727,0.9187652601693769
17,29,1,47,0.3695652173913043,0.9787234042553191,0.26218902788908366,0.9466137773795962
22,77,1,100,0.2222222222222222,0.99,0.268888677445876,0.9488018424790537
8,19,1,28,0.2962962962962963,0.9642857142857143,0.2848061555482281,0.9577690657319913
10,65,3,78,0.13333333333333333,0.9615384615384616,0.2412687405822417,0.9751317030946287
18,35,1,54,0.33962264150943394,0.9814814814814815,0.24216721317882753,0.9753150547631287
18,41,2,61,0.3050847457627119,0.9672131147540983,0.2467897093267474,0.9727634101757612
20,151,9,180,0.11695906432748537,0.95,0.25472621726325534,0.9704631680450105
54,144,4,202,0.2727272727272727,0.9801980198019802,0.24089222516839365,0.9706738274088194
57,76,11,144,0.42857142857142855,0.9236111111111112,0.2703706832182803,0.9611897004246923
5,52,6,63,0.08771929824561403,0.9047619047619048,0.24057396921103996,0.9526862990641481
41,144,6,191,0.22162162162162163,0.9685863874345549,0.25318658182365256,0.9536931456207328
2,1,64,67,0.6666666666666666,0.04477611940298507,0.2999071568461144,0.8198780938952334
4,10,1,15,0.2857142857142857,0.9333333333333333,0.2971399482677678,0.8150381251208384
32,36,2,70,0.47058823529411764,0.9714285714285714,0.34765840126300096,0.8180993496106342
12,48,3,63,0.2,0.9523809523809523,0.3372687908733906,0.8141254828362017
51,61,31,143,0.45535714285714285,0.7832167832167832,0.3410953214856355,0.7940691502798691
182,400,5,587,0.3127147766323024,0.9914821124361158,0.3732375326837338,0.806457751376185
5,47,1,53,0.09615384615384616,0.9811320754716981,0.3553135647597659,0.8082499925243483
33,56,8,97,0.3707865168539326,0.9175257731958762,0.3130449719293753,0.9329285144947613
2,0,0,2,1.0,1.0,0.4150857882559059,0.9424523240185708
1,15,1,17,0.0625,0.9411764705882353,0.3567874689281748,0.9381305953270943
21,71,3,95,0.22826086956521738,0.968421052631579,0.3608247360089201,0.940422038220041
48,91,6,145,0.34532374100719426,0.9586206896551724,0.34510567860178465,0.9654797391398109
23,32,4,59,0.41818181818181815,0.9322033898305084,0.36017239882314406,0.9570113501961527
4,24,2,30,0.14285714285714285,0.9333333333333333,0.3668442983521864,0.9501829584621007
3,21,0,24,0.125,1.0,0.33115938499814607,0.9647971597822504
44,67,6,117,0.3963963963963964,0.9487179487179487,0.2449302987690598,0.9574711524562431
39,67,2,108,0.36792452830188677,0.9814814814814815,0.28856237424075787,0.9632290111552783
48,73,3,124,0.39669421487603307,0.9758064516129032,0.3133328376696503,0.9624938783924958
180,222,14,416,0.44776119402985076,0.9663461538461539,0.32800294788317025,0.9634776918763093
14,77,13,104,0.15384615384615385,0.875,0.29429089722196705,0.9546908438037469
6,33,1,40,0.15384615384615385,0.975,0.2916383773280678,0.9603360050940694
0,12,2,14,0.0,0.8571428571428571,0.27378123447092495,0.9399278418287633
3,12,1,16,0.2,0.9375,0.2457246064142969,0.9383252777261993
28,229,11,268,0.10894941634241245,0.9589552238805971,0.2087281618486577,0.935107240926073
45,110,16,171,0.2903225806451613,0.9064327485380117,0.1935322141013903,0.9251967119153742
3,23,0,26,0.11538461538461539,1.0,0.14604984572349955,0.9300044042230665
7,69,50,126,0.09210526315789473,0.6031746031746031,0.13722971848231968,0.8911722046765812
8,43,1,52,0.1568627450980392,0.9807692307692307,0.13766066008973188,0.891996380500757
33,156,17,206,0.1746031746031746,0.9174757281553398,0.16260397074732827,0.9006153620739689
36,127,2,165,0.22085889570552147,0.9878787878787879,0.16558381299097416,0.9078123317709385
45,101,4,150,0.3082191780821918,0.9733333333333334,0.19405092181094266,0.9098663474070436
10,111,2,123,0.08264462809917356,0.983739837398374,0.16438264287580154,0.9209102172442382
51,162,8,221,0.23943661971830985,0.9638009049773756,0.182104357780615,0.9157389179552918
13,88,1,102,0.12871287128712872,0.9901960784313726,0.18733401608479133,0.9710277001348304
11,47,1,59,0.1896551724137931,0.9830508474576272,0.19201864855847045,0.9713536453760299
7,24,8,39,0.22580645161290322,0.7948717948717948,0.1993334024170031,0.9538387977640949
27,131,4,162,0.17088607594936708,0.9753086419753086,0.1921944281661239,0.9520430626350266
23,104,13,140,0.18110236220472442,0.9071428571428571,0.17403488304077142,0.9425872803221013
54,67,19,140,0.4462809917355372,0.8642857142857143,0.22598293498882338,0.9255224055917214
34,73,2,109,0.3177570093457944,0.981651376146789,0.23717156207846402,0.9280724729016375
16,50,1,67,0.24242424242424243,0.9850746268656716,0.25341604366948023,0.9273408369636803
8,120,4,132,0.0625,0.9696969696969697,0.23525101903893836,0.9254331401407292
19,30,1,50,0.3877551020408163,0.98,0.25838654052864024,0.9518800265876157
22,78,1,101,0.22,0.9900990099009901,0.2654028153930164,0.9539929362912843
8,21,1,30,0.27586206896551724,0.9666666666666667,0.2789399163588439,0.9624963376518287
12,81,3,96,0.12903225806451613,0.96875,0.2336186686915552,0.9774198070395838
18,36,1,55,0.3333333333333333,0.9818181818181818,0.23584385783263223,0.9774436364212112
16,45,2,63,0.26229508196721313,0.9682539682539683,0.23868254919591372,0.975040685190968
22,170,13,205,0.11458333333333333,0.9365853658536586,0.24612302538638994,0.9703104560704949
57,169,4,230,0.252212389380531,0.9826086956521739,0.22675978072063488,0.9706831268779483
55,85,12,152,0.39285714285714285,0.9210526315789473,0.2514536582716553,0.9608193585462279
8,54,2,64,0.12903225806451613,0.96875,0.2304779710000837,0.961116977593847
49,173,6,228,0.22072072072072071,0.9736842105263158,0.24357632280811292,0.961821864811892
1,1,65,67,0.5,0.029850746268656716,0.26738584661763676,0.8258265168762458
5,9,1,15,0.35714285714285715,0.9333333333333333,0.28093552878558586,0.8208378547447264
32,52,3,87,0.38095238095238093,0.9655172413793104,0.31898824987402125,0.8249709798198195
14,48,3,65,0.22580645161290322,0.9538461538461539,0.3152159730500744,0.8208620452761023
52,57,33,142,0.47706422018348627,0.7676056338028169,0.32724555552526635,0.7989410455937981
182,403,5,590,0.3111111111111111,0.9915254237288136,0.35325682024620847,0.8021946775550572
7,51,1,59,0.1206896551724138,0.9830508474576272,0.33896666802502173,0.8035327685452446
34,65,8,107,0.3434343434343434,0.9252336448598131,0.31660014565849937,0.9314446112011238
2,0,0,2,1.0,1.0,0.4084368803523769,0.9409684207249336
1,15,1,17,0.0625,0.9411764705882353,0.3629436830734654,0.9374911677547798
26,77,2,105,0.2524271844660194,0.9809523809523809,0.36674664490962483,0.9413634859128123
50,91,7,148,0.3546099290780142,0.9527027027027027,0.34925317475170026,0.9678059243270817
23,36,4,63,0.3898305084745763,0.9365079365079365,0.360498802946481,0.9599462832955279
5,24,2,31,0.1724137931034483,0.9354838709677419,0.3678879655080573,0.9531510009398299
3,21,0,24,0.125,1.0,0.3298227940237281,0.9628666578517485
44,67,6,117,0.3963963963963964,0.9487179487179487,0.24359370779464187,0.9555406505257411
39,67,2,108,0.36792452830188677,0.9814814814814815,0.28722578326633996,0.9612985092247763
46,74,3,123,0.38333333333333336,0.975609756097561,0.31008754933198956,0.9605352771026592
180,223,14,417,0.4466501240694789,0.9664268585131894,0.32593552623987426,0.9634611217551227
14,77,13,104,0.15384615384615385,0.875,0.29222347557867107,0.9546742736825602
6,33,1,40,0.15384615384615385,0.975,0.2895709556847719,0.9603194349728827
0,12,2,14,0.0,0.8571428571428571,0.271713812827629,0.9399112717075767
3,12,1,16,0.2,0.9375,0.24365718477100096,0.9383087076050126
28,229,11,268,0.10894941634241245,0.9589552238805971,0.20666074020536176,0.9350906708048863
45,110,16,171,0.2903225806451613,0.9064327485380117,0.1933734898213372,0.9252082411535222
3,23,0,26,0.11538461538461539,1.0,0.14604984572349955,0.9300044042230665
7,67,52,126,0.0945945945945946,0.5873015873015873,0.13758533725899108,0.888904630980436
8,43,1,52,0.1568627450980392,0.9807692307692307,0.13801627886640327,0.889728806804612
35,154,17,206,0.18518518518518517,0.9174757281553398,0.16447130532142973,0.8983477883778237
32,131,2,165,0.19631901840490798,0.9878787878787879,0.16394545080784514,0.9055447580747933
46,100,4,150,0.3150684931506849,0.9733333333333334,0.19339103320902692,0.9075987737108985
9,112,2,123,0.0743801652892562,0.983739837398374,0.16254211672961194,0.9186426435480932
51,162,8,221,0.23943661971830985,0.9638009049773756,0.18026383163442541,0.9134713442591468
13,88,1,102,0.12871287128712872,0.9901960784313726,0.1851378711619303,0.9710277001348304
11,47,1,59,0.1896551724137931,0.9830508474576272,0.1898225036356094,0.9713536453760299
7,24,8,39,0.22580645161290322,0.7948717948717948,0.195625541696712,0.9538387977640949
27,131,4,162,0.17088607594936708,0.9753086419753086,0.1919922642030633,0.9520430626350266
24,103,13,140,0.1889763779527559,0.9071428571428571,0.17397910488907348,0.9425872803221013
52,67,21,140,0.4369747899159664,0.85,0.22577833697860347,0.9234815892651909
34,73,2,109,0.3177570093457944,0.981651376146789,0.2369669640682441,0.926031656575107
17,49,1,67,0.25757575757575757,0.9850746268656716,0.25537594782376255,0.9253000206371497
8,120,4,132,0.0625,0.9696969696969697,0.23721092319322065,0.9233923238141986
19,30,1,50,0.3877551020408163,0.98,0.2603464446829225,0.949839210261085
21,79,1,101,0.21,0.9900990099009901,0.26593414811872723,0.9519521199647538
8,21,1,30,0.27586206896551724,0.9666666666666667,0.27834638969197883,0.9604555213252981
11,82,3,96,0.11827956989247312,0.96875,0.23281850111719407,0.9774198070395838
18,36,1,55,0.3333333333333333,0.9818181818181818,0.2350436902582711,0.9774436364212112
18,43,2,63,0.29508196721311475,0.9682539682539683,0.24040172020646497,0.975040685190968
23,173,9,205,0.11734693877551021,0.9560975609756097,0.24823699717439499,0.973097912516488
58,169,4,231,0.2555066079295154,0.9826839826839827,0.22934435515849488,0.9734813386141997
55,85,12,152,0.39285714285714285,0.9210526315789473,0.2554668041380867,0.9636175702824793
8,54,2,64,0.12903225806451613,0.96875,0.2344911168665151,0.9639151893300983
49,173,6,228,0.22072072072072071,0.9736842105263158,0.2491255669848362,0.9646200765481435
1,1,65,67,0.5,0.029850746268656716,0.27293509079436,0.8286247286124971
5,9,1,15,0.35714285714285715,0.9333333333333333,0.28180093221289465,0.8236360664809778
33,52,2,87,0.38823529411764707,0.9770114942528736,0.3204992686903428,0.8266237712348727
14,48,3,65,0.22580645161290322,0.9538461538461539,0.316256389216541,0.822504081400897
50,62,31,143,0.44642857142857145,0.7832167832167832,0.3239094504410308,0.802813245920588
178,407,5,590,0.30427350427350425,0.9915254237288136,0.34894391418517196,0.806066877881847
7,51,1,59,0.1206896551724138,0.9830508474576272,0.3346537619639852,0.8074049688720344
34,65,8,107,0.3434343434343434,0.9252336448598131,0.31228723959746285,0.9353168115279138
2,0,0,2,1.0,1.0,0.40412397429134045,0.9448406210517234
1,15,1,17,0.0625,0.9411764705882353,0.35759036084596235,0.9397213319567752
23,80,2,105,0.22330097087378642,0.9809523809523809,0.3572324350260884,0.9435936501148074
49,93,6,148,0.34507042253521125,0.9594594594594594,0.34275269946989423,0.9687711752923327
23,36,4,63,0.3898305084745763,0.9365079365079365,0.35497512864147585,0.9609115342607788
5,24,2,31,0.1724137931034483,0.9354838709677419,0.36236429120305225,0.9541162519050809
3,21,0,24,0.125,1.0,0.33882472757250753,0.9676929126780033
45,65,7,117,0.4090909090909091,0.9401709401709402,0.2544091431569231,0.9591459041309948
40,67,2,109,0.37383177570093457,0.981651376146789,0.29888511111419946,0.9649280334965024
46,75,3,124,0.38016528925619836,0.9758064516129032,0.3185203743505219,0.9641929007337199
179,225,13,417,0.4430693069306931,0.9688249400479616,0.3325549058824927,0.9626350736363244
14,77,13,104,0.15384615384615385,0.875,0.29884285522128956,0.9538482255637621
6,33,1,40,0.15384615384615385,0.975,0.29126422695300613,0.9594933868540847
0,12,2,14,0.0,0.8571428571428571,0.2734070840958633,0.9390852235887787
3,12,1,16,0.2,0.9375,0.24353695422573338,0.9387036607072157
28,229,11,268,0.10894941634241245,0.9589552238805971,0.20569661717451596,0.935461353240617
44,111,16,171,0.2838709677419355,0.9064327485380117,0.19194028552962125,0.9255508242299182
3,23,0,26,0.11538461538461539,1.0,0.14512818673732442,0.9300044042230665
5,69,52,126,0.06756756756756757,0.5873015873015873,0.13280267441181212,0.888904630980436
7,44,1,52,0.13725490196078433,0.9807692307692307,0.13043249557104503,0.889728806804612
36,153,17,206,0.19047619047619047,0.9174757281553398,0.15764337992478653,0.8983477883778237
35,128,2,165,0.2147239263803681,0.9878787878787879,0.1597467979791248,0.9055447580747933
47,99,4,150,0.3219178082191781,0.9733333333333334,0.1901708539615199,0.9075987737108985
10,111,2,123,0.08264462809917356,0.983739837398374,0.16142423401255396,0.9186426435480932
51,162,8,221,0.23943661971830985,0.9638009049773756,0.17914594891736743,0.9134713442591468
13,88,1,102,0.12871287128712872,0.9901960784313726,0.18788099230587615,0.9710277001348304
10,48,1,59,0.1724137931034483,0.9830508474576272,0.19290369104054242,0.9713536453760299
7,24,8,39,0.22580645161290322,0.7948717948717948,0.19795087120292995,0.9538387977640949
27,131,4,162,0.17088607594936708,0.9753086419753086,0.19168832114135842,0.9520430626350266
24,103,13,140,0.1889763779527559,0.9071428571428571,0.1726966882461552,0.9425872803221013
51,68,21,140,0.42857142857142855,0.85,0.2221148025993345,0.9234815892651909
33,74,2,109,0.308411214953271,0.981651376146789,0.23196831620432895,0.926031656575107
17,49,1,67,0.25757575757575757,0.9850746268656716,0.25037729995984737,0.9253000206371497
8,120,4,132,0.0625,0.9696969696969697,0.2346753295164976,0.9233923238141986
19,30,1,50,0.3877551020408163,0.98,0.2578108510061995,0.949839210261085
21,79,1,101,0.21,0.9900990099009901,0.26339855444200416,0.9519521199647538
8,21,1,30,0.27586206896551724,0.9666666666666667,0.2758107960152558,0.9604555213252981
11,82,3,96,0.11827956989247312,0.96875,0.23148338763254792,0.9774198070395838
17,37,1,55,0.3148148148148148,0.9818181818181818,0.23239818761276845,0.9774436364212112
20,41,2,63,0.32786885245901637,0.9682539682539683,0.24244005831037688,0.975040685190968
23,173,9,205,0.11734693877551021,0.9560975609756097,0.25027533527830687,0.973097912516488
59,168,4,231,0.2599118942731278,0.9826839826839827,0.2320120198829228,0.9734813386141997
51,87,14,152,0.3695652173913043,0.9078947368421053,0.25480705093882344,0.961737871034359
9,53,2,64,0.14516129032258066,0.96875,0.23613551113268963,0.9620354900819781
51,171,6,228,0.22972972972972974,0.9736842105263158,0.252056962538012,0.9627403773000233
1,1,65,67,0.5,0.029850746268656716,0.2785119889930385,0.8267450293643768
4,10,1,15,0.2857142857142857,0.9333333333333333,0.2724899080295055,0.8217563672328575
32,52,3,87,0.38095238095238093,0.9655172413793104,0.310147828340487,0.8231020358619576
12,49,4,65,0.19672131147540983,0.9384615384615385,0.3011206022265273,0.8167845438301798
52,59,32,143,0.46846846846846846,0.7762237762237763,0.31524963809469364,0.79797440659899
179,406,5,590,0.305982905982906,0.9915254237288136,0.33822415461759725,0.801228038560249
7,51,1,59,0.1206896551724138,0.9830508474576272,0.32264700110940925,0.8025661295504364
34,65,8,107,0.3434343434343434,0.9252336448598131,0.3002804787428869,0.9304779722063159
2,0,0,2,1.0,1.0,0.4023212950694175,0.9400017817301255
1,15,1,17,0.0625,0.9411764705882353,0.35682809779050595,0.9365245287599718
23,80,2,105,0.22330097087378642,0.9809523809523809,0.36062519199027404,0.9425946491158065
47,93,8,148,0.3357142857142857,0.9459459459459459,0.3416603087396765,0.9668406733618308
23,36,4,63,0.3898305084745763,0.9365079365079365,0.35363853766705794,0.9589810323302769
5,24,2,31,0.1724137931034483,0.9354838709677419,0.3610277002286343,0.952185749974579
3,21,0,24,0.125,1.0,0.3413295284408385,0.9676929126780033
43,67,7,117,0.39090909090909093,0.9401709401709402,0.2543165414278515,0.9591459041309947
39,67,2,108,0.36792452830188677,0.9814814814814815,0.29794861689954955,0.96490376283003
44,77,3,124,0.36363636363636365,0.9758064516129032,0.31522260504732413,0.9641686300672474
178,226,13,417,0.4405940594059406,0.9688249400479616,0.32890352979004467,0.962610802969852
13,78,13,104,0.14285714285714285,0.875,0.2960429279221789,0.9538239548972897
6,32,2,40,0.15789473684210525,0.95,0.2841165602789329,0.9558976876161837
0,12,2,14,0.0,0.8571428571428571,0.26625941742179,0.9354895243508775
3,12,1,16,0.2,0.9375,0.23898669014906274,0.9351079614693146
28,229,11,268,0.10894941634241245,0.9589552238805971,0.20199024558342352,0.9318899246691883
45,110,16,171,0.2903225806451613,0.9064327485380117,0.1915168480132518,0.9219793956584895
2,24,0,26,0.07692307692307693,1.0,0.13956385051569983,0.9264329756516378
5,72,49,126,0.06493506493506493,0.6111111111111112,0.12843212509826013,0.8887345629532251
9,42,1,52,0.17647058823529413,0.9807692307692307,0.13108581815442996,0.8931301673488294
36,155,15,206,0.18848167539267016,0.9271844660194175,0.15801177178195427,0.9031361114740525
39,124,2,165,0.2392638036809816,0.9878787878787879,0.16362088659352308,0.9103330811710222
49,97,4,150,0.3356164383561644,0.9733333333333334,0.1960018897383448,0.9123870968071274
8,113,2,123,0.06611570247933884,0.983739837398374,0.16397233571465586,0.9234309666443219
51,162,8,221,0.23943661971830985,0.9638009049773756,0.1871885561139748,0.9182596673553756
12,89,1,102,0.1188118811881188,0.9901960784313726,0.1948852441501254,0.9724146626868416
11,47,1,59,0.1896551724137931,0.9830508474576272,0.19676875617562525,0.9727406079280411
7,24,8,39,0.22580645161290322,0.7948717948717948,0.20210086706422997,0.9538387977640949
27,131,4,162,0.17088607594936708,0.9753086419753086,0.19233262024542788,0.9520430626350266
24,103,13,140,0.1889763779527559,0.9071428571428571,0.17138404018779813,0.9425872803221013
54,71,15,140,0.432,0.8928571428571429,0.22365322554789255,0.9296040382447827
33,73,2,108,0.3113207547169811,0.9814814814814815,0.2339223876905599,0.9321298348882262
16,50,1,67,0.24242424242424243,0.9850746268656716,0.2515812964385776,0.9313981989502691
8,120,4,132,0.0625,0.9696969696969697,0.23341627180803567,0.929490502127318
19,30,1,50,0.3877551020408163,0.98,0.25655179329773753,0.9559373885742044
23,77,1,101,0.23,0.9900990099009901,0.26499663959068515,0.9580502982778732
8,21,1,30,0.27586206896551724,0.9666666666666667,0.27740888116393675,0.9665536996384174
12,81,3,96,0.12903225806451613,0.96875,0.23412777517315334,0.9773955363731112
20,34,1,55,0.37037037037037035,0.9818181818181818,0.2425634345522089,0.9774436364212112
22,39,2,63,0.36065573770491804,0.9682539682539683,0.259453648163734,0.9750406851909679
22,174,9,205,0.11224489795918367,0.9560975609756097,0.2665600621579031,0.9730979125164879
62,164,5,231,0.2743362831858407,0.9783549783549783,0.25035737375004946,0.9728629094243421
52,88,12,152,0.37142857142857144,0.9210526315789473,0.27056145538270254,0.9629991410926216
8,54,2,64,0.12903225806451613,0.96875,0.24958576811113092,0.9632967601402406
50,172,6,228,0.22522522522522523,0.9736842105263158,0.2633276205626608,0.9640016473582858
2,1,64,67,0.6666666666666666,0.04477611940298507,0.3056556628907031,0.8301384955846862
4,10,1,15,0.2857142857142857,0.9333333333333333,0.29494974117775563,0.825149833453167
32,52,3,87,0.38095238095238093,0.9655172413793104,0.33333652446249806,0.8264955020822671
12,49,4,65,0.19672131147540983,0.9384615384615385,0.32224867136100804,0.8207964392403471
54,58,31,143,0.48214285714285715,0.7832167832167832,0.3380649978916202,0.801105603760038
181,404,5,590,0.3094017094017094,0.9915254237288136,0.36383206236836213,0.8043592357212971
7,51,1,59,0.1206896551724138,0.9830508474576272,0.3488984095036748,0.8056973267114843
34,65,8,107,0.3434343434343434,0.9252336448598131,0.3027223633276286,0.931476973205317
2,0,0,2,1.0,1.0,0.4047631796541592,0.9410007827291265
1,15,1,17,0.0625,0.9411764705882353,0.3592699823752477,0.9375235297589729
25,78,2,105,0.24271844660194175,0.9809523809523809,0.36584100167903794,0.9435936501148074
50,95,3,148,0.3448275862068966,0.9797297297297297,0.3462245344024721,0.9716669281880856
23,36,4,63,0.3898305084745763,0.9365079365079365,0.35771436284145314,0.9638072871565316
6,23,2,31,0.20689655172413793,0.9354838709677419,0.37002963377741377,0.9570120048008338
3,21,0,24,0.125,1.0,0.33899326426707393,0.967018825073889
45,67,5,117,0.4017857142857143,0.9572649572649573,0.25353408059360455,0.960913818968883
39,67,2,108,0.36792452830188677,0.9814814814814815,0.29716615606530267,0.9666716776679182
45,76,3,124,0.371900826446281,0.9758064516129032,0.31957287935179135,0.9662229752667539
174,233,10,417,0.4275184275184275,0.9760191846522782,0.33100155035493045,0.9657733349789842
13,78,13,104,0.14285714285714285,0.875,0.2981409484870646,0.9569864869064217
6,33,1,40,0.15384615384615385,0.975,0.2844046847508009,0.9629388678588027
0,13,1,14,0.0,0.9285714285714286,0.26654754189365804,0.9527347862261496
3,12,1,16,0.2,0.9375,0.23772101128141315,0.9499112209025844
26,231,11,268,0.10116731517509728,0.9589552238805971,0.19961283797758606,0.9466931841024581
46,109,16,171,0.2967741935483871,0.9064327485380117,0.18888046184931553,0.9367826550917593
2,24,0,26,0.07692307692307693,1.0,0.1387954117642654,0.9402084858557195
6,84,36,126,0.06666666666666667,0.7142857142857143,0.12791105802276884,0.9172493021822501
9,42,1,52,0.17647058823529413,0.9807692307692307,0.13114312007836032,0.9180734780064259
37,154,15,206,0.193717277486911,0.9271844660194175,0.15881701686220473,0.9178753404989958
36,127,2,165,0.22085889570552147,0.9878787878787879,0.16179685910585068,0.9250723101959656
49,97,4,150,0.3356164383561644,0.9733333333333334,0.19528959098886026,0.9271263258320707
7,114,2,123,0.05785123966942149,0.983739837398374,0.16115774043472234,0.9381701956692653
51,163,7,221,0.2383177570093458,0.9683257918552036,0.18421412330418926,0.9336453087914373
13,88,1,102,0.12871287128712872,0.9901960784313726,0.19307786682139813,0.9730610750979599
11,47,1,59,0.1896551724137931,0.9830508474576272,0.194961378846898,0.9733870203391594
7,24,8,39,0.22580645161290322,0.7948717948717948,0.1995455465791826,0.9544852101752133
27,131,4,162,0.17088607594936708,0.9753086419753086,0.1924065723283034,0.9526894750461448
23,104,13,140,0.18110236220472442,0.9071428571428571,0.1703331328780977,0.9432336927332197
57,68,15,140,0.456,0.8928571428571429,0.2272115272110375,0.9302504506559008
34,72,2,108,0.32075471698113206,0.9814814814814815,0.2389882357784355,0.9321298348882262
17,49,1,67,0.25757575757575757,0.9850746268656716,0.25739721953395395,0.931398198950269
11,117,4,132,0.0859375,0.9696969696969697,0.24258040918912635,0.9294905021273179
17,32,1,50,0.3469387755102041,0.98,0.25988502688874077,0.9559373885742044
24,76,1,101,0.24,0.9900990099009901,0.2697584446102597,0.958050298277873
8,21,1,30,0.27586206896551724,0.9666666666666667,0.28329554557608727,0.9665536996384174
12,81,3,96,0.12903225806451613,0.96875,0.2365858681567324,0.9773955363731112
19,35,1,55,0.35185185185185186,0.9818181818181818,0.2410283159954067,0.9774436364212112
21,40,2,63,0.3442622950819672,0.9682539682539683,0.2534121070677223,0.975040685190968
23,170,12,205,0.11917098445595854,0.9414634146341463,0.2581597477042879,0.9710073201819932
62,164,4,230,0.2743362831858407,0.9826086956521739,0.24778796308652165,0.9713799909894466
52,89,12,153,0.36879432624113473,0.9215686274509803,0.2661871525495409,0.9615899363537308
9,53,2,64,0.14516129032258066,0.96875,0.2475156127434071,0.96188755540135
49,173,6,228,0.22072072072072071,0.9736842105263158,0.2606139645514364,0.9625924426193951
12,50,5,67,0.1935483870967742,0.9253731343283582,0.23799918387213953,0.9545288644065631
4,10,1,15,0.2857142857142857,0.9333333333333333,0.2296351825338993,0.9495402022750438
32,53,2,87,0.3764705882352941,0.9770114942528736,0.2663922687880901,0.9546184993634333
13,49,3,65,0.20967741935483872,0.9538461538461539,0.2571552882408041,0.9505095648197164
51,63,29,143,0.4473684210526316,0.7972027972027972,0.2683801589281608,0.9327430176414044
184,401,5,590,0.3145299145299145,0.9915254237288136,0.29257567667206563,0.9359966496026636
7,51,1,59,0.1206896551724138,0.9830508474576272,0.27828552445087895,0.9373347405928509
34,65,8,107,0.3434343434343434,0.9252336448598131,0.2996978039276746,0.9373148135259157
2,0,0,2,1.0,1.0,0.40173862025420515,0.9468386230497254
1,15,1,17,0.0625,0.9411764705882353,0.3568856790777346,0.9417193339547769
25,78,2,105,0.24271844660194175,0.9809523809523809,0.36160582582732076,0.9455916521128095
50,95,3,148,0.3448275862068966,0.9797297297297297,0.3469571351350728,0.9716669281880855
22,37,4,63,0.3728813559322034,0.9365079365079365,0.3552930553353999,0.9638072871565316
7,22,2,31,0.2413793103448276,0.9354838709677419,0.3725344346457447,0.9570120048008339
3,20,0,23,0.13043478260869565,1.0,0.3430726936467589,0.9664038898342565
43,66,7,116,0.3944954128440367,0.9396551724137931,0.25657203833876413,0.957783200179084
37,58,2,97,0.3894736842105263,0.979381443298969,0.3032825646545536,0.9632410534234747
45,62,4,111,0.4205607476635514,0.963963963963964,0.3326407052577952,0.9611005670724619
163,208,12,383,0.4393530997304582,0.9686684073107049,0.3437337012679214,0.959600815735896
13,71,13,97,0.15476190476190477,0.865979381443299,0.3112970902598819,0.9501402431091518
6,26,1,33,0.1875,0.9696969696969697,0.30236851883131044,0.955335048303957
0,12,2,14,0.0,0.8571428571428571,0.28373497845863965,0.9349268850386508
1,9,1,11,0.1,0.9090909090909091,0.24166420519520582,0.9305605617068103
25,208,11,244,0.1072961373390558,0.9549180327868853,0.20135312707071004,0.9270657887765126
43,100,15,158,0.3006993006993007,0.9050632911392406,0.1842300632186742,0.9186514069444093
2,22,0,24,0.08333333333333333,1.0,0.13337009659051352,0.9231273487571657
6,66,51,123,0.08333333333333333,0.5853658536585366,0.12316601495786046,0.8830397019307711
7,41,1,49,0.14583333333333334,0.9795918367346939,0.1172136340054795,0.8844532543647317
39,137,14,190,0.2215909090909091,0.9263157894736842,0.14886947816132365,0.8943351018405641
34,105,2,141,0.2446043165467626,0.9858156028368794,0.169527237668004,0.9052957723757027
50,91,4,145,0.3546099290780142,0.9724137931034482,0.2048577793449981,0.9077951667066403
4,101,2,107,0.0380952380952381,0.9813084112149533,0.16734291325870343,0.9186873267174563
49,164,8,221,0.2300469483568075,0.9638009049773756,0.18830200111919973,0.9135160274285099
7,75,1,83,0.08536585365853659,0.9879518072289156,0.18859236116565734,0.9710283065099927
9,43,1,53,0.17307692307692307,0.9811320754716981,0.19248430255759877,0.9712483406152791
7,23,8,38,0.23333333333333334,0.7894736842105263,0.1941617917350879,0.9516994684348278
29,126,4,159,0.1870967741935484,0.9748427672955975,0.1859464285417716,0.9501319205003591
24,94,13,131,0.2033898305084746,0.9007633587786259,0.16434355731755163,0.9398961441682417
51,61,15,127,0.45535714285714285,0.8818897637795275,0.22395240085496665,0.925693480248895
32,67,2,101,0.32323232323232326,0.9801980198019802,0.23726459726575458,0.9280359252238386
17,48,1,66,0.26153846153846155,0.9848484848484849,0.2624321126771724,0.9275925934552057
8,108,4,120,0.06896551724137931,0.9666666666666667,0.24755905470066616,0.9255261064830583
17,30,1,48,0.3617021276595745,0.9791666666666666,0.2658974538901292,0.9526251039767926
22,77,1,100,0.2222222222222222,0.99,0.27091537503708263,0.9547904229345645
7,22,1,30,0.2413793103448276,0.9666666666666667,0.27634244358513305,0.9642051812042846
12,67,2,81,0.1518987341772152,0.9753086419753086,0.2329912423451434,0.9775507352322533
17,37,1,55,0.3148148148148148,0.9818181818181818,0.2317887411426422,0.9777821869488534
22,37,2,61,0.3728813559322034,0.9672131147540983,0.24769486891317674,0.9752628483639411
22,147,12,181,0.1301775147928994,0.9337016574585635,0.2564394399919653,0.970553561334212
59,140,4,203,0.2964824120603015,0.9802955665024631,0.24712233776349773,0.9707148327393259
53,81,12,146,0.39552238805970147,0.9178082191780822,0.27187950431170904,0.9604017211933377
7,54,2,63,0.11475409836065574,0.9682539682539683,0.2537901883139702,0.9606284785629521
45,149,6,200,0.23195876288659795,0.97,0.26522733527245346,0.959870101137908
2,1,64,67,0.6666666666666666,0.04477611940298507,0.31549188553700375,0.8260069493643085
5,9,1,15,0.35714285714285715,0.9333333333333333,0.31324352856709714,0.8211669805899134
31,43,3,77,0.4189189189189189,0.961038961038961,0.35449230058509995,0.8250723096728274
13,48,3,64,0.21311475409836064,0.953125,0.3425826351619655,0.8211908001724755
48,62,33,143,0.43636363636363634,0.7692307692307693,0.3484170992053848,0.7999654501800022
178,350,61,589,0.3371212121212121,0.8964346349745331,0.3801838297426071,0.7897055454257973
6,47,1,54,0.11320754716981132,0.9814814814814815,0.3632193703544947,0.791345757066009
34,62,8,104,0.3541666666666667,0.9230769230769231,0.31857651321163755,0.916817300448
2,0,0,2,1.0,1.0,0.4104132479055151,0.9263411099718096
1,15,1,17,0.0625,0.9411764705882353,0.3594962594885267,0.9235036113359917
20,73,2,95,0.21505376344086022,0.9789473684210527,0.35977326082316946,0.9271925211104277
49,92,3,144,0.3475177304964539,0.9791666666666666,0.34708098855642916,0.9571833636012702
22,37,4,63,0.3728813559322034,0.9365079365079365,0.3521895805294279,0.962908120963185
7,21,2,30,0.25,0.9333333333333333,0.37173135950516917,0.9560298140848781
4,19,0,23,0.17391304347826086,1.0,0.3427756380398522,0.9638772561777831
42,60,7,109,0.4117647058823529,0.9357798165137615,0.2587420245944741,0.9547029442511776
40,50,2,92,0.4444444444444444,0.9782608695652174,0.3133055166579661,0.9600007155336036
47,55,3,105,0.46078431372549017,0.9714285714285714,0.3486186710459349,0.9586401713159164
166,204,13,383,0.4486486486486487,0.9660574412532638,0.36240952427340783,0.9605026437480703
11,71,13,95,0.13414634146341464,0.8631578947368421,0.3307258297124913,0.9500240663521996
6,26,1,33,0.1875,0.9696969696969697,0.3230287853775159,0.9549116518849464
0,12,2,14,0.0,0.8571428571428571,0.2981840648806215,0.9345034886196403
1,8,1,10,0.1111111111111111,0.9,0.2552335513418727,0.9293920862605315
24,197,11,232,0.1085972850678733,0.9525862068965517,0.20725538571664823,0.925724277307865
42,98,16,156,0.3,0.8974358974358975,0.18428619804157823,0.9151538953089116
2,22,0,24,0.08333333333333333,1.0,0.13209829585367602,0.9200028322727309
5,65,52,122,0.07142857142857142,0.5737704918032787,0.123138614420127,0.8786617747107933
8,39,1,48,0.1702127659574468,0.9791666666666666,0.12066900955690511,0.8800145885636071
41,134,15,190,0.2342857142857143,0.9210526315789473,0.15413839731200715,0.8891445563401916
31,107,2,140,0.2246376811594203,0.9857142857142858,0.1703564787474799,0.9013894542993752
49,88,4,141,0.35766423357664234,0.9716312056737588,0.20593747139158974,0.9041101684104048
6,96,2,104,0.058823529411764705,0.9807692307692307,0.1714836898789847,0.9160149303151668
48,165,8,221,0.22535211267605634,0.9638009049773756,0.19177208692794515,0.9108436310262203
7,71,1,79,0.08974358974358974,0.9873417721518988,0.1943885181158049,0.9699252425045947
9,42,1,52,0.17647058823529413,0.9807692307692307,0.19528249272692594,0.9701541802335324
7,22,8,37,0.2413793103448276,0.7837837837837838,0.19629586359251358,0.9505443448342232
31,124,4,159,0.2,0.9748427672955975,0.19277619485545355,0.9489912707744106
24,94,13,131,0.2033898305084746,0.9007633587786259,0.17073699441714388,0.9388672926465346
49,61,15,125,0.44545454545454544,0.88,0.22596999670896967,0.9244716882509303
33,66,2,101,0.3333333333333333,0.9801980198019802,0.24139588537429496,0.9268141332258738
17,48,1,66,0.26153846153846155,0.9848484848484849,0.26593800991641947,0.926457949325386
8,107,4,119,0.06956521739130435,0.9663865546218487,0.2506658140815638,0.9244032813043315
17,29,1,47,0.3695652173913043,0.9787234042553191,0.2689780865167748,0.9522517985145509
24,75,1,100,0.24242424242424243,0.99,0.27503869257738084,0.9544171174723226
7,21,1,29,0.25,0.9655172413793104,0.28169728821902734,0.9636676721295633
12,62,4,78,0.16216216216216217,0.9487179487179487,0.24122694774868683,0.9734845219464131
18,34,1,53,0.34615384615384615,0.9811320754716981,0.24305844958018868,0.9736179584706585
19,39,2,60,0.3275862068965517,0.9666666666666667,0.2524938417742016,0.9710205558732559
22,146,12,180,0.13095238095238096,0.9333333333333333,0.2612634365686411,0.9662986671177537
59,138,4,201,0.29949238578680204,0.9800995024875622,0.2512530320537122,0.9664952525795025
52,81,12,145,0.39097744360902253,0.9172413793103448,0.2724749179372522,0.9561011639095519
7,54,2,63,0.11475409836065574,0.9682539682539683,0.2531540748459173,0.9564921248916459
45,149,6,200,0.23195876288659795,0.97,0.263125017806551,0.9595324179319389
2,1,64,67,0.6666666666666666,0.04477611940298507,0.30891256359409675,0.8257672813506941
5,9,1,15,0.35714285714285715,0.9333333333333333,0.31313494220071186,0.8210053765887894
31,37,2,70,0.45588235294117646,0.9714285714285714,0.3595535096276827,0.8264475534595377
12,48,3,63,0.2,0.9523809523809523,0.3453403116581395,0.8224877605871649
50,62,30,142,0.44642857142857145,0.7887323943661971,0.3532619013466465,0.8041293341665724
179,403,5,587,0.3075601374570447,0.9914821124361158,0.3808056212175592,0.8074476404783077
6,46,1,53,0.11538461538461539,0.9811320754716981,0.3641521715744188,0.8090379369742646
34,55,8,97,0.38202247191011235,0.9175257731958762,0.32348871518062533,0.9337164589446777
2,0,0,2,1.0,1.0,0.41532544987450287,0.9432402684684872
1,15,1,17,0.0625,0.9411764705882353,0.3591279708829062,0.9389185397770107
20,73,2,95,0.21505376344086022,0.9789473684210527,0.36127850851731486,0.9427137420684535
51,90,3,144,0.3617021276595745,0.9791666666666666,0.34917473083602957,0.9699186381113777
21,34,4,59,0.38181818181818183,0.9322033898305084,0.3597830228876206,0.9614502491677195
7,21,2,30,0.25,0.9333333333333333,0.37901379211838987,0.9546218574336675
4,20,0,24,0.16666666666666666,1.0,0.34617382129314256,0.9638772561777831
42,67,8,117,0.3853211009174312,0.9316239316239316,0.2583625499956327,0.9541092464097732
42,67,2,111,0.3853211009174312,0.9819819819819819,0.30447985012669426,0.9599386051803086
45,77,3,125,0.36885245901639346,0.976,0.3266598824133636,0.9592311221871113
165,240,14,419,0.4074074074074074,0.9665871121718377,0.3325470573146229,0.961169261893347
16,75,13,104,0.17582417582417584,0.875,0.30439603158490475,0.9523824138207846
6,33,1,40,0.15384615384615385,0.975,0.2918912949422371,0.9580275751111073
0,12,2,14,0.0,0.8571428571428571,0.26808177113271325,0.937619411845801
3,11,2,16,0.21428571428571427,0.875,0.24364814447103944,0.929530278756668
24,233,11,268,0.0933852140077821,0.9589552238805971,0.20194301776966098,0.9262407418850416
42,112,17,171,0.2727272727272727,0.9005847953216374,0.18821084829978657,0.915467141216704
2,24,0,26,0.07692307692307693,1.0,0.14099880108773938,0.9202404109064416
5,70,51,126,0.06666666666666667,0.5952380952380952,0.1254048712080952,0.8802744245118836
9,42,1,52,0.17647058823529413,0.9807692307692307,0.12863693326368666,0.8810986003360596
38,151,15,204,0.20105820105820105,0.9264705882352942,0.15735953341485825,0.8910025619206934
35,129,2,166,0.21341463414634146,0.9879518072289156,0.15723509339494784,0.907138534381967
52,94,4,150,0.3561643835616438,0.9733333333333334,0.19477497475978525,0.9091925500180722
7,114,2,123,0.05785123966942149,0.983739837398374,0.1640783986086636,0.9210718417433202
48,165,8,221,0.22535211267605634,0.9638009049773756,0.18528254657337498,0.9159005424543739
10,91,1,102,0.09900990099009901,0.9901960784313726,0.1899030086195796,0.972323111481985
10,48,1,59,0.1724137931034483,0.9830508474576272,0.18932346645788733,0.9726490567231846
7,24,8,39,0.22580645161290322,0.7948717948717948,0.1928589308228448,0.9538492290998274
31,128,4,163,0.1949685534591195,0.9754601226993865,0.1902237764389559,0.9520647027384662
25,102,13,140,0.1968503937007874,0.9071428571428571,0.16746463503026218,0.942608920425541
56,65,19,140,0.4628099173553719,0.8642857142857143,0.22531587469968364,0.925544045695161
32,75,2,109,0.29906542056074764,0.981651376146789,0.23584634725463954,0.9280941130050773
16,50,1,67,0.24242424242424243,0.9850746268656716,0.25633411031666004,0.9273624770671199
8,120,4,132,0.0625,0.9696969696969697,0.24063213987331028,0.9254547802441689
17,32,1,50,0.3469387755102041,0.98,0.2579367575729247,0.9519016666910554
24,76,1,101,0.24,0.9900990099009901,0.264369821364479,0.9539929362912843
7,22,1,30,0.2413793103448276,0.9666666666666667,0.2707310951707705,0.9624963376518286
12,80,4,96,0.13043478260869565,0.9583333333333334,0.22324893306410248,0.9759317118014886
18,35,1,54,0.33962264150943394,0.9814814814814815,0.22904282177105764,0.9759074411350159
18,43,2,63,0.29508196721311475,0.9682539682539683,0.2365653538837537,0.9735044899047727
22,171,12,205,0.11398963730569948,0.9414634146341463,0.24392101635599647,0.9694711248957979
62,164,4,230,0.2743362831858407,0.9826086956521739,0.2335492317382303,0.9698437957032514
51,90,12,153,0.3617021276595745,0.9215686274509803,0.25093524997531236,0.9600537410675357
8,50,7,65,0.13793103448275862,0.8923076923076924,0.23615692485215964,0.949431030444825
50,172,6,228,0.22522522522522523,0.9736842105263158,0.24969841665452103,0.9516240129009654
1,1,65,67,0.5,0.029850746268656716,0.27260946786745904,0.8156767650134189
5,9,1,15,0.35714285714285715,0.9333333333333333,0.2814753092859937,0.8106881028818996
32,52,3,87,0.38095238095238093,0.9655172413793104,0.3196128440926624,0.8141243638454946
13,49,3,65,0.20967741935483872,0.9538461538461539,0.31037586354537644,0.8100154293017774
49,62,31,142,0.44144144144144143,0.7816901408450704,0.32176719408564314,0.790032788358076
182,403,5,590,0.3111111111111111,0.9915254237288136,0.34650720503255067,0.8042067499896648
7,51,1,59,0.1206896551724138,0.9830508474576272,0.3315735521678633,0.8055448409798521
36,64,8,108,0.36,0.9259259259259259,0.31157355216786325,0.9335555809308905
2,0,0,2,1.0,1.0,0.4034102868617409,0.9430793904547
1,15,1,17,0.0625,0.9411764705882353,0.35791708958282925,0.9396021374845465
22,81,2,105,0.21359223300970873,0.9809523809523809,0.3584763486763821,0.9434744556425789
50,92,7,149,0.352112676056338,0.9530201342281879,0.34571509647851023,0.9679501689830242
21,38,4,63,0.3559322033898305,0.9365079365079365,0.35211810966118445,0.9600905279514703
7,22,2,31,0.2413793103448276,0.9354838709677419,0.36935948897152926,0.9532952455957725
3,21,0,24,0.125,1.0,0.32550348807151464,0.9677123472611964
41,69,7,117,0.37272727272727274,0.9401709401709402,0.23589309846112502,0.9591653387141877
42,67,2,111,0.3853211009174312,0.9819819819819819,0.2909389700207581,0.964994697484723
46,76,3,125,0.3770491803278688,0.976,0.315676925046792,0.9642872144915257
158,247,14,419,0.39012345679012345,0.9665871121718377,0.31857127405986246,0.9623902631143482
16,75,13,104,0.17582417582417584,0.875,0.2904202483301443,0.9536034150417858
6,33,1,40,0.15384615384615385,0.975,0.28284162006186087,0.9592485763321085
0,12,2,14,0.0,0.8571428571428571,0.264984477204718,0.9388404130668022
3,11,2,16,0.21428571428571427,0.875,0.24234996885592391,0.929530278756668
26,231,11,268,0.10116731517509728,0.9589552238805971,0.20175657089273338,0.9262407418850416
43,112,16,171,0.27741935483870966,0.9064327485380117,0.18752373867999633,0.9163025631047576
2,24,0,26,0.07692307692307693,1.0,0.14278082727041827,0.921075832794495
5,73,48,126,0.0641025641025641,0.6190476190476191,0.12682059702447374,0.8845112069441549
9,42,1,52,0.17647058823529413,0.9807692307692307,0.1300526590800652,0.8853353827683307
38,151,15,204,0.20105820105820105,0.9264705882352942,0.15877525923123678,0.8952393443529646
34,130,2,166,0.2073170731707317,0.9879518072289156,0.15777973907195356,0.9113753168142382
51,96,3,150,0.3469387755102041,0.98,0.1928899476912545,0.9143817134027243
7,114,2,123,0.05785123966942149,0.983739837398374,0.16152307409564193,0.925425583239919
48,165,8,221,0.22535211267605634,0.9638009049773756,0.18272722206035327,0.9202542839509726
10,91,1,102,0.09900990099009901,0.9901960784313726,0.18771398447285828,0.9732754924343661
11,47,1,59,0.1896551724137931,0.9830508474576272,0.18959749649835814,0.9736014376755655
7,24,8,39,0.22580645161290322,0.7948717948717948,0.19313296086331558,0.9548016100522084
31,128,4,163,0.1949685534591195,0.9754601226993865,0.19136888661879953,0.9530170836908471
26,101,13,140,0.2047244094488189,0.9071428571428571,0.17105254861003022,0.9426089204255409
55,66,19,140,0.45454545454545453,0.8642857142857143,0.2277231507351778,0.925544045695161
32,75,2,109,0.29906542056074764,0.981651376146789,0.23825362329013372,0.9280941130050772
16,50,1,67,0.24242424242424243,0.9850746268656716,0.2587413863521542,0.9273624770671199
9,119,4,132,0.0703125,0.9696969696969697,0.24169243315018374,0.9254547802441689
18,31,1,50,0.3673469387755102,0.98,0.2619125027448419,0.9519016666910554
23,77,1,101,0.23,0.9900990099009901,0.2669169951078248,0.9539929362912843
7,22,1,30,0.2413793103448276,0.9666666666666667,0.2721534095215404,0.9624963376518287
11,82,3,96,0.11827956989247312,0.96875,0.22411542599968584,0.9774198070395838
17,36,1,54,0.32075471698113206,0.9814814814814815,0.22721389691688362,0.9773955363731114
19,42,2,63,0.3114754098360656,0.9682539682539683,0.23707834940428693,0.9749925851428679
22,171,12,205,0.11398963730569948,0.9414634146341463,0.24331794044795826,0.9709592201338931
63,163,4,230,0.27876106194690264,0.9826086956521739,0.23066281518672865,0.9713318909413465
53,89,11,153,0.3732394366197183,0.9281045751633987,0.2511255918466884,0.9624755431216906
8,50,7,65,0.13793103448275862,0.8923076923076924,0.2363472667235357,0.95185283249898
50,172,6,228,0.22522522522522523,0.9736842105263158,0.25162521748535743,0.9525577197170251
1,1,65,67,0.5,0.029850746268656716,0.2772316864880528,0.8166104718294788
5,9,1,15,0.35714285714285715,0.9333333333333333,0.2837556075318802,0.8116218096979596
32,52,3,87,0.38095238095238093,0.9655172413793104,0.32189314233854904,0.8150580706615543
13,49,3,65,0.20967741935483872,0.9538461538461539,0.31202405053968274,0.8109491361178371
49,62,31,142,0.44144144144144143,0.7816901408450704,0.32176719408564314,0.790032788358076
180,405,5,590,0.3076923076923077,0.9915254237288136,0.3460188045441502,0.8042067499896647
7,51,1,59,0.1206896551724138,0.9830508474576272,0.3310851516794628,0.8055448409798521
36,64,8,108,0.36,0.9259259259259259,0.31108515167946277,0.9335555809308905
2,0,0,2,1.0,1.0,0.4029218863733404,0.9430793904547
1,15,1,17,0.0625,0.9411764705882353,0.35742868909442876,0.9396021374845465
22,81,2,105,0.21359223300970873,0.9809523809523809,0.35798794818798163,0.9434744556425789
52,90,7,149,0.36619718309859156,0.9530201342281879,0.3472387684247174,0.9679501689830242
22,37,4,63,0.3728813559322034,0.9365079365079365,0.35655148960184535,0.9600905279514704
7,22,2,31,0.2413793103448276,0.9354838709677419,0.37379286891219016,0.9532952455957726
3,21,0,24,0.125,1.0,0.32550348807151464,0.9677123472611964
41,69,7,117,0.37272727272727274,0.9401709401709402,0.23589309846112502,0.9591653387141879
45,64,2,111,0.41284403669724773,0.9819819819819819,0.2948708179893033,0.964994697484723
46,76,3,125,0.3770491803278688,0.976,0.31960877301533724,0.9642872144915257
161,243,15,419,0.39851485148514854,0.964200477326969,0.3237018926991256,0.9620493152793669
17,74,13,104,0.18681318681318682,0.875,0.2971207256821232,0.9532624672068045
3,36,1,40,0.07692307692307693,0.975,0.2785530864248288,0.9589076284971272
0,12,2,14,0.0,0.8571428571428571,0.26069594356768594,0.938499465231821
3,12,1,16,0.2,0.9375,0.23602061889236126,0.938117902350258
26,231,11,268,0.10116731517509728,0.9589552238805971,0.1914953729606255,0.9348283654786318
43,111,17,171,0.2792207792207792,0.9005847953216374,0.17751988708818414,0.9240547648102942
2,24,0,26,0.07692307692307693,1.0,0.13157820500788817,0.929168982335013
6,71,49,126,0.07792207792207792,0.6111111111111112,0.1160223323091583,0.8914705696366002
10,41,1,52,0.19607843137254902,0.9807692307692307,0.13304452580194007,0.892294745460776
41,148,15,204,0.21693121693121692,0.9264705882352942,0.16403469964925677,0.9021987070454099
36,127,2,165,0.22085889570552147,0.9878787878787879,0.16701454189290268,0.9093956767423796
52,94,4,150,0.3561643835616438,0.9733333333333334,0.2034426945195522,0.9114496923784847
9,112,2,123,0.0743801652892562,0.983739837398374,0.17417974967219177,0.923328984103733
48,165,8,221,0.22535211267605634,0.9638009049773756,0.1953838976369031,0.9181576848147867
10,91,1,102,0.09900990099009901,0.9901960784313726,0.19839644378947754,0.9723126801462525
11,47,1,59,0.1896551724137931,0.9830508474576272,0.19747883536679814,0.972638625387452
7,24,8,39,0.22580645161290322,0.7948717948717948,0.19874672603561042,0.953838797764095
31,128,4,163,0.1949685534591195,0.9754601226993865,0.1950481057146959,0.9520647027384662
25,101,14,140,0.1984126984126984,0.9,0.17251215069341796,0.9415885122622756
57,68,15,140,0.456,0.8928571428571429,0.22702926993780995,0.928605270184957
32,75,2,109,0.29906542056074764,0.981651376146789,0.23755974249276585,0.9311553374948731
17,49,1,67,0.25757575757575757,0.9850746268656716,0.2602120077192885,0.9304237015569159
9,119,4,132,0.0703125,0.9696969696969697,0.24316305451731804,0.9285160047339648
19,30,1,50,0.3877551020408163,0.98,0.26629857600701995,0.9549628911808512
24,76,1,101,0.24,0.9900990099009901,0.2727316397985743,0.9570541607810803
6,23,1,30,0.20689655172413793,0.9666666666666667,0.2739436188430656,0.9665779703048899
9,82,5,96,0.0989010989010989,0.9479166666666666,0.22292949011465119,0.9744436165633933
18,35,1,54,0.33962264150943394,0.9814814814814815,0.22872337882160637,0.9744193458969208
19,42,2,63,0.3114754098360656,0.9682539682539683,0.2364233291445075,0.9720163946666773
23,171,12,206,0.11855670103092783,0.941747572815534,0.24331535786321148,0.9680236236836152
64,162,4,230,0.2831858407079646,0.9826086956521739,0.22837689195851837,0.9683962944910686
54,88,11,153,0.38028169014084506,0.9281045751633987,0.24841713340721053,0.9595399466714127
8,54,3,65,0.12903225806451613,0.9538461538461539,0.23729366288440742,0.9577084448399109
47,175,6,228,0.21171171171171171,0.9736842105263158,0.253409464714495,0.9613895225341464
2,1,64,67,0.6666666666666666,0.04477611940298507,0.3001300397369568,0.8275744708086471
4,10,1,15,0.2857142857142857,0.9333333333333333,0.2964498791481311,0.8225858086771277
32,52,3,87,0.38095238095238093,0.9655172413793104,0.33393497627976726,0.8259814756148101
13,48,4,65,0.21311475409836064,0.9384615384615385,0.32392482104982384,0.8196747388732907
49,63,32,144,0.4375,0.7777777777777778,0.3320988653154174,0.7981994821039162
181,404,5,590,0.3094017094017094,0.9915254237288136,0.3578659297921593,0.8035822349442963
7,51,1,59,0.1206896551724138,0.9830508474576272,0.34486277885797384,0.8049203259344836
36,64,8,108,0.36,0.9259259259259259,0.30105325504845004,0.930798869723475
2,0,0,2,1.0,1.0,0.4030940713749807,0.9403226792472846
0,16,1,17,0.0,0.9411764705882353,0.3486723026674977,0.9368454262771311
21,82,2,105,0.20388349514563106,0.9809523809523809,0.3473535513885363,0.9429155466329657
54,92,3,149,0.3698630136986301,0.9798657718120806,0.33769112477405494,0.9717852600664375
22,37,4,63,0.3728813559322034,0.9365079365079365,0.3467596457069826,0.9639256190348836
6,23,2,31,0.20689655172413793,0.9354838709677419,0.35907491664294316,0.9571303366791858
3,21,0,24,0.125,1.0,0.3265378330255568,0.9677123472611964
41,67,9,117,0.37962962962962965,0.9230769230769231,0.2379134944012182,0.9567233362721853
45,64,2,111,0.41284403669724773,0.9819819819819819,0.29689121392939644,0.9625526950427206
45,77,3,125,0.36885245901639346,0.976,0.3218451713200879,0.9618452120495232
157,246,16,419,0.38957816377171217,0.9618138424821002,0.32466162133052817,0.9592663650023833
17,74,13,104,0.18681318681318682,0.875,0.2956591468074725,0.9504795169298209
3,36,1,40,0.07692307692307693,0.975,0.27709150755017814,0.9561246782201434
0,12,2,14,0.0,0.8571428571428571,0.25923436469303524,0.9357165149548373
3,12,1,16,0.2,0.9375,0.2335729890316596,0.937776954515277
26,231,11,268,0.10116731517509728,0.9589552238805971,0.1890477430999238,0.9344874176436505
43,111,17,171,0.2792207792207792,0.9005847953216374,0.17624321741483606,0.9237138169753131
2,24,0,26,0.07692307692307693,1.0,0.13157820500788817,0.929168982335013
5,70,51,126,0.06666666666666667,0.5952380952380952,0.11441441641552816,0.8892029959404552
9,42,1,52,0.17647058823529413,0.9807692307692307,0.12863548946013062,0.890027171764631
42,147,15,204,0.2222222222222222,0.9264705882352942,0.16038152120616234,0.8999311333492648
36,127,2,165,0.22085889570552147,0.9878787878787879,0.16336136344980828,0.9071281030462345
52,94,4,150,0.3561643835616438,0.9733333333333334,0.19978951607645776,0.9091821186823397
8,113,2,123,0.06611570247933884,0.983739837398374,0.16934593368482348,0.9210614104075877
50,163,8,221,0.2347417840375587,0.9638009049773756,0.19189146327260653,0.9158901111186414
10,91,1,102,0.09900990099009901,0.9901960784313726,0.19651192531881118,0.9723126801462525
12,46,1,59,0.20689655172413793,0.9830508474576272,0.20085849153150312,0.9726386253874519
8,23,8,39,0.25806451612903225,0.7948717948717948,0.20597881923247602,0.9538387977640949
32,126,4,162,0.20253164556962025,0.9753086419753086,0.20336064064163298,0.9520430626350266
23,104,13,140,0.18110236220472442,0.9071428571428571,0.17835178044778738,0.9425872803221013
60,65,15,140,0.48,0.8928571428571429,0.23747810866502464,0.9296040382447827
32,75,2,109,0.29906542056074764,0.981651376146789,0.24666719959690878,0.9321541055546988
17,49,1,67,0.25757575757575757,0.9850746268656716,0.26931946482343144,0.9314224696167415
8,120,4,132,0.0625,0.9696969696969697,0.24869138600569743,0.9295147727937904
19,30,1,50,0.3877551020408163,0.98,0.2672186125645237,0.9559616592406768
27,73,1,101,0.27,0.9900990099009901,0.27685694891172086,0.9580745689443456
6,23,1,30,0.20689655172413793,0.9666666666666667,0.2805418331287799,0.9665779703048899
10,81,5,96,0.10989010989010989,0.9479166666666666,0.2276689916845099,0.9744436165633932
20,33,1,54,0.37735849056603776,0.9814814814814815,0.2388537159709799,0.9744193458969208
21,40,2,63,0.3442622950819672,0.9682539682539683,0.2512375070432956,0.9720163946666774
23,170,13,206,0.11917098445595854,0.9368932038834952,0.2593333619655754,0.9673301424076096
63,163,4,230,0.27876106194690264,0.9826086956521739,0.243762784809302,0.9677028132150631
54,88,11,153,0.38028169014084506,0.9281045751633987,0.25951731197227984,0.9588464653954071
8,50,7,65,0.13793103448275862,0.8923076923076924,0.24966509522351138,0.9482237547726965
48,174,6,228,0.21621621621621623,0.9736842105263158,0.2648545389843837,0.951904832466932
2,1,64,67,0.6666666666666666,0.04477611940298507,0.3061842784273307,0.8180897807414327
4,10,1,15,0.2857142857142857,0.9333333333333333,0.2978202770890905,0.8131011186099134
33,52,2,87,0.38823529411764707,0.9770114942528736,0.3362580356121888,0.8188323029483959
15,46,4,65,0.2459016393442623,0.9384615384615385,0.3315638323832402,0.8125255662068767
50,64,30,144,0.43859649122807015,0.7916666666666666,0.33989451825284384,0.7930344364216292
178,407,5,590,0.30427350427350425,0.9915254237288136,0.3636577282229503,0.807208398053218
7,51,1,59,0.1206896551724138,0.9830508474576272,0.35001107664526426,0.8085464890434053
36,64,8,108,0.36,0.9259259259259259,0.30620155283574046,0.9344250328323968
2,0,0,2,1.0,1.0,0.4082423691622711,0.9439488423562062
0,16,1,17,0.0,0.9411764705882353,0.35278018428832153,0.938829553261258
21,82,2,105,0.20388349514563106,0.9809523809523809,0.3467775922599456,0.9448996736170926
54,92,3,149,0.3698630136986301,0.9798657718120806,0.3369585240414542,0.9717852600664375
22,37,4,63,0.3728813559322034,0.9365079365079365,0.3467596457069826,0.9639256190348836
6,23,2,31,0.20689655172413793,0.9354838709677419,0.35907491664294316,0.9571303366791858
3,21,0,24,0.125,1.0,0.3433695487928746,0.9664038898342565
41,72,4,117,0.36283185840707965,0.9658119658119658,0.25234552856531456,0.9615198849502516
44,65,2,111,0.4036697247706422,0.9819819819819819,0.30108406067540633,0.9673492437207869
47,75,3,125,0.38524590163934425,0.976,0.32846941989577344,0.9669281910892079
157,247,15,419,0.3886138613861386,0.964200477326969,0.32826126838153386,0.9647901640406796
17,74,13,104,0.18681318681318682,0.875,0.2952086067574437,0.95661825120775
3,36,1,40,0.07692307692307693,0.975,0.2755853728484955,0.9625706321601308
0,13,1,14,0.0,0.9285714285714286,0.25772822999135264,0.9523665505274778
3,12,1,16,0.2,0.9375,0.2344665359331984,0.9483219839829112
26,231,11,268,0.10116731517509728,0.9589552238805971,0.19125190599097772,0.9450324471112849
43,111,17,171,0.2792207792207792,0.9005847953216374,0.1761054599311827,0.9342588464429473
2,24,0,26,0.07692307692307693,1.0,0.1315782050078882,0.939373063967666
6,90,30,126,0.0625,0.7619047619047619,0.11381917832029008,0.923216601382632
8,43,1,52,0.1568627450980392,0.9807692307692307,0.12523913091671326,0.9240407772068079
41,148,15,204,0.21693121693121692,0.9264705882352942,0.15622930476402996,0.9237406571587885
32,131,2,165,0.19631901840490798,0.9878787878787879,0.15570345025044538,0.9309376268557583
55,91,4,150,0.3767123287671233,0.9733333333333334,0.19506702362073483,0.9329916424918635
8,113,2,123,0.06611570247933884,0.983739837398374,0.1646234412291005,0.9448709342171115
50,164,7,221,0.2336448598130841,0.9683257918552036,0.18701226735624438,0.9403460473392835
10,91,1,102,0.09900990099009901,0.9901960784313726,0.19222796749768709,0.9729590925573708
12,46,1,59,0.20689655172413793,0.9830508474576272,0.19937565415855832,0.9732850377985702
8,23,8,39,0.25806451612903225,0.7948717948717948,0.20525183975824618,0.9544852101752133
32,126,4,162,0.20253164556962025,0.9753086419753086,0.2061393579246337,0.9526894750461448
25,102,13,140,0.1968503937007874,0.9071428571428571,0.18044479577229997,0.9432336927332196
61,64,15,140,0.488,0.8928571428571429,0.24071398113239442,0.9302504506559008
32,75,2,109,0.29906542056074764,0.981651376146789,0.2500597755249178,0.9321541055546988
16,50,1,67,0.24242424242424243,0.9850746268656716,0.2705475385869383,0.9314224696167415
9,119,4,132,0.0703125,0.9696969696969697,0.2510355311977757,0.9295147727937904
19,30,1,50,0.3877551020408163,0.98,0.26956275775660204,0.9559616592406769
25,75,1,101,0.25,0.9900990099009901,0.2763439512466563,0.9580745689443457
6,23,1,30,0.20689655172413793,0.9666666666666667,0.2777791166785635,0.9665779703048898
12,80,4,96,0.13043478260869565,0.9583333333333334,0.2266983713369486,0.9759317118014886
20,33,1,54,0.37735849056603776,0.9814814814814815,0.23788309562341858,0.9759074411350159
20,41,2,63,0.32786885245901637,0.9682539682539683,0.25008946848552915,0.9735044899047727
21,176,9,206,0.1065989847715736,0.9563106796116505,0.2552732520243254,0.971592162749727
64,162,4,230,0.2831858407079646,0.9826086956521739,0.24033478611963227,0.9719648335571804
55,87,11,153,0.3873239436619718,0.9281045751633987,0.2599524923570568,0.9631084857375246
8,55,2,65,0.12698412698412698,0.9692307692307692,0.2485364316799124,0.9634747861038251
45,177,6,228,0.20270270270270271,0.9736842105263158,0.2588604202647706,0.9656677685599652
12,50,5,67,0.1935483870967742,0.9253731343283582,0.23260183405487575,0.9576522903952335
3,10,2,15,0.23076923076923078,0.8666666666666667,0.21873045952776352,0.9431398187399047
33,52,2,87,0.38823529411764707,0.9770114942528736,0.258964218005774,0.946097077974365
16,46,3,65,0.25806451612903225,0.9538461538461539,0.25537545735164086,0.941988143430648
49,65,30,144,0.4298245614035088,0.7916666666666666,0.2614469741718604,0.9224970136454004
182,403,5,590,0.3111111111111111,0.9915254237288136,0.28775082904714383,0.9256819642879782
7,51,1,59,0.1206896551724138,0.9830508474576272,0.27603467939995974,0.9270200552781656
36,64,8,108,0.36,0.9259259259259259,0.29981348124327767,0.9270990255063895
2,0,0,2,1.0,1.0,0.40970359113338756,0.9461466445540084
0,16,1,17,0.0,0.9411764705882353,0.354241406259438,0.9410273554590602
20,83,2,105,0.1941747572815534,0.9809523809523809,0.34511429785265524,0.9448996736170926
54,92,3,149,0.3698630136986301,0.9798657718120806,0.3365483624662441,0.9717852600664375
23,36,4,63,0.3898305084745763,0.9365079365079365,0.34779399066102484,0.9639256190348836
6,23,2,31,0.20689655172413793,0.9354838709677419,0.36010926159698536,0.9571303366791858
3,20,0,23,0.13043478260869565,1.0,0.3528104278868954,0.9664038898342565
39,63,7,109,0.38235294117647056,0.9357798165137615,0.26457513376924824,0.9572295779076511
38,52,2,92,0.4222222222222222,0.9782608695652174,0.31596402265813717,0.9625273491900771
43,58,3,104,0.42574257425742573,0.9711538461538461,0.3475985225136527,0.9614139888661903
152,211,22,385,0.418732782369146,0.9428571428571428,0.34966673154511124,0.9562269140362584
15,67,13,95,0.18292682926829268,0.8631578947368421,0.3160588759860361,0.9463632718800203
3,29,1,33,0.09375,0.9696969696969697,0.2937374474146076,0.9515580770748256
0,12,2,14,0.0,0.8571428571428571,0.2751039070419367,0.9311499138095194
1,9,1,11,0.1,0.9090909090909091,0.23476777258815526,0.927337212749112
25,199,11,235,0.11160714285714286,0.9531914893617022,0.19039418982171535,0.9237558727200383
41,106,20,167,0.2789115646258503,0.8802395209580839,0.16941833130291886,0.9107681119777865
2,22,0,24,0.08333333333333333,1.0,0.12150412429780276,0.918931377283909
6,70,46,122,0.07894736842105263,0.6229508196721312,0.10664991560533989,0.8846160808460931
6,42,1,49,0.125,0.9795918367346939,0.1111142013196256,0.8860296332800538
42,132,17,191,0.2413793103448276,0.9109947643979057,0.14559695994031527,0.8937227628879179
32,105,2,139,0.23357664233576642,0.9856115107913669,0.16467933741685334,0.9046542774165547
48,89,4,141,0.35036496350364965,0.9716312056737588,0.19878759750921146,0.9072885226039913
7,95,2,104,0.06862745098039216,0.9807692307692307,0.16874700984557456,0.9216499097198695
50,163,8,221,0.2347417840375587,0.9638009049773756,0.19037678851760673,0.9164786104309232
7,71,1,79,0.08974358974358974,0.9873417721518988,0.19191910584939778,0.9685344607851756
10,41,1,52,0.19607843137254902,0.9807692307692307,0.20207316747404763,0.9687026599329666
8,21,8,37,0.27586206896551724,0.7837837837837838,0.20699927584843186,0.9505296627023778
32,123,4,159,0.2064516129032258,0.9748427672955975,0.2031242716437832,0.9489912707744107
26,92,13,131,0.22033898305084745,0.9007633587786259,0.1845491315790972,0.9388672926465347
55,56,15,126,0.4954954954954955,0.8809523809523809,0.24553028079554048,0.924607742672699
32,68,2,102,0.32,0.9803921568627451,0.2577100259330321,0.926977921513466
15,50,1,66,0.23076923076923078,0.9848484848484849,0.2778565460795523,0.9266217376129783
7,108,4,119,0.06086956521739131,0.9663865546218487,0.2585409937716726,0.9245670695919237
17,30,1,48,0.3617021276595745,0.9791666666666666,0.27080385929939504,0.9524789100037641
25,74,1,100,0.25252525252525254,0.99,0.2773858078168274,0.9546442289615359
7,21,1,29,0.25,0.9655172413793104,0.2816230959524207,0.9638947836187766
11,65,3,79,0.14473684210526316,0.9620253164556962,0.2315147168966732,0.9754766315478216
20,32,1,53,0.38461538461538464,0.9811320754716981,0.24074548612744243,0.9755823342062434
21,37,2,60,0.3620689655172414,0.9666666666666667,0.25950259109144397,0.9729849316088409
22,147,13,182,0.1301775147928994,0.9285714285714286,0.269403726745088,0.9675827707444952
61,135,4,200,0.3112244897959184,0.98,0.2621926356217085,0.9677018183635427
57,77,11,145,0.4253731343283582,0.9241379310344827,0.28688519016500935,0.9582929513684688
7,54,2,63,0.11475409836065574,0.9682539682539683,0.26756434707367444,0.9586839123505627
40,146,6,192,0.21505376344086022,0.96875,0.27760962155018826,0.9596445814283204
2,1,64,67,0.6666666666666666,0.04477611940298507,0.31790266184322863,0.8258794448470759
3,11,1,15,0.21428571428571427,0.9333333333333333,0.2967907688101533,0.821117540085171
31,39,2,72,0.44285714285714284,0.9722222222222222,0.3414592871050452,0.82735336774957
15,45,3,63,0.25,0.9523809523809523,0.33271293141991404,0.8234077895182776
50,65,29,144,0.43478260869565216,0.7986111111111112,0.33405714204381315,0.8054753866720815
180,399,5,584,0.31088082901554404,0.9914383561643836,0.36207524642308286,0.8087874420878551
6,46,1,53,0.11538461538461539,0.9811320754716981,0.34783679670076223,0.8105563100123836
35,54,8,97,0.39325842696629215,0.9175257731958762,0.30877847674356584,0.9352348319827966
2,0,0,2,1.0,1.0,0.42102337470274953,0.9447586415066062
1,15,1,17,0.0625,0.9411764705882353,0.3666866400088719,0.9403235341303223
18,75,2,95,0.1935483870967742,0.9789473684210527,0.3586221238798397,0.9441187364217651
55,86,3,144,0.3900709219858156,0.9791666666666666,0.3522347400641488,0.9699123872154158
23,32,4,59,0.41818181818181815,0.9322033898305084,0.3675634528021879,0.9614502491677195
6,22,2,30,0.21428571428571427,0.9333333333333333,0.3816921812166306,0.9546218574336675
3,20,0,23,0.13043478260869565,1.0,0.3392617160755738,0.9677123472611964
40,63,6,109,0.3883495145631068,0.944954128440367,0.2518830752988748,0.9598486513241059
41,49,2,92,0.45555555555555555,0.9782608695652174,0.3080338689496684,0.9651464226065319
44,56,3,103,0.44,0.970873786407767,0.34315176076658943,0.9637066233858728
150,212,23,385,0.4143646408839779,0.9402597402597402,0.34657371533514203,0.9580486188783957
16,66,13,95,0.1951219512195122,0.8631578947368421,0.32360082216795366,0.947570041482525
3,30,1,34,0.09090909090909091,0.9705882352941176,0.30210507653427704,0.9525849506720073
0,12,2,14,0.0,0.8571428571428571,0.2834715361616062,0.9321767874067011
1,9,1,11,0.1,0.9090909090909091,0.24227874836687666,0.9270534703567785
31,193,11,235,0.13839285714285715,0.9531914893617022,0.1969697914507769,0.9234721303277048
42,105,20,167,0.2857142857142857,0.8802395209580839,0.17492897512424627,0.9105243781206074
2,22,0,24,0.08333333333333333,1.0,0.12763878833129705,0.9190587009406445
6,70,46,122,0.07894736842105263,0.6229508196721312,0.11104241936008853,0.8847434045028286
8,40,1,49,0.16666666666666666,0.9795918367346939,0.12186493018259936,0.8860296332800538
40,135,15,190,0.22857142857142856,0.9210526315789473,0.15451799140708913,0.895159601056638
32,104,2,138,0.23529411764705882,0.9855072463768116,0.1738457224995261,0.9060762206689098
51,86,4,141,0.3722627737226277,0.9716312056737588,0.2072557105823505,0.9087104658563465
6,96,2,104,0.058823529411764705,0.9807692307692307,0.17484274539627603,0.9230718529722246
50,163,8,221,0.2347417840375587,0.9638009049773756,0.19647252406830826,0.9179005536832783
7,71,1,79,0.08974358974358974,0.9873417721518988,0.19801484140009928,0.9699564040375307
10,41,1,52,0.19607843137254902,0.9807692307692307,0.20221652207236818,0.9701246031853218
8,21,8,37,0.27586206896551724,0.7837837837837838,0.20897232784295228,0.9505147677860127
33,122,4,159,0.2129032258064516,0.9748427672955975,0.20577362900857982,0.9489912707744107
26,92,13,131,0.22033898305084745,0.9007633587786259,0.18407023034118267,0.9388672926465347
56,56,15,127,0.5,0.8818897637795275,0.24709544042521628,0.9247416545051484
31,68,2,101,0.31313131313131315,0.9801980198019802,0.25829394458146687,0.9270840994800918
17,48,1,66,0.26153846153846155,0.9848484848484849,0.28283606912359144,0.9267279155796043
8,109,4,121,0.06837606837606838,0.9669421487603306,0.26459287440980844,0.9247526181497614
18,29,1,48,0.3829787234042553,0.9791666666666666,0.2798952536153425,0.9526644585616018
24,75,1,100,0.24242424242424243,0.99,0.28411254170359834,0.9548297775193735
7,21,1,29,0.25,0.9655172413793104,0.2883498298391916,0.9640803321766142
12,62,5,79,0.16216216216216217,0.9367088607594937,0.24008728157664327,0.9719116317451808
20,32,1,53,0.38461538461538464,0.9811320754716981,0.2502992917886535,0.9720450682694263
19,39,2,60,0.3275862068965517,0.9666666666666667,0.25973468398266636,0.9694476656720237
22,152,9,183,0.12643678160919541,0.9508196721311475,0.26802907158739886,0.9671444547249974
62,136,4,202,0.31313131313131315,0.9801980198019802,0.25805087011983563,0.9672917908871851
57,78,11,146,0.4222222222222222,0.9246575342465754,0.28373629580526133,0.9579571529224101
8,53,2,63,0.13114754098360656,0.9682539682539683,0.26675737308863373,0.9583481139045041
38,149,6,193,0.20320855614973263,0.9689119170984456,0.2726211436582866,0.9629485505243542
2,1,64,67,0.6666666666666666,0.04477611940298507,0.31291418395132686,0.8291834139431097
4,10,1,15,0.2857142857142857,0.9333333333333333,0.30693248092528896,0.8244215091812048
30,38,3,71,0.4411764705882353,0.9577464788732394,0.3518952936365803,0.8254110530015037
15,45,3,63,0.25,0.9523809523809523,0.34287653461782125,0.8214371862270712
47,65,32,144,0.41964285714285715,0.7777777777777778,0.34250805389219774,0.8004543638743858
193,386,5,584,0.3333333333333333,0.9914383561643836,0.3713917385135872,0.8037664192901595
6,46,1,53,0.11538461538461539,0.9811320754716981,0.35884546126142763,0.8055121562006242
37,52,8,97,0.4157303370786517,0.9175257731958762,0.32299741417742556,0.9301906781710371
2,0,0,2,1.0,1.0,0.4250382305039561,0.9397144876948467
1,15,1,17,0.0625,0.9411764705882353,0.37094159184849396,0.9373473436541317
19,74,2,95,0.20430107526881722,0.9789473684210527,0.3644131740297536,0.9411425459455746
57,84,3,144,0.40425531914893614,0.9791666666666666,0.36221495431633627,0.969912387215416
23,32,4,59,0.41818181818181815,0.9322033898305084,0.37433616643754836,0.9614502491677196
7,21,2,30,0.25,0.9333333333333333,0.39356693566831763,0.9546218574336673
3,21,0,24,0.125,1.0,0.34090662606609917,0.9677123472611964
40,69,8,117,0.3669724770642202,0.9316239316239316,0.25047412278955916,0.9579443374931866
42,67,2,111,0.3853211009174312,0.9819819819819819,0.29659142292062074,0.9637736962637218
43,79,3,125,0.3524590163934426,0.976,0.319203459936605,0.9630662132705246
141,252,24,417,0.35877862595419846,0.9424460431654677,0.31468455522947486,0.9577205377495798
19,72,13,104,0.2087912087912088,0.875,0.2912431056379042,0.9489336896770174
3,36,1,40,0.07692307692307693,0.975,0.26774935800622546,0.95457885096734
0,12,2,14,0.0,0.8571428571428571,0.2498922151490826,0.9341706877020339
3,11,2,16,0.21428571428571427,0.875,0.2280798204664389,0.9260815546129008
32,224,12,268,0.125,0.9552238805970149,0.19089109176394872,0.9222589687007627
43,110,17,170,0.28104575163398693,0.9,0.18068919679831222,0.9114018258436198
2,24,0,26,0.07692307692307693,1.0,0.14042411836529484,0.9196238196771246
5,75,46,126,0.0625,0.6349206349206349,0.11952537425226499,0.8853267675229295
7,44,1,52,0.13725490196078433,0.9807692307692307,0.12814420640050891,0.8861509433471053
42,146,15,203,0.22340425531914893,0.9261083743842364,0.1600591000175302,0.8960031600958738
34,129,2,165,0.2085889570552147,0.9878787878787879,0.15924527755603027,0.9121287012214149
53,95,3,151,0.3581081081081081,0.9801324503311258,0.19254643585718853,0.9156870683262879
7,114,2,123,0.05785123966942149,0.983739837398374,0.16066150557653636,0.9276499022403414
50,163,8,221,0.2347417840375587,0.9638009049773756,0.18320703516431944,0.9224786029513948
8,92,1,101,0.08,0.9900990099009901,0.18570703516431947,0.9732183708057314
11,47,1,59,0.1896551724137931,0.9830508474576272,0.19319278808617785,0.9735443160469309
8,23,8,39,0.25806451612903225,0.7948717948717948,0.19814425391616122,0.9547962332594392
32,127,4,163,0.20125786163522014,0.9754601226993865,0.19709695457044768,0.9530221382338105
24,113,2,139,0.17518248175182483,0.9856115107913669,0.1709647222338358,0.953804861156702
61,64,15,140,0.488,0.8928571428571429,0.23241454513820417,0.9408216190793832
29,77,2,108,0.27358490566037735,0.9814814814814815,0.23796356251289255,0.943347415722827
17,49,1,67,0.25757575757575757,0.9850746268656716,0.26333152788085784,0.9426296467177815
9,119,4,132,0.0703125,0.9696969696969697,0.24628257467888742,0.9407219498948304
20,29,1,50,0.40816326530612246,0.98,0.26772525313275747,0.9671688363417169
25,75,1,101,0.25,0.9900990099009901,0.2746884157562975,0.969260105941946
7,22,1,30,0.2413793103448276,0.9666666666666667,0.2841451055552978,0.9665536996384174
12,81,3,96,0.12903225806451613,0.96875,0.23286399956451445,0.9773955363731114
19,34,1,54,0.3584905660377358,0.9814814814814815,0.24499337961842277,0.9773955363731112
19,41,2,62,0.31666666666666665,0.967741935483871,0.25343493805998124,0.9749194376042826
25,170,10,205,0.1282051282051282,0.9512195121951219,0.2617053135178567,0.9722798008183043
64,161,4,229,0.28444444444444444,0.982532751091703,0.2440311962519027,0.9726416224028334
56,86,11,153,0.39436619718309857,0.9281045751633987,0.2646549387066311,0.9637852745831774
7,56,2,65,0.1111111111111111,0.9692307692307692,0.2460451959589573,0.9641515749494777
44,177,6,227,0.19909502262443438,0.973568281938326,0.2560541623246599,0.9648399009406672
1,0,66,67,1.0,0.014925373134328358,0.3476983671764119,0.8267604568910739
4,10,1,15,0.2857142857142857,0.9333333333333333,0.3432765984689289,0.8218449422981401
33,52,2,87,0.38823529411764707,0.9770114942528736,0.3804237650278602,0.8255295111635331
14,47,4,65,0.22950819672131148,0.9384615384615385,0.3725757296388412,0.8192336236449381
46,65,32,143,0.4144144144144144,0.7762237762237763,0.3754397606718863,0.7975363666535634
191,391,5,587,0.3281786941580756,0.9914821124361158,0.40644941539288126,0.800715129968613
7,51,1,59,0.1206896551724138,0.9830508474576272,0.39524864861402115,0.802069782185656
39,61,8,108,0.39,0.9259259259259259,0.308105791471164,0.9322127182987413
2,0,0,2,1.0,1.0,0.41014660779769463,0.9417365278225509
1,15,1,17,0.0625,0.9411764705882353,0.3636129943523165,0.9366172387276025
20,83,2,105,0.1941747572815534,0.9809523809523809,0.3585653601466367,0.9426873590834371
57,89,3,149,0.3904109589041096,0.9798657718120806,0.35513629507373606,0.9717790727389092
21,38,4,63,0.3559322033898305,0.9365079365079365,0.3591010821068439,0.9639256190348836
7,22,2,31,0.2413793103448276,0.9354838709677419,0.37634246141718875,0.9571303366791858
3,21,0,24,0.125,1.0,0.3361198824268215,0.9677123472611964
41,70,6,117,0.36936936936936937,0.9487179487179487,0.2460297923367314,0.960386339935189
43,66,2,111,0.3944954128440367,0.9819819819819819,0.29345770845730806,0.9662156987057242
41,81,3,125,0.3360655737704918,0.976,0.31511478765059614,0.9655082157125269
140,251,26,417,0.35805626598465473,0.9376498800959233,0.31147116224331584,0.9594773740387902
18,73,13,104,0.1978021978021978,0.875,0.2888811614450826,0.9506905259662278
3,36,1,40,0.07692307692307693,0.975,0.2653874138134039,0.9563356872565504
0,12,2,14,0.0,0.8571428571428571,0.24753027095626107,0.9359275239912443
3,11,2,16,0.21428571428571427,0.875,0.22537546308716747,0.9253963884601087
31,225,12,268,0.12109375,0.9552238805970149,0.18631808268087655,0.9215738025479706
43,111,17,171,0.2792207792207792,0.9005847953216374,0.17819739774520332,0.9108002018796331
2,24,0,26,0.07692307692307693,1.0,0.13803551359354935,0.9197073618659297
4,79,43,126,0.04819277108433735,0.6587301587301587,0.1166627383481407,0.8888116702559524
8,43,1,52,0.1568627450980392,0.9807692307692307,0.12808269094456387,0.8896358460801282
41,145,17,203,0.22043010752688172,0.916256157635468,0.15957270630554699,0.8980806032933584
35,128,2,165,0.2147239263803681,0.9878787878787879,0.15963530803335466,0.9142061444188995
53,94,4,151,0.36054421768707484,0.9735099337748344,0.19384251770293678,0.9168184377300167
7,114,2,123,0.05785123966942149,0.983739837398374,0.16221829776702854,0.9286977294552647
51,162,8,221,0.23943661971830985,0.9638009049773756,0.18543451816634754,0.9235264301663183
10,90,1,101,0.1,0.9900990099009901,0.19283555086858506,0.9708648374764371
11,47,1,59,0.1896551724137931,0.9830508474576272,0.19752018334226418,0.9711907827176366
8,23,8,39,0.25806451612903225,0.7948717948717948,0.20289652742828568,0.9538501594656833
31,128,4,163,0.1949685534591195,0.9754601226993865,0.20007433129667876,0.9520760644400544
26,111,2,139,0.1897810218978102,0.9856115107913669,0.17567958904106953,0.953804861156702
62,62,16,140,0.5,0.8857142857142857,0.2388436976597236,0.9398012109161179
31,75,2,108,0.29245283018867924,0.9814814814814815,0.2464174420126335,0.9423270075595617
18,48,1,67,0.2727272727272727,0.9850746268656716,0.2710927666879582,0.9416092385545162
9,119,4,132,0.0703125,0.9696969696969697,0.25404381348598776,0.9397015417315651
20,29,1,50,0.40816326530612246,0.98,0.27548649193985775,0.9661484281784516
25,75,1,101,0.25,0.9900990099009901,0.28334812715998353,0.9682396977786807
7,22,1,30,0.2413793103448276,0.9666666666666667,0.2907193112238432,0.9655332914751521
12,81,3,96,0.12903225806451613,0.96875,0.23772391951877406,0.9773955363731114
19,34,1,54,0.3584905660377358,0.9814814814814815,0.24715788178292497,0.9773955363731112
19,41,2,62,0.31666666666666665,0.967741935483871,0.25343493805998124,0.9749194376042826
26,169,10,205,0.13333333333333333,0.9512195121951219,0.2624379142504575,0.9722798008183043
67,160,4,231,0.29515418502202645,0.9826839826839827,0.24629375992415806,0.9726632269160161
55,87,11,153,0.3873239436619718,0.9281045751633987,0.26591146616158257,0.9638068790963602
7,56,2,65,0.1111111111111111,0.9692307692307692,0.2473017234139088,0.9641731794626606
44,178,6,228,0.1981981981981982,0.9736842105263158,0.25718257200443484,0.9648780666807057
1,0,66,67,1.0,0.014925373134328358,0.34882677685618685,0.8267986226311124
4,10,1,15,0.2857142857142857,0.9333333333333333,0.34440500814870384,0.8218831080381784
32,52,3,87,0.38095238095238093,0.9655172413793104,0.37977915780856775,0.8239256407787768
14,47,4,65,0.22950819672131148,0.9384615384615385,0.3704011594798942,0.8176081487469992
46,65,33,144,0.4144144144144144,0.7708333333333334,0.37427122673024316,0.7951408284855611
190,392,5,587,0.32646048109965636,0.9914821124361158,0.4050354224428925,0.7983195918006106
7,51,1,59,0.1206896551724138,0.9830508474576272,0.393962773439209,0.799657682790798
39,61,8,108,0.39,0.9259259259259259,0.3068199162963518,0.9298006189038833
2,0,0,2,1.0,1.0,0.4088607326228825,0.939324428427693
1,15,1,17,0.0625,0.9411764705882353,0.36336753534397087,0.9358471754575393
20,83,2,105,0.1941747572815534,0.9809523809523809,0.3583199011382911,0.9419172958133739
57,89,3,149,0.3904109589041096,0.9798657718120806,0.35489083606539046,0.9717790727389092
22,37,4,63,0.3728813559322034,0.9365079365079365,0.3615223896128971,0.9639256190348836
7,22,2,31,0.2413793103448276,0.9354838709677419,0.37876376892324204,0.9571303366791858
3,21,0,24,0.125,1.0,0.3292865797839707,0.9677123472611964
36,70,11,117,0.33962264150943394,0.905982905982906,0.2349469571424612,0.954281333830183
49,60,2,111,0.44954128440366975,0.9819819819819819,0.2902385692001283,0.9601106926007181
40,82,3,125,0.32786885245901637,0.976,0.3107246882060627,0.9594032096075208
131,257,29,417,0.33762886597938147,0.9304556354916067,0.30122744205438917,0.9523446187045961
18,73,13,104,0.1978021978021978,0.875,0.2834800562682625,0.9435577706320337
3,36,1,40,0.07692307692307693,0.975,0.26491241701096807,0.9492029319223562
0,12,2,14,0.0,0.8571428571428571,0.2470552741538252,0.92879476865705
3,12,1,16,0.2,0.9375,0.22710918250962037,0.933297210659492
32,225,11,268,0.1245136186770428,0.9589552238805971,0.18067665883438797,0.9300076737878656
43,111,17,171,0.2792207792207792,0.9005847953216374,0.17372693408606835,0.9192340731195282
2,24,0,26,0.07692307692307693,1.0,0.13648324993516772,0.929168982335013
6,78,42,126,0.07142857142857142,0.6666666666666666,0.11842987473893538,0.8994070775731081
8,43,1,52,0.1568627450980392,0.9807692307692307,0.12984982733535855,0.900231253397284
41,145,17,203,0.22043010752688172,0.916256157635468,0.16133984269634166,0.9086760106105142
37,125,3,165,0.22839506172839505,0.9818181818181818,0.16539628008611237,0.915007179441683
54,94,3,151,0.36486486486486486,0.9801324503311258,0.1997321723986584,0.9180324975060443
10,111,2,123,0.08264462809917356,0.983739837398374,0.17164986509557184,0.9299117892312924
51,162,8,221,0.23943661971830985,0.9638009049773756,0.19486608549489087,0.9247404899423459
9,91,1,101,0.09,0.9900990099009901,0.19751914671938064,0.9709451104043921
12,46,1,59,0.20689655172413793,0.9830508474576272,0.20466683338025188,0.9712710556455917
7,24,8,39,0.22580645161290322,0.7948717948717948,0.2054348825353978,0.9539304323936383
33,126,4,163,0.20754716981132076,0.9754601226993865,0.20245661226153006,0.9530221382338105
26,110,3,139,0.19117647058823528,0.9784172661870504,0.17764398450772584,0.9527771119275139
65,60,15,140,0.52,0.8928571428571429,0.24012332335070102,0.9397938698501953
32,74,2,108,0.3018867924528302,0.9814814814814815,0.24904477659848964,0.942319666493639
19,47,1,67,0.2878787878787879,0.9850746268656716,0.27731317486688795,0.9416018974885934
9,119,4,132,0.0703125,0.9696969696969697,0.25780116747772536,0.9396942006656424
20,29,1,50,0.40816326530612246,0.98,0.28385214086247096,0.9661410871125289
26,74,1,101,0.26,0.9900990099009901,0.29134540231799655,0.9682323567127579
7,21,2,30,0.25,0.9333333333333333,0.29974876366253433,0.9617917948765127
11,82,3,96,0.11827956989247312,0.96875,0.24236013079003055,0.9726336316112066
20,33,1,54,0.37735849056603776,0.9814814814814815,0.2531418019490602,0.9726336316112064
19,41,2,62,0.31666666666666665,0.967741935483871,0.25725435606161434,0.9701575328423778
26,169,10,205,0.13333333333333333,0.9512195121951219,0.26625733225209053,0.9675178960563996
67,160,4,231,0.29515418502202645,0.9826839826839827,0.2501131779257911,0.9679013221541114
55,87,11,153,0.3873239436619718,0.9281045751633987,0.26830231273464417,0.9590449743344555
8,55,2,65,0.12698412698412698,0.9692307692307692,0.25072861658951945,0.9641731794626606
44,178,6,228,0.1981981981981982,0.9736842105263158,0.2621455634903373,0.9648780666807057
1,1,65,67,0.5,0.029850746268656716,0.27966577912376056,0.8289308187931593
4,10,1,15,0.2857142857142857,0.9333333333333333,0.27524401041627755,0.8240153042002254
32,53,2,87,0.3764705882352941,0.9770114942528736,0.30997790397370056,0.8276998730656185
14,48,3,65,0.22580645161290322,0.9538461538461539,0.3000710849152543,0.823580183231643
47,66,31,144,0.415929203539823,0.7847222222222222,0.3041575506120902,0.803096989954332
193,389,5,587,0.3316151202749141,0.9914821124361158,0.33339054965363124,0.8062757532693815
7,51,1,59,0.1206896551724138,0.9830508474576272,0.32231790064994775,0.8076138442595688
39,61,8,108,0.39,0.9259259259259259,0.306603614935662,0.9356245842106073
2,0,0,2,1.0,1.0,0.4086444312621926,0.9451483937344168
1,15,1,17,0.0625,0.9411764705882353,0.3637914900857221,0.9400291046394685
19,84,2,105,0.18446601941747573,0.9809523809523809,0.3578857140578039,0.943901422797501
56,90,3,149,0.3835616438356164,0.9798657718120806,0.3532617769572029,0.9717790727389092
21,38,4,63,0.3559322033898305,0.9365079365079365,0.3567356459736195,0.9639256190348836
7,22,2,31,0.2413793103448276,0.9354838709677419,0.37397702528396437,0.9571303366791858
6,18,0,24,0.25,1.0,0.36153769402726427,0.9677123472611964
40,70,6,116,0.36363636363636365,0.9482758620689655,0.2706286031181733,0.96032318469962
49,60,2,111,0.44954128440366975,0.9819819819819819,0.3259202151758404,0.9661525434701552
38,83,3,124,0.3140495867768595,0.9758064516129032,0.3402712657140049,0.9654174107073726
131,256,29,416,0.3385012919896641,0.9302884615384616,0.33285559901194123,0.9583349378111414
18,73,13,104,0.1978021978021978,0.875,0.3078442907076547,0.9495480897385791
3,36,1,40,0.07692307692307693,0.975,0.284350543075976,0.9551932510289015
0,12,2,14,0.0,0.8571428571428571,0.2486362573616903,0.9347850877635955
3,12,1,16,0.2,0.9375,0.2252596339850669,0.9332456788966005
32,224,12,268,0.125,0.9552238805970149,0.17889659335597122,0.9294230929844624
42,112,17,171,0.2727272727272727,0.9005847953216374,0.1729934056346017,0.91867714208571
3,23,0,26,0.11538461538461539,1.0,0.1411195946910233,0.9286359332945012
6,73,47,126,0.0759493670886076,0.626984126984127,0.1237120474462247,0.8932050942922336
8,43,1,52,0.1568627450980392,0.9807692307692307,0.1351320000426479,0.8940292701164093
40,146,17,203,0.21505376344086022,0.916256157635468,0.16585396624848506,0.9024740273296395
42,121,2,165,0.25766871165644173,0.9878787878787879,0.17409235362797673,0.9096709970266093
53,95,3,151,0.3581081081081081,0.9801324503311258,0.20739351192913505,0.9132293641314823
10,111,2,123,0.08264462809917356,0.983739837398374,0.18023884841083518,0.9251086558567304
50,163,8,221,0.2347417840375587,0.9638009049773756,0.19728987250411276,0.919937356567784
9,91,1,101,0.09,0.9900990099009901,0.19929710577716883,0.9718109112701931
11,47,1,59,0.1896551724137931,0.9830508474576272,0.20398173825084795,0.9721368565113926
8,23,8,39,0.25806451612903225,0.7948717948717948,0.2101261314920154,0.9547962332594393
32,126,4,162,0.20253164556962025,0.9753086419753086,0.2022494077653266,0.9530004981303708
26,110,3,139,0.19117647058823528,0.9784172661870504,0.17840203097677335,0.9527554718240744
64,61,15,140,0.512,0.8928571428571429,0.23973851267689142,0.9397722297467554
33,73,2,108,0.3113207547169811,0.9814814814814815,0.25067836563109464,0.9422980263901993
19,47,1,67,0.2878787878787879,0.9850746268656716,0.27894676389949286,0.9415802573851538
8,120,4,132,0.0625,0.9696969696969697,0.26078173926895104,0.9396725605622026
19,30,1,50,0.3877551020408163,0.98,0.2793089658277773,0.9661194470090891
28,72,1,101,0.28,0.9900990099009901,0.2903758736035459,0.9682323567127579
7,22,1,30,0.2413793103448276,0.9666666666666667,0.2975477078544876,0.9665536996384174
12,81,3,96,0.12903225806451613,0.96875,0.24283803043513275,0.9773955363731114
20,33,1,54,0.37735849056603776,0.9814814814814815,0.25227199269928374,0.9773955363731112
20,40,2,62,0.3333333333333333,0.967741935483871,0.25876549919279024,0.9749194376042826
23,167,14,204,0.12105263157894737,0.9313725490196079,0.26713016084692554,0.9694445203646594
67,160,4,231,0.29515418502202645,0.9826839826839827,0.25390145841566986,0.9698279464623712
56,86,11,153,0.39436619718309857,0.9281045751633987,0.2702394865846839,0.9609715986427153
8,55,2,65,0.12698412698412698,0.9692307692307692,0.25389731753315525,0.9613378990090157
44,178,6,228,0.1981981981981982,0.9736842105263158,0.26377816612368127,0.9620427862270607
2,1,64,67,0.6666666666666666,0.04477611940298507,0.30510790556662826,0.8282277345015613
3,11,1,15,0.21428571428571427,0.9333333333333333,0.2881011028455398,0.8233122199086275
32,53,2,87,0.3764705882352941,0.9770114942528736,0.3245893823678751,0.8298320692276653
14,48,3,65,0.22580645161290322,0.9538461538461539,0.3146825633094289,0.8257123793936898
39,69,36,144,0.3611111111111111,0.75,0.30993183672771646,0.8002688686560615
196,387,5,588,0.3361921097770154,0.9914965986394558,0.3398186914124147,0.803449701428731
7,51,1,59,0.1206896551724138,0.9830508474576272,0.32874604240873123,0.8047877924189183
40,64,4,108,0.38461538461538464,0.9629629629629629,0.28845300211569097,0.9359573414989152
2,0,0,2,1.0,1.0,0.40069790007487466,0.9454811510227247
1,15,1,17,0.0625,0.9411764705882353,0.35584495889840406,0.9403618619277764
19,84,2,105,0.18446601941747573,0.9809523809523809,0.34993918287048587,0.9442341800858088
59,87,3,149,0.4041095890410959,0.9798657718120806,0.3560818225747694,0.9770721474875346
19,40,4,63,0.3220338983050847,0.9365079365079365,0.3540592209359222,0.969216624325889
6,23,2,31,0.20689655172413793,0.9354838709677419,0.36637449187188276,0.962421341970191
6,18,0,24,0.25,1.0,0.377405461476996,0.9664864259826617
39,71,6,116,0.35454545454545455,0.9482758620689655,0.28519766926920376,0.9590972634210854
49,60,2,111,0.44954128440366975,0.9819819819819819,0.3404892813268709,0.9649266221916205
37,84,3,124,0.30578512396694213,0.9758064516129032,0.3510901636980882,0.9644159090936111
128,260,28,416,0.32989690721649484,0.9326923076923077,0.3368500840449114,0.957756189502857
18,73,13,104,0.1978021978021978,0.875,0.305367281133537,0.9495842766699273
3,36,1,40,0.07692307692307693,0.975,0.2806420064082623,0.9555366576223082
0,13,1,14,0.0,0.9285714285714286,0.2449277206939766,0.9453325759896553
3,12,1,16,0.2,0.9375,0.22284979861605453,0.94379316712266
31,231,6,268,0.1183206106870229,0.9776119402985075,0.17553255951367644,0.9431688754535923
43,111,17,171,0.2792207792207792,0.9005847953216374,0.1717376531213674,0.93242292455484
3,23,0,26,0.11538461538461539,1.0,0.1410930400025275,0.9420383091702247
4,89,33,126,0.043010752688172046,0.7380952380952381,0.11897997641480952,0.922480486040973
8,43,1,52,0.1568627450980392,0.9807692307692307,0.1303999290112327,0.9233046618651487
44,144,15,203,0.23404255319148937,0.9261083743842364,0.16383457946715976,0.9229527969812642
41,122,2,165,0.25153374233128833,0.9878787878787879,0.17119654265734383,0.9301497666782338
54,93,4,151,0.3673469387755102,0.9735099337748344,0.20677173238427057,0.9295637657462805
9,112,2,123,0.0743801652892562,0.983739837398374,0.17750878753691016,0.9414430574715287
50,164,7,221,0.2336448598130841,0.9683257918552036,0.19440310816954853,0.9369181705937006
10,90,1,101,0.1,0.9900990099009901,0.20254442921409538,0.9729187094230938
13,46,1,60,0.22033898305084745,0.9833333333333333,0.2116124632073537,0.973285009789394
8,23,8,39,0.25806451612903225,0.7948717948717948,0.21504417219843125,0.9545369270019025
33,125,4,162,0.2088607594936709,0.9753086419753086,0.20894803179305738,0.952741191872834
28,108,3,139,0.20588235294117646,0.9784172661870504,0.1858816623881525,0.9534422393602935
63,63,14,140,0.5,0.9,0.24668449591825878,0.94147940544624
32,74,2,108,0.3018867924528302,0.9814814814814815,0.2564333434382225,0.9433587896785653
19,47,1,67,0.2878787878787879,0.9850746268656716,0.2832731702780493,0.9426410206735198
12,116,4,132,0.09375,0.9696969696969697,0.265189029842214,0.940692968725468
20,29,1,50,0.40816326530612246,0.98,0.286631708296084,0.9671398551723545
29,71,1,101,0.29,0.9900990099009901,0.29822302836841674,0.9692527648760232
6,23,1,30,0.20689655172413793,0.9666666666666667,0.2983679139088398,0.9675741078016825
13,79,4,96,0.14130434782608695,0.9583333333333334,0.24712567788399506,0.975907441135016
20,33,1,54,0.37735849056603776,0.9814814814814815,0.25790734904302476,0.9759074411350159
19,41,2,62,0.31666666666666665,0.967741935483871,0.2620199031555789,0.9734313423661874
23,166,14,203,0.12169312169312169,0.9310344827586207,0.2660117776831677,0.9679081299464232
68,159,4,231,0.29955947136563876,0.9826839826839827,0.2504969499773843,0.968291556044135
57,85,11,153,0.4014084507042254,0.9281045751633987,0.2664124429351308,0.9594352082244791
8,55,2,65,0.12698412698412698,0.9692307692307692,0.2549963822579863,0.9598015085907795
43,179,6,228,0.19369369369369369,0.9736842105263158,0.2624805745247873,0.9619944910469199
12,48,7,67,0.2,0.8955223880597015,0.2371436473010676,0.9497146205580942
3,11,1,15,0.21428571428571427,0.9333333333333333,0.22251779696093157,0.94479910596516
32,53,2,87,0.3764705882352941,0.9770114942528736,0.25891457789552763,0.9513672504643392
14,48,3,65,0.22580645161290322,0.9538461538461539,0.2483784322165654,0.9472475606303635
45,71,28,144,0.3879310344827586,0.8055555555555556,0.24645308704207017,0.9297405578292431
194,389,5,588,0.33276157804459694,0.9914965986394558,0.27584986576499443,0.9329213906019127
7,51,1,59,0.1206896551724138,0.9830508474576272,0.2654207174048116,0.9342594815921
40,65,3,108,0.38095238095238093,0.9722222222222222,0.291271057540866,0.9452166007581744
2,0,0,2,1.0,1.0,0.4035159555000497,0.9547404102819839
1,15,1,17,0.0625,0.9411764705882353,0.3586630143235791,0.9496211211870355
22,81,2,105,0.21359223300970873,0.9809523809523809,0.3569181259516942,0.9534934393450679
57,89,3,149,0.3904109589041096,0.9798657718120806,0.35727240086903,0.9783948988102859
22,37,4,63,0.3728813559322034,0.9365079365079365,0.36300379771011665,0.9705393756486401
7,22,2,31,0.2413793103448276,0.9354838709677419,0.3802451770204615,0.9637440932929423
6,16,0,22,0.2727272727272727,1.0,0.36834468722766595,0.9664759878876091
38,63,7,108,0.37623762376237624,0.9351851851851852,0.27923577633657687,0.9572167286283497
40,50,2,92,0.4444444444444444,0.9782608695652174,0.3337992684000689,0.9625144999107759
37,61,3,101,0.37755102040816324,0.9702970297029703,0.3573399916802625,0.961247408915962
110,239,39,388,0.3151862464183381,0.8994845360824743,0.3454235413683967,0.949823477671384
15,67,13,95,0.18292682926829268,0.8631578947368421,0.3170104910041268,0.939959835515146
3,30,1,34,0.09090909090909091,0.9705882352941176,0.29428321827685405,0.9452819643666865
0,12,2,14,0.0,0.8571428571428571,0.2553221793158151,0.9248738011013804
1,9,1,11,0.1,0.9090909090909091,0.21585966163547562,0.9211460473736267
29,202,6,237,0.12554112554112554,0.9746835443037974,0.17030204464928728,0.9206350009077094
42,100,16,158,0.29577464788732394,0.8987341772151899,0.15861970571773876,0.9104117362665981
3,21,0,24,0.125,1.0,0.13145024194369045,0.924771088254816
6,73,43,122,0.0759493670886076,0.6475409836065574,0.1161677473465926,0.8939686723790611
6,41,1,48,0.1276595744680851,0.9791666666666666,0.1214178164264489,0.8951941625751395
42,130,17,189,0.2441860465116279,0.91005291005291,0.15630153735668145,0.90275274156229
35,104,3,142,0.2517985611510791,0.9788732394366197,0.17798704609254992,0.9127216458973916
53,87,3,143,0.37857142857142856,0.9790209790209791,0.21413423223973607,0.9133412794284175
6,96,2,104,0.058823529411764705,0.9807692307692307,0.1802840724575133,0.9250605727932805
50,163,8,221,0.2347417840375587,0.9638009049773756,0.19596147017716456,0.919889273504334
7,71,1,79,0.08974358974358974,0.9873417721518988,0.19793207341359056,0.9684322432965258
8,44,1,53,0.15384615384615385,0.9811320754716981,0.20167301332474327,0.9687130159829588
9,20,8,37,0.3103448275862069,0.7837837837837838,0.21112426776396884,0.9506745693730835
33,123,4,160,0.21153846153846154,0.975,0.2053728249621663,0.9501212494535665
30,97,3,130,0.23622047244094488,0.9769230769230769,0.18503697408638292,0.9498215491538661
57,55,15,127,0.5089285714285714,0.8818897637795275,0.24933769437449818,0.93569591101248
32,67,2,101,0.32323232323232326,0.9801980198019802,0.2619791999737503,0.9380383559874235
19,46,1,66,0.2923076923076923,0.9848484848484849,0.2909169289114792,0.9376821720869358
6,112,4,122,0.05084745762711865,0.9672131147540983,0.27620282945161706,0.9356937491272787
19,27,1,47,0.41304347826086957,0.9787234042553191,0.2908740652622831,0.9635422663374981
27,72,1,100,0.2727272727272727,0.99,0.2996153240035419,0.9656851234803552
7,21,1,29,0.25,0.9655172413793104,0.3015838279405497,0.9640557184026741
11,66,2,79,0.14285714285714285,0.9746835443037974,0.2492879095732028,0.9773119727632843
21,30,1,52,0.4117647058823529,0.9807692307692307,0.2619353928089213,0.9773935743300343
18,39,2,59,0.3157894736842105,0.9661016949152542,0.2652899330055668,0.9747154614824298
20,152,9,181,0.11627906976744186,0.9502762430939227,0.2746373061684701,0.9722959083881192
64,140,4,208,0.3137254901960784,0.9807692307692307,0.2604490221592142,0.972588169318678
57,78,11,146,0.4222222222222222,0.9246575342465754,0.2818054435156356,0.9632535313539029
8,54,2,64,0.12903225806451613,0.96875,0.26452433752485216,0.9637153540140014
39,150,6,195,0.20634920634920634,0.9692307692307692,0.27359463230943265,0.962936386146426
2,1,64,67,0.6666666666666666,0.04477611940298507,0.31000919813576316,0.8292230845226767
3,11,1,15,0.21428571428571427,0.9333333333333333,0.29550866107883517,0.8245418900109737
31,40,2,73,0.43661971830985913,0.9726027397260274,0.3412716108706091,0.8277313895298457
13,47,3,63,0.21666666666666667,0.9523809523809523,0.32740606465212163,0.8236759211886631
45,68,30,143,0.39823008849557523,0.7902097902097902,0.32397861697688635,0.8044691006119795
182,398,5,585,0.3137931034482759,0.9914529914529915,0.35037302346028065,0.807712385105264
6,46,1,53,0.11538461538461539,0.9811320754716981,0.3373780818939105,0.809412571711111
38,57,3,98,0.4,0.9693877551020408,0.2992828437986724,0.9414999482395475
2,0,0,2,1.0,1.0,0.41152774175785606,0.9510237577633571
1,15,1,17,0.0625,0.9411764705882353,0.35808206771359047,0.9465342907436725
22,73,2,97,0.23157894736842105,0.979381443298969,0.36021239352812684,0.9503915037319606
61,81,3,145,0.4295774647887324,0.9793103448275862,0.36469059014143507,0.97740586867736
23,32,4,59,0.41818181818181815,0.9322033898305084,0.3796032636747982,0.9689416398741482
7,21,2,30,0.25,0.9333333333333333,0.3988340329055674,0.9621132481400961
6,16,0,22,0.2727272727272727,1.0,0.3629790098735,0.967738017906813
37,64,7,108,0.36633663366336633,0.9351851851851852,0.2724556718254095,0.9584787586475538
42,48,2,92,0.4666666666666667,0.9782608695652174,0.33019376706350473,0.9637765299299799
36,63,3,102,0.36363636363636365,0.9705882352941176,0.3505484124181501,0.9622702670474682
103,247,40,390,0.29428571428571426,0.8974358974358975,0.3348592874530955,0.9504945707080136
14,69,12,95,0.1686746987951807,0.8736842105263158,0.3105295228741989,0.9415197527106391
3,30,1,34,0.09090909090909091,0.9705882352941176,0.2890337772405222,0.9465346619001214
0,12,2,14,0.0,0.8571428571428571,0.25007273827948323,0.9261264986348153
2,9,1,12,0.18181818181818182,0.9166666666666666,0.2237129594444569,0.9234809959893127
30,201,6,237,0.12987012987012986,0.9746835443037974,0.17559916847352305,0.9229699495233955
42,98,16,156,0.3,0.8974358974358975,0.16650825938261396,0.9125196155436498
3,21,0,24,0.125,1.0,0.14232458591322622,0.9271716301956644
7,72,43,122,0.08860759493670886,0.6475409836065574,0.1308864282191588,0.8948654549214133
6,41,1,48,0.1276595744680851,0.9791666666666666,0.1361364972990151,0.8960909451174918
43,130,17,190,0.24855491329479767,0.9105263157894737,0.1716443420554148,0.9037171534955798
37,102,3,142,0.26618705035971224,0.9788732394366197,0.18369703756134767,0.9126038067484303
53,88,3,144,0.375886524822695,0.9791666666666666,0.2188422368402856,0.9132442528002687
6,96,2,104,0.058823529411764705,0.9807692307692307,0.18438845532768053,0.9251490147050305
50,163,8,221,0.2347417840375587,0.9638009049773756,0.2000658530473318,0.9199777154160842
7,71,1,79,0.08974358974358974,0.9873417721518988,0.20022813801974332,0.9685206852082758
8,44,1,53,0.15384615384615385,0.9811320754716981,0.20396907793089603,0.9688014578947088
7,22,8,37,0.2413793103448276,0.7837837837837838,0.20294399179518602,0.950695381893896
31,125,4,160,0.1987179487179487,0.975,0.19330554870350553,0.9501420619743789
30,98,2,130,0.234375,0.9846153846153847,0.17308961658597766,0.9509204502527673
56,56,15,127,0.5,0.8818897637795275,0.23611482667001127,0.936794812111381
31,68,2,101,0.31313131313131315,0.9801980198019802,0.2473133308262619,0.9391372570863246
19,46,1,66,0.2923076923076923,0.9848484848484849,0.27625105976399084,0.9387810731858368
6,113,4,123,0.05042016806722689,0.967479674796748,0.26147591893842986,0.9368307302322726
20,26,1,47,0.43478260869565216,0.9787234042553191,0.28910496155997617,0.9646792474424919
29,70,1,100,0.29292929292929293,0.99,0.3025637250187397,0.9668221045853491
8,20,1,29,0.2857142857142857,0.9655172413793104,0.309897908692209,0.964093798408767
13,62,4,79,0.17333333333333334,0.9493670886075949,0.2632312420255424,0.9737334162413481
21,30,1,52,0.4117647058823529,0.9807692307692307,0.27732172670426236,0.9738150178080982
16,41,2,59,0.2807017543859649,0.9661016949152542,0.275663735572587,0.9711369049604939
18,157,9,184,0.10285714285714286,0.9510869565217391,0.28315473197114643,0.9687950880640639
63,141,4,208,0.3088235294117647,0.9807692307692307,0.26516057778773394,0.9690873489946227
54,81,11,146,0.4,0.9246575342465754,0.28045639308354925,0.9597527110298477
8,54,2,64,0.12903225806451613,0.96875,0.2580732462764393,0.9602145336899464
35,154,6,195,0.18518518518518517,0.9692307692307692,0.259766367969561,0.9630522023503998
2,0,65,67,1.0,0.029850746268656716,0.34379998141493917,0.8272067045646034
2,12,1,15,0.14285714285714285,0.9333333333333333,0.32410789405367885,0.8225255100529006
31,40,2,73,0.43661971830985913,0.9726027397260274,0.37178826197549547,0.8255991933677989
13,47,3,63,0.21666666666666667,0.9523809523809523,0.3586229958690529,0.8215437250266163
43,69,28,140,0.38392857142857145,0.8,0.35632707750170595,0.803735505848534
181,396,5,582,0.31369150779896016,0.9914089347079038,0.3827069703209123,0.8069724965210917
6,46,1,53,0.11538461538461539,0.9811320754716981,0.3727354603494023,0.8086726831269386
38,57,3,98,0.4,0.9693877551020408,0.2870211746351166,0.9428922558174221
2,0,0,2,1.0,1.0,0.40947015422695326,0.9524160653412316
1,15,1,17,0.0625,0.9411764705882353,0.3560244801826877,0.947926598321547
20,74,2,96,0.2127659574468085,0.9791666666666666,0.3554672360084222,0.9517531289337919
57,86,3,146,0.3986013986013986,0.9794520547945206,0.35756335417596896,0.9773891367615806
21,34,4,59,0.38181818181818183,0.9322033898305084,0.3672957361787149,0.9689312017790955
7,21,2,30,0.25,0.9333333333333333,0.38652650540948413,0.9621028100450435
7,16,0,23,0.30434782608695654,1.0,0.37129116566170595,0.9677380179068132
38,72,6,116,0.34545454545454546,0.9482758620689655,0.2777846721552124,0.9603488553452368
44,65,2,111,0.4036697247706422,0.9819819819819819,0.3265232042653042,0.9661782141157721
34,87,3,124,0.2809917355371901,0.9758064516129032,0.3336978478035841,0.9654174107073726
115,251,51,417,0.31420765027322406,0.8776978417266187,0.32085471369388807,0.9508219921237353
17,74,13,104,0.18681318681318682,0.875,0.296694854182939,0.9420351440511728
3,32,1,36,0.08571428571428572,0.9722222222222222,0.274456993521433,0.9472834799446701
0,12,2,14,0.0,0.8571428571428571,0.23097873265186777,0.9268753166793641
3,11,2,16,0.21428571428571427,0.875,0.21224032819917765,0.9164073363837975
31,231,6,268,0.1183206106870229,0.9776119402985075,0.17147616904437485,0.9157830447147297
43,111,17,171,0.2792207792207792,0.9005847953216374,0.1712231752848876,0.9050370938159774
3,23,0,26,0.11538461538461539,1.0,0.14281988458651493,0.9225088307121748
8,74,44,126,0.0975609756097561,0.6507936507936508,0.13006956870031053,0.8904793522541248
8,42,1,51,0.16,0.9803921568627451,0.14068181359826973,0.8916464857741995
44,138,17,199,0.24175824175824176,0.914572864321608,0.17521870527801855,0.8998507725140212
40,122,3,165,0.24691358024691357,0.9818181818181818,0.1798798289867613,0.9151105127737614
56,92,3,151,0.3783783783783784,0.9801324503311258,0.21703093865695494,0.9154705856355639
8,113,2,123,0.06611570247933884,0.983739837398374,0.1865873562653206,0.9273498773608121
50,163,8,221,0.2347417840375587,0.9638009049773756,0.20363838035859821,0.9221785780718658
10,92,1,103,0.09803921568627451,0.9902912621359223,0.20370670036952943,0.9706782368350474
9,50,1,60,0.15254237288135594,0.9833333333333333,0.20264132506686597,0.9710984049022743
6,25,8,39,0.1935483870967742,0.7948717948717948,0.19575420297237062,0.9539982521237296
32,127,4,163,0.20125786163522014,0.9754601226993865,0.18923195745641438,0.9530899579639016
28,109,2,139,0.20437956204379562,0.9856115107913669,0.16437498369433118,0.9538726808867933
62,63,15,140,0.496,0.8928571428571429,0.22578702619728278,0.9408894388094744
32,74,2,108,0.3018867924528302,0.9814814814814815,0.23537917025660726,0.9434152354529182
17,49,1,67,0.25757575757575757,0.9850746268656716,0.25817010481224767,0.9426700018428823
6,122,4,132,0.046875,0.9696969696969697,0.24307476582919682,0.9407219498948304
21,28,1,50,0.42857142857142855,0.98,0.2766494860398617,0.9671688363417169
28,72,1,101,0.28,0.9900990099009901,0.287898362949116,0.969260105941946
7,22,1,30,0.2413793103448276,0.9666666666666667,0.2931840412778349,0.9665536996384174
14,78,4,96,0.15217391304347827,0.9583333333333334,0.2440660288554746,0.975907441135016
22,30,1,53,0.4230769230769231,0.9811320754716981,0.26137890465891644,0.9758575259907613
16,44,2,62,0.26666666666666666,0.967741935483871,0.26267760595761774,0.9733814272219325
19,175,10,204,0.0979381443298969,0.9509803921568627,0.26997234086188876,0.9707076304304888
68,159,4,231,0.29955947136563876,0.9826839826839827,0.2515420612610616,0.9710910565282005
54,88,11,153,0.38028169014084506,0.9281045751633987,0.265868016995468,0.9622347087085447
5,57,2,64,0.08064516129032258,0.96875,0.2429059957019674,0.9625323277561637
30,192,6,228,0.13513513513513514,0.9736842105263158,0.24047188457220406,0.964725310212304
1,0,66,67,1.0,0.014925373134328358,0.3228894669897865,0.8266957813069655
3,11,1,15,0.21428571428571427,0.9333333333333333,0.3154064737925076,0.8217802667140316
30,55,2,87,0.35294117647058826,0.9770114942528736,0.3518354783840349,0.8254989955848903
15,47,3,65,0.24193548387096775,0.9538461538461539,0.34360348017051046,0.8213793057509147
33,80,28,141,0.2920353982300885,0.8014184397163121,0.3309968670404024,0.8032812864013309
182,397,5,584,0.3143350604490501,0.9914383561643836,0.364381138348792,0.8065224801391
7,51,1,59,0.1206896551724138,0.9830508474576272,0.36231749835411753,0.8078605711292873
36,69,3,108,0.34285714285714286,0.9722222222222222,0.2684399473337094,0.9446172638561293
2,0,0,2,1.0,1.0,0.38068484529289304,0.9541410733799388
1,15,1,17,0.0625,0.9411764705882353,0.3391932486542376,0.9490217842849905
23,81,2,106,0.22115384615384615,0.9811320754716981,0.3362244432660773,0.9529197730886397
59,87,3,149,0.4041095890410959,0.9798657718120806,0.35223504195336414,0.9784122491023208
20,39,4,63,0.3389830508474576,0.9365079365079365,0.3557561834388509,0.970565046294257
7,22,2,31,0.2413793103448276,0.9354838709677419,0.3729975627491958,0.9637697639385591
6,17,0,23,0.2608695652173913,1.0,0.365544345881109,0.967738017906813
38,72,6,116,0.34545454545454546,0.9482758620689655,0.2720378523746155,0.9603488553452367
44,65,2,111,0.4036697247706422,0.9819819819819819,0.3207763844847072,0.9661782141157719
37,84,3,124,0.30578512396694213,0.9758064516129032,0.3314929406558088,0.9654174107073727
109,250,58,417,0.30362116991643456,0.8609112709832134,0.3190943993718553,0.948423910588963
17,74,13,104,0.18681318681318682,0.875,0.2925132323548529,0.9396370625164009
3,32,1,36,0.08571428571428572,0.9722222222222222,0.2702753716933469,0.9448853984098979
0,12,2,14,0.0,0.8571428571428571,0.23300829094800532,0.9244772351445919
3,11,2,16,0.21428571428571427,0.875,0.21426988649531514,0.9140092548490253
30,232,6,268,0.11450381679389313,0.9776119402985075,0.17296047107006526,0.9133849631799575
43,111,17,171,0.2792207792207792,0.9005847953216374,0.16916556467775629,0.9026390122812051
3,23,0,26,0.11538461538461539,1.0,0.14227462831606782,0.9225088307121746
8,75,43,126,0.0963855421686747,0.6587301587301587,0.1293563933668518,0.8916131391021974
8,42,1,51,0.16,0.9803921568627451,0.139968638264811,0.8927802726222722
43,141,15,199,0.23369565217391305,0.9246231155778895,0.17335373143251287,0.9024203095415625
40,122,3,165,0.24691358024691357,0.9818181818181818,0.17801485514125562,0.9176800498013027
57,91,3,151,0.38513513513513514,0.9801324503311258,0.2166764720471473,0.9180401226631053
10,111,2,123,0.08264462809917356,0.983739837398374,0.18859416474406082,0.9299194143883536
50,163,8,221,0.2347417840375587,0.9638009049773756,0.20564518883733843,0.9247481150994071
9,93,1,103,0.08823529411764706,0.9902912621359223,0.20448086768719162,0.9721139870145162
10,49,1,60,0.1694915254237288,0.9833333333333333,0.20583679989058146,0.9725341550817431
6,25,8,39,0.1935483870967742,0.7948717948717948,0.20010147630813305,0.9539982521237296
33,126,4,163,0.20754716981132076,0.9754601226993865,0.19447770338876263,0.9530899579639016
29,108,2,139,0.2116788321167883,0.9856115107913669,0.1696982315289988,0.9538726808867933
63,62,15,140,0.504,0.8928571428571429,0.22989185608625973,0.9408894388094744
32,74,2,108,0.3018867924528302,0.9814814814814815,0.2394840001455842,0.9434152354529182
17,49,1,67,0.25757575757575757,0.9850746268656716,0.2636754949253143,0.9426700018428823
7,121,4,132,0.0546875,0.9696969696969697,0.24727491986478162,0.9407219498948304
21,28,1,50,0.42857142857142855,0.98,0.2808496400754465,0.9671688363417169
29,71,1,101,0.29,0.9900990099009901,0.29262861581668637,0.969260105941946
7,22,1,30,0.2413793103448276,0.9666666666666667,0.2968715412778349,0.9665536996384174
11,81,4,96,0.11956521739130435,0.9583333333333334,0.24195228661944976,0.975907441135016
22,30,1,53,0.4230769230769231,0.9811320754716981,0.2592651624228916,0.9758575259907613
16,44,2,62,0.26666666666666666,0.967741935483871,0.2605638637215929,0.9733814272219325
19,175,10,204,0.0979381443298969,0.9509803921568627,0.26674252719729247,0.9707076304304888
55,172,4,231,0.2422907488986784,0.9826839826839827,0.24013100152975672,0.9710910565282005
52,90,11,153,0.36619718309859156,0.9281045751633987,0.2510163134009841,0.9622347087085447
6,57,2,65,0.09523809523809523,0.9692307692307692,0.2301389969571652,0.9626010090748449
32,190,6,228,0.14414414414414414,0.9736842105263158,0.2336502722075709,0.9647939915309853
1,0,66,67,1.0,0.014925373134328358,0.3160678546251533,0.8267644626256468
2,12,1,15,0.14285714285714285,0.9333333333333333,0.2983807797952213,0.8218489480327129
31,54,2,87,0.36470588235294116,0.9770114942528736,0.33649045665565624,0.8255676769035716
14,48,3,65,0.22580645161290322,0.9538461538461539,0.33413555704340264,0.821447987069596
34,80,28,142,0.2982456140350877,0.8028169014084507,0.32442819003433065,0.8035497479617463
178,401,5,584,0.307426597582038,0.9914383561643836,0.3547408332263225,0.8067222603808342
7,51,1,59,0.1206896551724138,0.9830508474576272,0.3513901919446467,0.8080603513710215
36,69,3,108,0.34285714285714286,0.9722222222222222,0.25751264092423853,0.9448170440978634
2,0,0,2,1.0,1.0,0.37996162051607524,0.9543408536216729
1,15,1,17,0.0625,0.9411764705882353,0.33678935160851226,0.9492215645267246
24,80,2,106,0.23076923076923078,0.9811320754716981,0.3374983200594162,0.9531195533303737
59,87,3,149,0.4041095890410959,0.9798657718120806,0.3526217450602745,0.9784122491023208
21,38,4,63,0.3559322033898305,0.9365079365079365,0.35955111731853057,0.9705650462942571
7,22,2,31,0.2413793103448276,0.9354838709677419,0.37679249662887543,0.9637697639385591
6,17,0,23,0.2608695652173913,1.0,0.354056689701672,0.967738017906813
38,72,6,116,0.34545454545454546,0.9482758620689655,0.2605501961951785,0.9603488553452367
45,63,2,110,0.4166666666666667,0.9818181818181818,0.320074005718988,0.9661548140923719
36,85,3,124,0.2975206611570248,0.9758064516129032,0.3351044298403213,0.9653940106839727
92,247,78,417,0.2713864306784661,0.8129496402877698,0.3151655050644465,0.9415488490376427
17,74,13,104,0.18681318681318682,0.875,0.28858433804744416,0.9327620009650802
3,32,1,36,0.08571428571428572,0.9722222222222222,0.2663464773859382,0.9380103368585774
0,12,2,14,0.0,0.8571428571428571,0.22907939664059657,0.9176021735932712
3,11,2,16,0.21428571428571427,0.875,0.21034099218790642,0.9071341932977048
30,232,6,268,0.11450381679389313,0.9776119402985075,0.16717487077751017,0.9065333016520369
42,112,17,171,0.2727272727272727,0.9005847953216374,0.16363295814468845,0.8957873507532848
3,23,0,26,0.11538461538461539,1.0,0.14134698453128122,0.9225088307121746
7,71,48,126,0.08974358974358974,0.6190476190476191,0.1274798992356245,0.8859442048618346
9,41,1,51,0.18,0.9803921568627451,0.14094928699072654,0.8871113383819093
46,138,15,199,0.25,0.9246231155778895,0.17666357270501226,0.8967513753011996
39,124,3,166,0.2392638036809816,0.9819277108433735,0.18023187119005044,0.9120267625645387
57,91,3,151,0.38513513513513514,0.9801324503311258,0.21889348809594214,0.9123868354263414
9,112,2,123,0.0743801652892562,0.983739837398374,0.19055818703336835,0.9242661271515893
49,164,8,221,0.2300469483568075,0.9638009049773756,0.2069385203151101,0.9190948278626431
8,94,1,103,0.0784313725490196,0.9902912621359223,0.20532248928731436,0.972129634018115
10,49,1,60,0.1694915254237288,0.9833333333333333,0.20382127863356134,0.9725498020853419
6,25,8,39,0.1935483870967742,0.7948717948717948,0.19575676250452909,0.9540138991273285
34,125,4,163,0.2138364779874214,0.9754601226993865,0.192124287405449,0.9530899579639016
29,98,12,139,0.2283464566929134,0.9136690647482014,0.16972590477084593,0.9435951885949124
62,63,15,140,0.496,0.8928571428571429,0.2299573097295236,0.9306119465175938
31,75,2,108,0.29245283018867924,0.9814814814814815,0.2388724357055053,0.9331377431610374
18,48,1,67,0.2727272727272727,0.9850746268656716,0.2666289928738272,0.9323925095510016
6,122,4,132,0.046875,0.9696969696969697,0.24911234638472307,0.9304444576029497
21,28,1,50,0.42857142857142855,0.98,0.28268706659538795,0.9568913440498361
29,71,1,101,0.29,0.9900990099009901,0.29356756974004206,0.9589826136500651
8,21,1,30,0.27586206896551724,0.9666666666666667,0.300355514350414,0.9665536996384174
13,80,3,96,0.13978494623655913,0.96875,0.24946764952706532,0.9773955363731112
22,30,1,53,0.4230769230769231,0.9811320754716981,0.26812823422538584,0.9773456212288565
16,44,2,62,0.26666666666666666,0.967741935483871,0.26726243335958505,0.9748695224600279
20,174,10,204,0.10309278350515463,0.9509803921568627,0.2752935452888928,0.972195725668584
57,170,4,231,0.2511013215859031,0.9826839826839827,0.24994067286238916,0.9725791517662958
57,85,11,153,0.4014084507042254,0.9281045751633987,0.26585616582013566,0.9637228039466399
6,57,2,65,0.09523809523809523,0.9692307692307692,0.2400527410019325,0.9640891043129401
33,189,6,228,0.14864864864864866,0.9736842105263158,0.2413189842036596,0.9647939915309853
2,0,65,67,1.0,0.029850746268656716,0.323736566621242,0.8288966587876938
3,11,1,15,0.21428571428571427,0.9333333333333333,0.3162535734239631,0.8239811441947598
30,55,2,87,0.35294117647058826,0.9770114942528736,0.3519462009904536,0.8276998730656185
13,49,3,65,0.20967741935483872,0.9538461538461539,0.34602850067173013,0.823580183231643
35,77,30,142,0.3125,0.7887323943661971,0.33332729342826933,0.8036698716891856
190,389,5,584,0.3281519861830743,0.9914383561643836,0.3666007064204092,0.8068423841082734
7,51,1,59,0.1206896551724138,0.9830508474576272,0.36260656449523276,0.8081804750984606
36,69,3,108,0.34285714285714286,0.9722222222222222,0.26872901347482464,0.9428049716632556
2,0,0,2,1.0,1.0,0.38097391143400827,0.9523287811870652
1,15,1,17,0.0625,0.9411764705882353,0.33948231479535285,0.9472094920921169
24,80,2,106,0.23076923076923078,0.9811320754716981,0.3424954307116946,0.9511074808957661
57,89,3,149,0.3904109589041096,0.9798657718120806,0.3536255676979959,0.9784122491023208
22,37,4,63,0.3728813559322034,0.9365079365079365,0.36001547766215725,0.970565046294257
7,22,2,31,0.2413793103448276,0.9354838709677419,0.37725685697250205,0.9637697639385591
6,17,0,23,0.2608695652173913,1.0,0.36585092994418805,0.967738017906813
38,73,5,116,0.34234234234234234,0.9568965517241379,0.27189983599309414,0.9615803824388328
45,63,2,110,0.4166666666666667,0.9818181818181818,0.3314236455169037,0.9673863411859679
36,85,3,124,0.2975206611570248,0.9758064516129032,0.33958593777010504,0.9666255377775688
114,292,11,417,0.28078817733990147,0.973621103117506,0.32099011966014973,0.9657334422497724
17,74,13,104,0.18681318681318682,0.875,0.2944089526431473,0.9569465941772101
3,32,1,36,0.08571428571428572,0.9722222222222222,0.26724498360725707,0.9621949300707071
2,10,2,14,0.16666666666666666,0.8571428571428571,0.2537874266714393,0.9417867668054011
3,12,1,16,0.2,0.9375,0.23345280633681892,0.93901583084481
29,233,6,268,0.11068702290076336,0.9776119402985075,0.1897414286559756,0.9384149391991422
41,113,17,171,0.2662337662337662,0.9005847953216374,0.18527187223836725,0.9276689883003898
2,24,0,26,0.07692307692307693,1.0,0.15614828646453516,0.9314374021407461
6,80,40,126,0.06976744186046512,0.6825396825396826,0.13942746575700352,0.9039430710749865
8,42,1,51,0.16,0.9803921568627451,0.1500397106549627,0.9051102045950613
46,138,15,199,0.25,0.9246231155778895,0.16194447255972458,0.9147502415143516
37,126,3,166,0.22699386503067484,0.9819277108433735,0.16580073899267814,0.9210970573491192
55,93,3,151,0.3716216216216216,0.9801324503311258,0.20307711023851502,0.9214571302109219
8,113,2,123,0.06611570247933884,0.983739837398374,0.17448881541645395,0.9333364219361701
49,164,8,221,0.2300469483568075,0.9638009049773756,0.1963636541927012,0.9281651226472236
8,94,1,103,0.0784313725490196,0.9902912621359223,0.1976013585767804,0.972129634018115
10,49,1,60,0.1694915254237288,0.9833333333333333,0.19895729078017022,0.9725498020853419
6,25,8,39,0.1935483870967742,0.7948717948717948,0.19089277465113796,0.9540138991273283
30,128,4,162,0.189873417721519,0.9753086419753086,0.18558985360697283,0.9530683178604619
31,105,3,139,0.22794117647058823,0.9784172661870504,0.1650640757282538,0.9528232915541655
63,62,15,140,0.504,0.8928571428571429,0.22761897537406253,0.9398400494768467
30,76,2,108,0.2830188679245283,0.9814814814814815,0.2351863924551655,0.9423658461202903
19,47,1,67,0.2878787878787879,0.9850746268656716,0.26510745178798956,0.9416206125102546
7,121,4,132,0.0546875,0.9696969696969697,0.24870687672745687,0.9396725605622027
21,28,1,50,0.42857142857142855,0.98,0.28228159693812177,0.9661194470090891
29,71,1,101,0.29,0.9900990099009901,0.2965853944064762,0.9682323567127579
8,21,1,30,0.27586206896551724,0.9666666666666667,0.30343123619146606,0.9665536996384174
13,79,4,96,0.14130434782608695,0.9583333333333334,0.25161757159519277,0.9759074411350159
21,31,1,53,0.40384615384615385,0.9811320754716981,0.26887861244113925,0.9758575259907614
14,46,2,62,0.23333333333333334,0.967741935483871,0.26108640464893146,0.9733814272219325
20,173,10,203,0.10362694300518134,0.9507389162561576,0.2680777536496716,0.9706731338732452
56,170,4,230,0.24778761061946902,0.9826086956521739,0.24225149394224887,0.9710458046806986
56,86,11,153,0.39436619718309857,0.9281045751633987,0.2571609506826915,0.9621894568610426
5,58,2,65,0.07936507936507936,0.9692307692307692,0.22908995216834324,0.962555757227343
34,188,6,228,0.15315315315315314,0.9736842105263158,0.23078263864363843,0.9647487396834834
2,1,64,67,0.6666666666666666,0.04477611940298507,0.268328426189426,0.8309836031022385
2,12,1,15,0.14285714285714285,0.9333333333333333,0.25540325612139875,0.8260680885093047
29,55,3,87,0.34523809523809523,0.9655172413793104,0.289919135011815,0.8281792778126122
14,48,3,65,0.22580645161290322,0.9538461538461539,0.28677896943944853,0.8240703432688952
36,78,28,142,0.3157894736842105,0.8028169014084507,0.2755537232253216,0.8061721041610453
187,392,5,584,0.3229706390328152,0.9914383561643836,0.31035451746356957,0.8093446165801331
7,51,1,59,0.1206896551724138,0.9830508474576272,0.3057168748948925,0.8106827075703205
36,69,3,108,0.34285714285714286,0.9722222222222222,0.259458371493532,0.9431750079730686
2,0,0,2,1.0,1.0,0.3819073510853688,0.9526988174968781
0,16,1,17,0.0,0.9411764705882353,0.3325876231942123,0.9492215645267246
20,84,2,106,0.19230769230769232,0.9811320754716981,0.32780208615061074,0.9531195533303737
60,86,3,149,0.410958904109589,0.9798657718120806,0.3413977190685219,0.9784122491023208
22,37,4,63,0.3728813559322034,0.9365079365079365,0.34852782148272027,0.970565046294257
7,22,2,31,0.2413793103448276,0.9354838709677419,0.3657692007930651,0.9637697639385591
6,17,0,23,0.2608695652173913,1.0,0.3791260732905946,0.9665747912256661
39,70,7,116,0.3577981651376147,0.9396551724137931,0.28738295402453956,0.9579541015704937
47,61,2,110,0.4351851851851852,0.9818181818181818,0.3406236947652803,0.9637600603176288
35,85,3,123,0.2916666666666667,0.975609756097561,0.3531358424815097,0.9631328826172804
113,289,11,413,0.2810945273631841,0.9733656174334141,0.33293003049516373,0.9622836358466843
17,74,13,104,0.18681318681318682,0.875,0.2998773688710736,0.9541117230137546
4,30,1,35,0.11764705882352941,0.9714285714285714,0.27586776502953697,0.9595538998845028
2,11,1,14,0.15384615384615385,0.9285714285714286,0.2605787062622173,0.9493498182518498
2,12,1,15,0.14285714285714285,0.9333333333333333,0.22987284593643562,0.9484466983832128
29,233,6,268,0.11068702290076336,0.9776119402985075,0.18351596561008962,0.947845806737545
41,112,17,170,0.2679738562091503,0.9,0.18013127840187299,0.9370444130093221
2,24,0,26,0.07692307692307693,1.0,0.15096392833900057,0.9408493248045485
7,88,31,126,0.07368421052631578,0.753968253968254,0.1348026460123047,0.9235590753714419
8,42,1,51,0.16,0.9803921568627451,0.14085306618037194,0.924839587576324
43,141,15,199,0.23369565217391305,0.9246231155778895,0.1522601373700518,0.9242755428629612
37,126,3,166,0.22699386503067484,0.9819277108433735,0.1642796691091278,0.931217596792967
57,91,3,151,0.38513513513513514,0.9801324503311258,0.20348654228546664,0.9315776696547696
10,111,2,123,0.08264462809917356,0.983739837398374,0.1770109382697557,0.9435405035688229
49,165,7,221,0.22897196261682243,0.9683257918552036,0.19873220765457647,0.9390156166909949
9,93,1,103,0.08823529411764706,0.9902912621359223,0.2008109338819095,0.9727760464292333
10,49,1,60,0.1694915254237288,0.9833333333333333,0.20216686608529932,0.9731962144964602
7,24,8,39,0.22580645161290322,0.7948717948717948,0.2010398374337265,0.9546603115384468
25,133,4,162,0.15822784810126583,0.9753086419753086,0.19121612072952518,0.9537147302715802
29,108,2,139,0.2116788321167883,0.9856115107913669,0.16643664886976137,0.9544974531944719
61,64,15,140,0.488,0.8928571428571429,0.22434455914130802,0.941514211117153
29,77,2,108,0.27358490566037735,0.9814814814814815,0.2307178367189587,0.9433935953494785
20,46,1,67,0.30303030303030304,0.9850746268656716,0.26140283799219527,0.9426483617394427
2,125,4,131,0.015748031496062992,0.9694656488549618,0.23943948171681445,0.9406672639568182
22,27,1,50,0.4489795918367347,0.98,0.27132135889164755,0.9671141504037045
31,69,1,101,0.31,0.9900990099009901,0.29300309487718096,0.9692270601073734
7,22,1,30,0.2413793103448276,0.9666666666666667,0.2972460203383295,0.9665206538038448
14,79,3,96,0.15053763440860216,0.96875,0.24903711096812975,0.9773624905385387
21,31,1,53,0.40384615384615385,0.9811320754716981,0.26764586070895496,0.9773125753942838
13,47,2,62,0.21666666666666667,0.967741935483871,0.25530819837129265,0.9748364766254553
20,172,10,202,0.10416666666666667,0.9504950495049505,0.2679394319670932,0.972126391004025
56,169,5,230,0.24888888888888888,0.9782608695652174,0.23935504583168662,0.9718779437990561
56,85,12,153,0.3971631205673759,0.9215686274509803,0.2518069201984546,0.9620878891633405
6,57,2,65,0.09523809523809523,0.9692307692307692,0.2309296037546357,0.9624541895296408
35,186,6,227,0.1583710407239819,0.973568281938326,0.23204866179968994,0.9631425155208302
11,50,6,67,0.18032786885245902,0.9104477611940298,0.2001174782291621,0.9530447563383062
3,11,1,15,0.21428571428571427,0.9333333333333333,0.19977734217474036,0.9481292417453723
30,55,2,87,0.35294117647058826,0.9770114942528736,0.23531655786101485,0.9519173052807899
14,48,3,65,0.22580645161290322,0.9538461538461539,0.2320190668215883,0.9484294887494951
32,83,27,142,0.2782608695652174,0.8098591549295775,0.21503303096413712,0.9324709926750089
181,398,5,584,0.3126079447322971,0.9914383561643836,0.2460858666061659,0.9356435050940968
7,51,1,59,0.1206896551724138,0.9830508474576272,0.24070281152737052,0.9369981573111398
36,69,3,108,0.34285714285714286,0.9722222222222222,0.26392127924232534,0.9458230803151672
2,0,0,2,1.0,1.0,0.376166177201509,0.9553468898389766
0,16,1,17,0.0,0.9411764705882353,0.32574600913428203,0.9502276007440285
25,79,2,106,0.2403846153846154,0.9811320754716981,0.3278286039588124,0.9541255895476776
60,86,3,149,0.410958904109589,0.9798657718120806,0.3467854660365798,0.9784122491023208
22,37,4,63,0.3728813559322034,0.9365079365079365,0.3553959533508521,0.970565046294257
8,21,2,31,0.27586206896551724,0.9354838709677419,0.3775634410355812,0.9637697639385591
6,16,0,22,0.2727272727272727,1.0,0.3803487528932489,0.9655607095219292
37,65,6,108,0.3627450980392157,0.9444444444444444,0.2893123383274226,0.9576242015854213
43,47,2,92,0.4777777777777778,0.9782608695652174,0.34863773515281943,0.9629219728678472
34,64,3,101,0.3469387755102041,0.9702970297029703,0.36579982826694285,0.9615646942828459
106,267,11,384,0.28418230563002683,0.9713541666666666,0.3496597118473215,0.9614133190775914
14,68,13,95,0.17073170731707318,0.8631578947368421,0.31950450120430596,0.9515496769213534
9,22,1,32,0.2903225806451613,0.96875,0.31506078823524747,0.9566092007308772
2,10,2,14,0.16666666666666666,0.8571428571428571,0.29990927308373233,0.9362010374655709
1,9,1,11,0.1,0.9090909090909091,0.26237425907813006,0.9311505324150658
25,207,6,238,0.10775862068965517,0.9747899159663865,0.2095143794941125,0.9306546819009472
43,98,16,157,0.3049645390070922,0.8980891719745223,0.20351805999366795,0.9203392736540261
2,22,0,24,0.08333333333333333,1.0,0.1748253496655689,0.924431535558788
10,70,42,122,0.125,0.6557377049180327,0.1682922486202727,0.8948000798703867
6,41,1,48,0.1276595744680851,0.9791666666666666,0.1450546763092618,0.8962881751084819
46,129,14,189,0.26285714285714284,0.9259259259259259,0.1587961729079013,0.9061143277917775
37,103,3,143,0.2642857142857143,0.9790209790209791,0.1822655606630033,0.9161043377817875
57,83,3,143,0.40714285714285714,0.9790209790209791,0.22503473729917503,0.916708775361015
7,96,2,105,0.06796116504854369,0.9809523809523809,0.1911771124479538,0.9285463766435662
49,163,9,221,0.23113207547169812,0.9592760180995475,0.2122912184677202,0.9227286649435016
4,75,1,80,0.05063291139240506,0.9875,0.20166734866663522,0.9701232785266398
7,45,1,53,0.1346153846153846,0.9811320754716981,0.20266103583053516,0.9704040512130728
6,23,8,37,0.20689655172413793,0.7837837837837838,0.1946666656686773,0.9500980309070526
18,137,4,159,0.11612903225806452,0.9748427672955975,0.17350142537901306,0.9495011435177123
30,98,2,130,0.234375,0.9846153846153847,0.14882030293003345,0.9503003443169131
53,59,15,127,0.4732142857142857,0.8818897637795275,0.20671360588228233,0.9361485418636483
28,72,2,102,0.28,0.9803921568627451,0.21369473795775404,0.9391651331155336
19,46,1,66,0.2923076923076923,0.9848484848484849,0.2482197066599379,0.9387863452367459
3,115,4,122,0.025423728813559324,0.9672131147540983,0.2326208986882486,0.9367979222770887
21,25,1,47,0.45652173913043476,0.9787234042553191,0.268281639746291,0.964646439487308
31,68,1,100,0.31313131313131315,0.99,0.29642482272818366,0.9668117584450798
7,21,1,29,0.25,0.9655172413793104,0.2986569655853265,0.9640834522684977
14,60,5,79,0.1891891891891892,0.9367088607594937,0.258081951796027,0.9719147518370644
22,29,1,52,0.43137254901960786,0.9807692307692307,0.279706601655971,0.971968619537991
14,43,2,59,0.24561403508771928,0.9661016949152542,0.27303607919597483,0.9692905066903865
18,154,9,181,0.10465116279069768,0.9502762430939227,0.28435428404985175,0.9668709535960758
44,151,12,207,0.22564102564102564,0.9420289855072463,0.25137132497993614,0.9616288937749224
56,76,12,144,0.42424242424242425,0.9166666666666666,0.267244340852952,0.9511527032987319
7,55,2,64,0.11290322580645161,0.96875,0.24765908739673081,0.9516145259588306
27,158,6,191,0.14594594594594595,0.9685863874345549,0.24148148121912466,0.9561684583409821
2,1,64,67,0.6666666666666666,0.04477611940298507,0.2750949265972759,0.8224551567172327
3,10,1,14,0.23076923076923078,0.9285714285714286,0.27297424026606326,0.8170936900966862
30,41,2,73,0.4225352112676056,0.9726027397260274,0.31838624719133585,0.8202831896155584
13,47,3,63,0.21666666666666667,0.9523809523809523,0.3171041959092845,0.8217620420260878
37,75,28,140,0.33035714285714285,0.8,0.30369201285424435,0.8050953753594211
179,397,5,581,0.3107638888888889,0.9913941480206541,0.33195782186602113,0.808330253648086
6,47,1,54,0.11320754716981132,0.9814814814814815,0.3272809077551448,0.8101724099405041
37,57,3,97,0.39361702127659576,0.9690721649484536,0.28827381555656323,0.9422147021612852
2,0,0,2,1.0,1.0,0.39816392544667306,0.9524187837939382
1,15,1,17,0.0625,0.9411764705882353,0.34673032383701513,0.9479293167742536
20,78,2,100,0.20408163265306123,0.98,0.3449324618350715,0.9518748950055462
60,82,3,145,0.4225352112676056,0.9793103448275862,0.35810075732228047,0.9774906585523443
23,32,4,59,0.41818181818181815,0.9322033898305084,0.37344617579269895,0.9690348359537521
8,20,2,30,0.2857142857142857,0.9333333333333333,0.3980899955847667,0.9621565290754452
6,16,0,22,0.2727272727272727,1.0,0.37572076187078807,0.9677123472611964
36,65,7,108,0.3564356435643564,0.9351851851851852,0.2837829966656962,0.9584530880019371
42,48,2,92,0.4666666666666667,0.9782608695652174,0.34152109190379143,0.963750859284363
30,67,3,100,0.30927835051546393,0.97,0.3565774998137675,0.962186233434023
106,264,11,381,0.2864864864864865,0.9711286089238845,0.3368387787051835,0.9609380673071378
15,67,13,95,0.18292682926829268,0.8631578947368421,0.3121237252592494,0.9504594899112672
9,22,1,32,0.2903225806451613,0.96875,0.30926340426767146,0.9552117940587326
2,10,2,14,0.16666666666666666,0.8571428571428571,0.2941118891161563,0.9348036307934265
1,9,1,11,0.1,0.9090909090909091,0.2574782257498197,0.9310758770656727
24,208,6,238,0.10344827586206896,0.9747899159663865,0.20558988420630575,0.930580026551554
42,97,16,155,0.302158273381295,0.896774193548387,0.20457273032999593,0.9201191970584665
2,22,0,24,0.08333333333333333,1.0,0.1755508513081169,0.9242436814979117
10,70,42,122,0.125,0.6557377049180327,0.16727558998407505,0.8946122258095103
6,41,1,48,0.1276595744680851,0.9791666666666666,0.14403801767306418,0.8961003210476054
47,129,14,190,0.26704545454545453,0.9263157894736842,0.158377844512891,0.9059821685234378
31,108,3,142,0.22302158273381295,0.9788732394366197,0.17595235633200712,0.9159510728585395
57,83,3,143,0.40714285714285714,0.9790209790209791,0.21933729651497688,0.9165555104377671
6,95,2,103,0.0594059405940594,0.9805825242718447,0.1846583918310861,0.9285281291125466
49,163,9,221,0.23113207547169812,0.9592760180995475,0.20577249785085253,0.9227104174124819
4,75,1,80,0.05063291139240506,0.9875,0.19514862804976754,0.9701050309956202
7,45,1,53,0.1346153846153846,0.9811320754716981,0.19614231521366746,0.9703858036820533
6,23,8,37,0.20689655172413793,0.7837837837837838,0.1875496148106222,0.9500240885834961
17,138,4,159,0.10967741935483871,0.9748427672955975,0.17135759147076876,0.9494483068490643
29,98,3,130,0.2283464566929134,0.9769230769230769,0.14581524854934821,0.9491486065493638
56,57,14,127,0.49557522123893805,0.889763779527559,0.2081251457843309,0.9361745001573231
27,73,2,102,0.27,0.9803921568627451,0.21367770643123116,0.9391910914092084
20,45,1,66,0.3076923076923077,0.9848484848484849,0.25040047733121723,0.9388123035304207
7,111,4,122,0.059322033898305086,0.9672131147540983,0.23964428437163446,0.9368238805707635
21,25,1,47,0.45652173913043476,0.9787234042553191,0.2753050254296769,0.9646723977809828
32,67,1,100,0.32323232323232326,0.99,0.3058128688407461,0.9668377167387546
7,21,1,29,0.25,0.9655172413793104,0.3089062321703299,0.9652083116610736
14,62,3,79,0.18421052631578946,0.9620253164556962,0.26442556146702295,0.9755313883650933
20,31,1,52,0.39215686274509803,0.9807692307692307,0.2818765418591798,0.9755852560660198
14,43,2,59,0.24561403508771928,0.9661016949152542,0.2730082172013814,0.9729071432184153
18,154,9,181,0.10465116279069768,0.9502762430939227,0.27948380704315184,0.9704875901241047
49,151,7,207,0.245,0.966183574879227,0.249266415738804,0.96869618592752
58,74,12,144,0.4393939393939394,0.9166666666666666,0.2658609323333206,0.9582199954513294
5,58,2,65,0.07936507936507936,0.9692307692307692,0.2414845150997605,0.9587504994301094
28,160,6,194,0.14893617021276595,0.9690721649484536,0.23644532137075716,0.9597571920719318
2,1,64,67,0.6666666666666666,0.04477611940298507,0.27566100764526696,0.8260438904481824
2,11,1,14,0.15384615384615385,0.9285714285714286,0.2625513103250433,0.820682423827636
30,41,2,73,0.4225352112676056,0.9726027397260274,0.3079633172503159,0.823871923346508
13,47,3,63,0.21666666666666667,0.9523809523809523,0.3039156982026968,0.8219001201324688
36,75,28,139,0.32432432432432434,0.7985611510791367,0.2874771817641804,0.8050279036199647
178,398,5,581,0.3090277777777778,0.9913941480206541,0.3202861386802801,0.8081941005899481
6,47,1,54,0.11320754716981132,0.9814814814814815,0.3151820496741438,0.8099668600946665
36,58,3,97,0.3829787234042553,0.9690721649484536,0.27465520063665644,0.9420091523154477
2,0,0,2,1.0,1.0,0.39553432151577733,0.9522132339481006
1,15,1,17,0.0625,0.9411764705882353,0.3441007199061194,0.9477237669284161
22,75,2,99,0.2268041237113402,0.9797979797979798,0.3455489280553585,0.9516404851308485
56,85,4,145,0.3971631205673759,0.9724137931034482,0.35595447037579436,0.9764765768486072
21,34,4,59,0.38181818181818183,0.9322033898305084,0.3663530995244235,0.9680207542500151
9,19,2,30,0.32142857142857145,0.9333333333333333,0.39609896013281787,0.9611424473717083
6,18,0,24,0.25,1.0,0.3686098671931416,0.9677123472611964
36,73,6,115,0.3302752293577982,0.9478260869565217,0.27293489995854137,0.960258931112128
41,68,2,111,0.3761467889908257,0.9819819819819819,0.31774158410008785,0.9660882898826632
31,90,3,124,0.256198347107438,0.9758064516129032,0.32521513438034605,0.9653531571198807
108,292,12,412,0.27,0.970873786407767,0.30214272733533626,0.9640685877764074
18,73,13,104,0.1978021978021978,0.875,0.2843953415492096,0.955281739703845
9,25,1,35,0.2647058823529412,0.9714285714285714,0.2778754922301716,0.960416696912535
2,9,2,13,0.18181818181818182,0.8461538461538461,0.2681352324899119,0.9384386749345129
2,12,2,16,0.14285714285714285,0.875,0.24136122013267539,0.9280349482264384
24,237,7,268,0.09195402298850575,0.9738805970149254,0.20076225356091534,0.926877607516859
41,112,18,171,0.2679738562091503,0.8947368421052632,0.2024444691468743,0.9152962347300532
3,23,0,26,0.11538461538461539,1.0,0.1803565570589622,0.9194571223860865
11,73,42,126,0.13095238095238096,0.6666666666666666,0.17080658322327408,0.8896952176241817
9,41,1,51,0.18,0.9803921568627451,0.15870574288713962,0.8909757298290636
44,141,15,200,0.23783783783783785,0.925,0.1667085508899476,0.9022394660927999
39,123,2,164,0.24074074074074073,0.9878048780487805,0.18069192201617587,0.9183544486711971
59,88,3,150,0.4013605442176871,0.98,0.22489285362034464,0.9192286490976365
10,111,2,123,0.08264462809917356,0.983739837398374,0.19841724960463367,0.9319433627109379
49,163,9,221,0.23113207547169812,0.9592760180995475,0.21495260104564548,0.9261256510108733
6,96,1,103,0.058823529411764705,0.9902912621359223,0.20464847939698602,0.9723577360779097
9,50,1,60,0.15254237288135594,0.9833333333333333,0.20072596123717973,0.9727779041451367
7,24,8,39,0.22580645161290322,0.7948717948717948,0.1990071917764748,0.954188160555393
15,144,4,163,0.09433962264150944,0.9754601226993865,0.17809274633372746,0.9524246240769082
29,108,2,139,0.2116788321167883,0.9856115107913669,0.15099535889074195,0.9532262684756748
58,67,15,140,0.464,0.8928571428571429,0.20547469773371715,0.9402430263983562
26,79,2,107,0.24761904761904763,0.9813084112149533,0.2078299794690528,0.9433905111291284
21,45,1,67,0.3181818181818182,0.9850746268656716,0.24488116357906042,0.9426452775190927
8,118,4,130,0.06349206349206349,0.9692307692307692,0.2321596908091615,0.9406306255044407
22,27,1,50,0.4489795918367347,0.98,0.2640415679839946,0.9670775119513272
32,68,1,101,0.32,0.9900990099009901,0.2962787647494932,0.9691687815515563
8,21,1,30,0.27586206896551724,0.9666666666666667,0.30544779858502596,0.9664623752480276
15,77,4,96,0.16304347826086957,0.9583333333333334,0.26245400976515015,0.9758161167446262
19,32,1,52,0.37254901960784315,0.9807692307692307,0.2803011486206924,0.9757390909666659
14,45,2,61,0.23728813559322035,0.9672131147540983,0.2687449082508927,0.9731874463792982
17,172,11,200,0.08994708994708994,0.945,0.2725241977444679,0.9697259079177598
51,168,7,226,0.2328767123287671,0.9690265486725663,0.24165235781475822,0.9681582720138406
57,84,11,152,0.40425531914893614,0.9276315789473685,0.25368883197889197,0.9592343533061803
4,59,2,65,0.06349206349206349,0.9692307692307692,0.22335025976839856,0.9596006536724807
30,190,6,226,0.13636363636363635,0.9734513274336283,0.21953885378307955,0.96176036711538
1,0,66,67,1.0,0.014925373134328358,0.30917470812481623,0.8237826731675367
3,11,1,15,0.21428571428571427,0.9333333333333333,0.30588864793802967,0.8189427043931419
32,52,2,86,0.38095238095238093,0.9767441860465116,0.347460832367357,0.823477588114072
15,47,3,65,0.24193548387096775,0.9538461538461539,0.34875494258767137,0.8213089602817274
38,74,28,140,0.3392857142857143,0.8,0.3394735704643539,0.8030758775749606
176,403,5,584,0.30397236614853196,0.9914383561643836,0.373827899415278,0.8062483899940484
7,51,1,59,0.1206896551724138,0.9830508474576272,0.3715887592451033,0.8076197499974767
37,68,3,108,0.3523809523809524,0.9722222222222222,0.2790717524423822,0.9443764427243188
2,0,0,2,1.0,1.0,0.3913166504015659,0.9539002522481282
1,15,1,17,0.0625,0.9411764705882353,0.34582345312265433,0.9488191500398031
21,82,2,105,0.20388349514563106,0.9809523809523809,0.34038745473332055,0.9526914681978356
62,84,3,149,0.4246575342465753,0.9798657718120806,0.35258342901344353,0.9783865784567042
21,38,4,63,0.3559322033898305,0.9365079365079365,0.3600062629050576,0.9705393756486403
9,20,2,31,0.3103448275862069,0.9354838709677419,0.3870998589641709,0.9637440932929424
6,18,0,24,0.25,1.0,0.36178268302915967,0.9677123472611964
36,74,6,116,0.32727272727272727,0.9482758620689655,0.26567878692526353,0.96032318469962
41,68,2,111,0.3761467889908257,0.9819819819819819,0.31048547106681007,0.9661525434701552
35,86,3,124,0.2892561983471074,0.9758064516129032,0.3240685340761749,0.9654174107073727
106,295,12,413,0.26433915211970077,0.9709443099273608,0.3031228552204766,0.9641429161524127
18,73,13,104,0.1978021978021978,0.875,0.28295416192829664,0.9553560680798504
9,25,1,35,0.2647058823529412,0.9714285714285714,0.2813604209836429,0.9604910252885404
2,10,2,14,0.16666666666666666,0.8571428571428571,0.26945565907888097,0.9400828620232342
2,12,2,16,0.14285714285714285,0.875,0.24311057559094038,0.9296148817276676
24,238,6,268,0.0916030534351145,0.9776119402985075,0.20246147051155305,0.9289905900585999
41,112,18,171,0.2679738562091503,0.8947368421052632,0.19942113592041633,0.9174092172717941
3,23,0,26,0.11538461538461539,1.0,0.1781419163868327,0.921560030139314
10,72,44,126,0.12195121951219512,0.6507936507936508,0.16730606234540374,0.8895305516812642
8,42,1,51,0.16,0.9803921568627451,0.15234807915212642,0.8908110638861462
47,138,15,200,0.25405405405405407,0.925,0.16483199163603895,0.9005049414371665
40,122,2,164,0.24691358024691357,0.9878048780487805,0.17969719697743475,0.9166199240155637
60,87,3,150,0.40816326530612246,0.98,0.2249200843875787,0.9169610754014912
9,112,2,123,0.0743801652892562,0.983739837398374,0.19726384282759388,0.9296757890147928
50,162,9,221,0.2358490566037736,0.9592760180995475,0.21447304871604503,0.9238580773147281
6,96,1,103,0.058823529411764705,0.9902912621359223,0.2054548072731264,0.9723577360779098
10,49,1,60,0.1694915254237288,0.9833333333333333,0.2068107394765162,0.9727779041451367
7,24,8,39,0.22580645161290322,0.7948717948717948,0.20277536769920895,0.9541881605553931
15,144,4,163,0.09433962264150944,0.9754601226993865,0.18097908804129406,0.9524246240769083
28,109,2,139,0.20437956204379562,0.9856115107913669,0.15186713043239025,0.953226268475675
60,65,15,140,0.48,0.8928571428571429,0.20981282110535365,0.9402430263983562
26,80,2,108,0.24528301886792453,0.9814814814814815,0.21116053000023235,0.9434152354529183
21,45,1,67,0.3181818181818182,0.9850746268656716,0.24821171411023998,0.9426700018428823
7,119,4,130,0.05555555555555555,0.9692307692307692,0.23193514698621523,0.9406553498282303
22,27,1,50,0.4489795918367347,0.98,0.2638170241610483,0.9671022362751167
32,68,1,101,0.32,0.9900990099009901,0.296054220926547,0.9691935058753458
8,21,1,30,0.27586206896551724,0.9666666666666667,0.30626600762965006,0.9664870995718172
13,79,4,96,0.14130434782608695,0.9583333333333334,0.25788091446194816,0.975840841068416
21,30,1,52,0.4117647058823529,0.9807692307692307,0.2816640126068665,0.9757390909666659
13,46,2,61,0.22033898305084745,0.9672131147540983,0.2676864647310136,0.9731874463792982
17,174,11,202,0.08900523560209424,0.9455445544554455,0.27246499045194766,0.9698037014113948
52,169,5,226,0.23529411764705882,0.9778761061946902,0.24193849413913684,0.9695002880106364
58,84,11,153,0.4084507042253521,0.9281045751633987,0.25457430902847283,0.9606439401909804
3,60,2,65,0.047619047619047616,0.9692307692307692,0.22196816312183434,0.9610102405572808
31,190,6,227,0.14027149321266968,0.973568281938326,0.22182061246277476,0.9631866617865654
1,0,66,67,1.0,0.014925373134328358,0.30585422590815287,0.8252089678387222
3,11,1,15,0.21428571428571427,0.9333333333333333,0.30498947322741954,0.8203689990643273
32,53,2,87,0.3764705882352941,0.9770114942528736,0.34605595217501955,0.8248642761782454
15,47,3,65,0.24193548387096775,0.9538461538461539,0.34700471877843514,0.8214314258427403
36,75,31,142,0.32432432432432434,0.7816901408450704,0.3349866645068597,0.8005150780829791
178,401,5,584,0.307426597582038,0.9914383561643836,0.3721020287872869,0.8036875905020668
7,51,1,59,0.1206896551724138,0.9830508474576272,0.3693046233529646,0.80504224271911
37,68,3,108,0.3523809523809524,0.9722222222222222,0.27678761655024353,0.941798935445952
2,0,0,2,1.0,1.0,0.3890325145094272,0.9513227449697614
1,15,1,17,0.0625,0.9411764705882353,0.3441795733329567,0.9462034558748131
21,82,2,105,0.20388349514563106,0.9809523809523809,0.33874357494362284,0.9500757740328456
63,83,3,149,0.4315068493150685,0.9798657718120806,0.3540553642280148,0.9783865784567041
19,40,4,63,0.3220338983050847,0.9365079365079365,0.35614212147416435,0.9705393756486403
9,20,2,31,0.3103448275862069,0.9354838709677419,0.3832357175332777,0.9637440932929424
6,18,0,24,0.25,1.0,0.36688871825040437,0.9676861829493177
36,75,5,116,0.32432432432432434,0.9568965517241379,0.27036362172530787,0.9615285474813374
41,68,2,111,0.3761467889908257,0.9819819819819819,0.31517030586685435,0.9673579062518726
33,88,3,124,0.2727272727272727,0.9758064516129032,0.32471958012201096,0.9666489378009687
102,299,12,413,0.2543640897755611,0.9709443099273608,0.30626278668486023,0.9653744432460087
18,73,13,104,0.1978021978021978,0.875,0.283672785886627,0.9565875951734464
9,25,1,35,0.2647058823529412,0.9714285714285714,0.277152936567589,0.9617225523821363
2,10,2,14,0.16666666666666666,0.8571428571428571,0.26524817466282713,0.9413143891168302
3,11,2,16,0.21428571428571427,0.875,0.24952837322873994,0.9296148817276676
24,238,6,268,0.0916030534351145,0.9776119402985075,0.20887926814935262,0.9289905900586
41,112,18,171,0.2679738562091503,0.8947368421052632,0.20820020864676372,0.9174092172717941
2,24,0,26,0.07692307692307693,1.0,0.18285149252498029,0.921560030139314
10,71,45,126,0.12345679012345678,0.6428571428571429,0.17223071999944586,0.8883967648331916
9,41,1,51,0.18,0.9803921568627451,0.1601298796633114,0.8896772770380734
47,139,15,201,0.25268817204301075,0.9253731343283582,0.1724186661456463,0.8994244594931452
42,121,3,166,0.25766871165644173,0.9819277108433735,0.17861623719860734,0.9146998467564842
60,87,3,150,0.40816326530612246,0.98,0.22383912460875136,0.9150409981424117
9,112,2,123,0.0743801652892562,0.983739837398374,0.19618288304876647,0.9277557117557133
50,162,9,221,0.2358490566037736,0.9592760180995475,0.21888659443172312,0.9219380000556486
6,96,1,103,0.058823529411764705,0.9902912621359223,0.20965327147291,0.9715714456669028
9,50,1,60,0.15254237288135594,0.9833333333333333,0.20573075331310367,0.9719916137341296
7,24,8,39,0.22580645161290322,0.7948717948717948,0.20189050753737403,0.9533485652403348
16,143,4,163,0.10062893081761007,0.9754601226993865,0.17945625313182667,0.9524246240769082
28,109,2,139,0.20437956204379562,0.9856115107913669,0.15034429552292283,0.9532262684756748
60,65,15,140,0.48,0.8928571428571429,0.2082899861958862,0.9402430263983562
26,80,2,108,0.24528301886792453,0.9814814814814815,0.20963769509076488,0.9434152354529183
21,45,1,67,0.3181818181818182,0.9850746268656716,0.24668887920077257,0.9426700018428823
8,118,4,130,0.06349206349206349,0.9692307692307692,0.2339674064308736,0.9406553498282305
22,27,1,50,0.4489795918367347,0.98,0.2658492836057067,0.9671022362751167
34,66,1,101,0.34,0.9900990099009901,0.30004515063176246,0.9691935058753459
8,21,1,30,0.27586206896551724,0.9666666666666667,0.3102569373348655,0.9664870995718173
13,79,4,96,0.14130434782608695,0.9583333333333334,0.26187184416716364,0.9758408410684158
20,30,1,51,0.4,0.9803921568627451,0.2839742700431744,0.9756852232657393
13,46,2,61,0.22033898305084745,0.9672131147540983,0.26999672216732146,0.9731335786783717
17,174,11,202,0.08900523560209424,0.9455445544554455,0.273641461040183,0.9697498337104682
49,171,6,226,0.22272727272727272,0.9734513274336283,0.2413197011674027,0.9688143090581295
56,86,11,153,0.39436619718309857,0.9281045751633987,0.24908630076498822,0.9599579612384737
3,60,2,65,0.047619047619047616,0.9692307692307692,0.2164801548583497,0.960324261604774
32,189,6,227,0.14479638009049775,0.973568281938326,0.2169790166104084,0.9625006828340587
1,0,66,67,1.0,0.014925373134328358,0.3026933023246941,0.824576856587142
3,11,1,15,0.21428571428571427,0.9333333333333333,0.30182854964396083,0.8197368878127469
32,53,2,87,0.3764705882352941,0.9770114942528736,0.3428950285915608,0.8242321649266653
15,47,3,65,0.24193548387096775,0.9538461538461539,0.3456390587549457,0.8214314258427403
31,79,33,143,0.2818181818181818,0.7692307692307693,0.3295607708456719,0.7987351678523646
182,397,5,584,0.3143350604490501,0.9914383561643836,0.3676630583928152,0.8019076802714524
7,51,1,59,0.1206896551724138,0.9830508474576272,0.36421924054737465,0.8032623324884955
37,68,3,108,0.3523809523809524,0.9722222222222222,0.27170223374465347,0.9400190252153375
2,0,0,2,1.0,1.0,0.3839471317038372,0.949542834739147
1,15,1,17,0.0625,0.9411764705882353,0.33909419052736656,0.9444235456441987
20,83,2,105,0.1941747572815534,0.9809523809523809,0.3322712295860217,0.9482958638022311
60,86,3,149,0.410958904109589,0.9798657718120806,0.35071990419907983,0.9783865784567042
20,39,4,63,0.3389830508474576,0.9365079365079365,0.35424104568456666,0.9705393756486403
8,21,2,31,0.27586206896551724,0.9354838709677419,0.37640853336929575,0.9637440932929423
6,18,0,24,0.25,1.0,0.36251899681435706,0.9676861829493176
37,73,6,116,0.33636363636363636,0.9482758620689655,0.26771380200916234,0.9602970203877413
43,66,2,111,0.3944954128440367,0.9819819819819819,0.315141718129739,0.9661263791582765
36,85,3,124,0.2975206611570248,0.9758064516129032,0.329633465241807,0.9654174107073727
102,301,10,413,0.2531017369727047,0.9757869249394673,0.3090393885275358,0.9648347182969993
18,73,13,104,0.1978021978021978,0.875,0.2864493877293026,0.9560478702244369
9,25,1,35,0.2647058823529412,0.9714285714285714,0.28485564678464886,0.961182827433127
2,10,2,14,0.16666666666666666,0.8571428571428571,0.27295088487988695,0.9407746641678207
3,11,2,16,0.21428571428571427,0.875,0.2555111817258981,0.9303066838722543
24,238,6,268,0.0916030534351145,0.9776119402985075,0.21224084466748064,0.9296823922031864
41,112,18,171,0.2679738562091503,0.8947368421052632,0.20801987253206997,0.9181010194163808
2,24,0,26,0.07692307692307693,1.0,0.18285149252498029,0.921560030139314
12,70,44,126,0.14634146341463414,0.6507936507936508,0.17549995904104265,0.889530551681264
9,41,1,51,0.18,0.9803921568627451,0.16339911870490817,0.8908110638861462
46,140,15,201,0.24731182795698925,0.9253731343283582,0.17491985603209712,0.9005582463412177
37,126,3,166,0.22699386503067484,0.9819277108433735,0.17673530613852004,0.9158336336045567
59,87,3,149,0.4041095890410959,0.9798657718120806,0.22137909693937452,0.9161556095350673
10,111,2,123,0.08264462809917356,0.983739837398374,0.19490349292366357,0.9288703231483687
50,162,9,221,0.2358490566037736,0.9592760180995475,0.21760720430662023,0.923052611448304
6,96,1,103,0.058823529411764705,0.9902912621359223,0.2051046423062103,0.9715522702114858
9,50,1,60,0.15254237288135594,0.9833333333333333,0.20118212414640402,0.9719724382787127
7,24,8,39,0.22580645161290322,0.7948717948717948,0.1981099275258203,0.9533293897849179
15,144,4,163,0.09433962264150944,0.9754601226993865,0.17915932147022523,0.9524054486214911
27,100,12,139,0.2125984251968504,0.9136690647482014,0.1518005837781902,0.9429487761837941
58,67,15,140,0.464,0.8928571428571429,0.2062799226211654,0.9299655341064754
26,80,2,108,0.24528301886792453,0.9814814814814815,0.2076276315160441,0.9331377431610373
22,44,1,67,0.3333333333333333,0.9850746268656716,0.24684331779055388,0.9323925095510016
8,118,4,130,0.06349206349206349,0.9692307692307692,0.23412184502065497,0.9303778575363496
22,27,1,50,0.4489795918367347,0.98,0.266003722195488,0.956824743983236
32,68,1,101,0.32,0.9900990099009901,0.2982409189609867,0.9589160135834651
9,20,1,30,0.3103448275862069,0.9666666666666667,0.31220469073089474,0.9664870995718173
13,79,4,96,0.14130434782608695,0.9583333333333334,0.2661053118489072,0.9758408410684158
20,30,1,51,0.4,0.9803921568627451,0.288207737724918,0.9756852232657393
14,45,2,61,0.23728813559322035,0.9672131147540983,0.2744869951906161,0.9731335786783717
17,173,11,201,0.08947368421052632,0.945273631840796,0.27819865529325366,0.9697111304798041
49,172,5,226,0.22171945701357465,0.9778761061946902,0.24573292174708797,0.9694077170790456
56,86,11,153,0.39436619718309857,0.9281045751633987,0.2563566642018163,0.9605513692593897
4,59,2,65,0.06349206349206349,0.9692307692307692,0.2210919836169387,0.96091766962569
33,188,6,227,0.1493212669683258,0.973568281938326,0.22223725778011566,0.9630940908549748
1,0,66,67,1.0,0.014925373134328358,0.3079515434944014,0.8251702646080581
2,12,1,15,0.14285714285714285,0.9333333333333333,0.29446140167496176,0.8203302958336629
32,53,2,87,0.3764705882352941,0.9770114942528736,0.3354609593927857,0.8248642761782455
15,47,3,65,0.24193548387096775,0.9538461538461539,0.3383489632295561,0.8214314258427403
32,80,31,143,0.2857142857142857,0.7832167832167832,0.32282726159115427,0.8007331698503667
179,400,5,584,0.30915371329879104,0.9914383561643836,0.3579217829921154,0.8039056822694545
7,51,1,59,0.1206896551724138,0.9830508474576272,0.3538315527355565,0.8052603344864975
37,68,3,108,0.3523809523809524,0.9722222222222222,0.26131454593283543,0.9420170272133394
2,0,0,2,1.0,1.0,0.3837635255246722,0.9515408367371491
1,15,1,17,0.0625,0.9411764705882353,0.3389105843482016,0.9464215476422007
21,81,2,104,0.20588235294117646,0.9807692307692307,0.3337601370725171,0.9502677014883545
56,90,3,149,0.3835616438356164,0.9798657718120806,0.34773833108985003,0.9783604141448256
21,38,4,63,0.3559322033898305,0.9365079365079365,0.3544209725314271,0.9705132113367617
9,20,2,31,0.3103448275862069,0.9354838709677419,0.38151456859054045,0.9637179289810638
6,18,0,24,0.25,1.0,0.3670621168227943,0.9665661754777967
37,75,4,116,0.33035714285714285,0.9655172413793104,0.2713988515166719,0.9616400671034124
46,63,2,111,0.42201834862385323,0.9819819819819819,0.3227586156057938,0.9674694258739477
38,83,3,124,0.3140495867768595,0.9758064516129032,0.33816776128672954,0.9668992075617938
96,306,11,413,0.23880597014925373,0.9733656174334141,0.3123428399394202,0.9660297165102073
18,73,13,104,0.1978021978021978,0.875,0.2912496474176562,0.9578578036772775
9,25,1,35,0.2647058823529412,0.9714285714285714,0.2882484469374641,0.9632999805480257
2,11,1,14,0.15384615384615385,0.9285714285714286,0.27451218320120035,0.9530958989153727
3,12,1,16,0.2,0.9375,0.25588973422160854,0.9490934358611856
24,238,6,268,0.0916030534351145,0.9776119402985075,0.20868754919464585,0.9484691441921178
41,112,18,171,0.2679738562091503,0.8947368421052632,0.2021053019706874,0.936887771405312
2,23,0,25,0.08,1.0,0.1794187348065083,0.9406926832005384
14,90,22,126,0.1346153846153846,0.8253968253968254,0.17039204720839216,0.9336065154000849
9,41,1,51,0.18,0.9803921568627451,0.15829120687225767,0.934887027604967
45,140,16,201,0.24324324324324326,0.9203980099502488,0.17106221964327045,0.9337193963733699
38,125,3,166,0.2331288343558282,0.9819277108433735,0.17579491026553162,0.9400662122081375
60,86,3,149,0.410958904109589,0.9798657718120806,0.22141717464759939,0.9403881881386479
8,113,2,123,0.06611570247933884,0.983739837398374,0.19258029554334063,0.9531029017519496
50,163,8,221,0.2347417840375587,0.9638009049773756,0.2146862646915633,0.9479316024630032
6,96,1,103,0.058823529411764705,0.9902912621359223,0.20385885680533186,0.9714879505685884
8,51,1,60,0.13559322033898305,0.9833333333333333,0.1975150311394723,0.9719081186358153
8,23,8,39,0.25806451612903225,0.7948717948717948,0.19963235583744218,0.9539758021960362
16,143,4,163,0.10062893081761007,0.9754601226993865,0.1807037981891253,0.9530518610326094
26,111,2,139,0.1897810218978102,0.9856115107913669,0.1491069578731569,0.9538726808867933
60,65,15,140,0.48,0.8928571428571429,0.20823328609039418,0.9408894388094744
26,80,2,108,0.24528301886792453,0.9814814814814815,0.20973917678044646,0.9434152354529182
21,45,1,67,0.3181818181818182,0.9850746268656716,0.24679036089045409,0.9426700018428823
8,118,4,130,0.06349206349206349,0.9692307692307692,0.23649019562660847,0.9406553498282303
23,26,1,50,0.46938775510204084,0.98,0.2666792297656097,0.9671022362751168
33,67,1,101,0.33,0.9900990099009901,0.29944652536309396,0.9691935058753459
9,20,1,30,0.3103448275862069,0.9666666666666667,0.31666992617572204,0.9664870995718173
15,77,4,96,0.16304347826086957,0.9583333333333334,0.271390423070132,0.9758408410684158
19,31,1,51,0.38,0.9803921568627451,0.29063570608899997,0.9756852232657394
15,44,2,61,0.2542372881355932,0.9672131147540983,0.2815007732252535,0.9731335786783717
17,173,11,201,0.08947368421052632,0.945273631840796,0.28521243332789104,0.9697111304798042
48,173,5,226,0.2171945701357466,0.9778761061946902,0.24918483547556328,0.9694077170790455
56,86,11,153,0.39436619718309857,0.9281045751633987,0.2583800065017202,0.9605513692593897
6,56,2,64,0.0967741935483871,0.96875,0.22786991592488884,0.9608489883070087
32,189,6,227,0.14479638009049775,0.973568281938326,0.2252631876148357,0.9630254095362935
11,50,6,67,0.18032786885245902,0.9104477611940298,0.19673859745090128,0.9530333530121912
2,12,1,15,0.14285714285714285,0.9333333333333333,0.1808271481254084,0.9481933842377962
32,53,2,87,0.3764705882352941,0.9770114942528736,0.22182670584323233,0.9527273645823786
15,47,3,65,0.24193548387096775,0.9538461538461539,0.22536112209112108,0.9492945142468735
34,78,31,143,0.30357142857142855,0.7832167832167832,0.21239044086088252,0.9285962582544999
184,395,5,584,0.3177892918825561,0.9914383561643836,0.24396402633719236,0.931837451992269
7,51,1,59,0.1206896551724138,0.9830508474576272,0.2405202084917518,0.933192104209312
37,68,3,108,0.3523809523809524,0.9722222222222222,0.2650992204243937,0.9420170272133396
2,0,0,2,1.0,1.0,0.3875482000162304,0.9515408367371491
1,15,1,17,0.0625,0.9411764705882353,0.3426952588397599,0.9464215476422007
20,82,2,104,0.19607843137254902,0.9807692307692307,0.33614425133998577,0.9502677014883545
58,88,3,149,0.3972602739726027,0.9798657718120806,0.3495283721115821,0.9783604141448256
21,38,4,63,0.3559322033898305,0.9365079365079365,0.35497735946976416,0.9705132113367616
8,21,2,31,0.27586206896551724,0.9354838709677419,0.37714484715449315,0.9637179289810637
6,16,0,22,0.2727272727272727,1.0,0.38272541994346515,0.9659814601796187
37,65,6,108,0.3627450980392157,0.9444444444444444,0.29168900537763875,0.9580449522431106
43,50,2,95,0.46236559139784944,0.9789473684210527,0.3482174231963792,0.9639660048746895
35,64,3,102,0.35353535353535354,0.9705882352941176,0.3671435263330087,0.9627098323025679
94,278,11,383,0.25268817204301075,0.9712793733681462,0.3413037746868054,0.9615423063845145
13,69,13,95,0.15853658536585366,0.8631578947368421,0.3120038063624468,0.9516786642282764
9,22,1,32,0.2903225806451613,0.96875,0.3075600933933882,0.9567381880378003
2,10,2,14,0.16666666666666666,0.8571428571428571,0.29240857824187305,0.9363300247724943
1,9,1,11,0.1,0.9090909090909091,0.25487356423627083,0.9312795197219891
27,206,6,239,0.11587982832618025,0.9748953974895398,0.20537559808317524,0.930700666731773
41,106,18,165,0.2789115646258503,0.8909090909090909,0.19471505681038906,0.9193179318196264
2,21,0,23,0.08695652173913043,1.0,0.1710391067669776,0.9234208784813198
14,69,39,122,0.1686746987951807,0.680327868852459,0.17248740868545287,0.8973023033549793
7,40,1,48,0.14893617021276595,0.9791666666666666,0.15228935005225352,0.8987903985930746
43,135,16,194,0.24157303370786518,0.9175257731958762,0.16299025962956762,0.9074165294577915
34,105,3,142,0.2446043165467626,0.9788732394366197,0.18364801913624798,0.9173854337928932
57,82,3,142,0.41007194244604317,0.9788732394366197,0.2256754640105141,0.9179536969281903
4,99,2,105,0.038834951456310676,0.9809523809523809,0.19137880498629414,0.9308170240772318
50,162,9,221,0.2358490566037736,0.9592760180995475,0.2126491671098146,0.9249993123771671
2,77,1,80,0.02531645569620253,0.9875,0.19216941809567487,0.9688810453982443
7,45,1,53,0.1346153846153846,0.9811320754716981,0.19012359158176326,0.9691618180846773
8,22,8,38,0.26666666666666666,0.7894736842105263,0.19370839629016348,0.9508686625153417
17,139,4,160,0.10897435897435898,0.975,0.17433268806553434,0.9503153425958245
28,100,2,130,0.21875,0.9846153846153847,0.14700098200181394,0.9511356490499338
57,55,14,126,0.5089285714285714,0.8888888888888888,0.2141572134264226,0.937983721612292
25,74,2,101,0.25252525252525254,0.9801980198019802,0.216539527129491,0.9409725789983538
20,45,1,66,0.3076923076923077,0.9848484848484849,0.25687893455750604,0.940593791119566
6,111,4,121,0.05128205128205128,0.9669421487603306,0.24497417265274415,0.9385666587322278
23,23,1,47,0.5,0.9787234042553191,0.27830750598607745,0.9656023330243411
33,66,1,100,0.3333333333333333,0.99,0.31035878803735956,0.9677451901671982
7,21,1,29,0.25,0.9655172413793104,0.31482307375164525,0.9650168839906161
11,64,4,79,0.14666666666666667,0.9493670886075949,0.2630713730713731,0.973656626807574
19,30,1,50,0.3877551020408163,0.98,0.2823899230021679,0.9736283382644341
13,44,2,59,0.22807017543859648,0.9661016949152542,0.2710153326802092,0.9709502254168297
16,158,9,183,0.09195402298850575,0.9508196721311475,0.27682561435255987,0.9686470144698036
46,151,5,202,0.233502538071066,0.9752475247524752,0.23875454836271212,0.9681504602551116
57,79,11,147,0.41911764705882354,0.9251700680272109,0.2510094503234965,0.9588890414018562
4,57,2,63,0.06557377049180328,0.9682539682539683,0.22466284610803977,0.95928000238395
29,160,6,195,0.15343915343915343,0.9692307692307692,0.22563034421839503,0.9621176710444035
2,0,65,67,1.0,0.029850746268656716,0.313093901069707,0.8263820633684974
2,12,1,15,0.14285714285714285,0.9333333333333333,0.30092061070092796,0.8217008688567943
31,40,2,73,0.43661971830985913,0.9726027397260274,0.350158567175407,0.824812735656063
14,46,3,63,0.23333333333333334,0.9523809523809523,0.3501343950700166,0.8215460824601309
25,87,31,143,0.22321428571428573,0.7832167832167832,0.32214820059222543,0.801267041772927
187,389,5,581,0.3246527777777778,0.9913941480206541,0.35915948734736464,0.8045727817395966
5,47,1,53,0.09615384615384616,0.9811320754716981,0.35097587202089214,0.8062729683454435
37,57,3,97,0.39361702127659576,0.9690721649484536,0.264349732203263,0.9404474567282716
2,0,0,2,1.0,1.0,0.3867987117950998,0.9499712662520812
1,15,1,17,0.0625,0.9411764705882353,0.3333530377508342,0.9454817992323965
20,77,2,99,0.20618556701030927,0.9797979797979798,0.3294747854189736,0.9493985174348291
60,83,3,146,0.4195804195804196,0.9794520547945206,0.3575270902569927,0.9774321276602201
19,36,4,59,0.34545454545454546,0.9322033898305084,0.36049877135367375,0.9689763050616279
8,20,2,30,0.2857142857142857,0.9333333333333333,0.38757883414802224,0.9621479133275758
6,16,0,22,0.2727272727272727,1.0,0.3725077299079618,0.9671871371771628
37,65,6,108,0.3627450980392157,0.9444444444444444,0.28147131534213554,0.9592506292406549
43,49,2,94,0.4673913043478261,0.9787234042553191,0.33871769215372977,0.9651396869914147
33,66,3,102,0.3333333333333333,0.9705882352941176,0.3585974887325554,0.9636590947545199
95,276,11,382,0.2560646900269542,0.9712041884816754,0.33451279670118106,0.9624217257073191
12,70,13,95,0.14634146341463414,0.8631578947368421,0.30699256992506335,0.9519431483114484
9,22,1,32,0.2903225806451613,0.96875,0.30413224893348545,0.956695452458914
2,10,2,14,0.16666666666666666,0.8571428571428571,0.28898073378197026,0.9362872891936078
1,9,1,11,0.1,0.9090909090909091,0.25144571977636804,0.9312367841431028
30,202,6,238,0.12931034482758622,0.9747899159663865,0.2031484398449052,0.9306748572446839
40,100,18,158,0.2857142857142857,0.8860759493670886,0.19634571875646983,0.9186016735408226
2,21,0,23,0.08695652173913043,1.0,0.17218740900106644,0.9227153609005833
10,77,35,122,0.11494252873563218,0.7131147540983607,0.16770184690406612,0.9012806265236574
8,39,1,48,0.1702127659574468,0.9791666666666666,0.15054330194867835,0.9027687217617526
44,131,15,190,0.25142857142857145,0.9210526315789473,0.16265214548609333,0.9118986895383367
30,107,3,140,0.21897810218978103,0.9785714285714285,0.17964901722749063,0.9218244780355539
60,80,3,143,0.42857142857142855,0.9790209790209791,0.2224006006194681,0.9224289156147814
5,98,2,105,0.04854368932038835,0.9809523809523809,0.1885190868489113,0.9359826915555375
49,162,10,221,0.23222748815165878,0.9547511312217195,0.20927208205070108,0.9295185674443546
2,77,1,80,0.02531645569620253,0.9875,0.19646835733078258,0.9687164597160173
6,46,1,53,0.11538461538461539,0.9811320754716981,0.18863576439180663,0.9689972324024503
8,22,8,38,0.26666666666666666,0.7894736842105263,0.190812635140106,0.9502002399212474
19,137,4,160,0.12179487179487179,0.975,0.1769293165122618,0.9496900358396146
28,100,2,130,0.21875,0.9846153846153847,0.1469548267163434,0.9504892366388155
57,54,15,126,0.5135135135135135,0.8809523809523809,0.21337908731536132,0.9362035223531012
24,75,2,101,0.24242424242424243,0.9801980198019802,0.21483576649715896,0.9398387921502813
18,47,1,66,0.27692307692307694,0.9848484848484849,0.2507795695295696,0.9394600042714935
6,113,4,123,0.05042016806722689,0.967479674796748,0.2414989341985141,0.9375096613179291
23,23,1,47,0.5,0.9787234042553191,0.2748322675318474,0.9645453356100424
33,66,1,100,0.3333333333333333,0.99,0.3050520477516277,0.9666881927528995
7,21,1,29,0.25,0.9655172413793104,0.3095163334659134,0.9639598865763175
12,64,3,79,0.15789473684210525,0.9620253164556962,0.2587136510842836,0.9755417345053624
20,29,1,50,0.40816326530612246,0.98,0.2823906543531236,0.9755134459622224
13,44,2,59,0.22807017543859648,0.9661016949152542,0.27541166842676923,0.9728353331146182
15,156,9,180,0.08771929824561403,0.95,0.28074011559511025,0.9703382367150828
42,153,6,201,0.2153846153846154,0.9701492537313433,0.24008077493576963,0.9691133580688004
59,76,11,146,0.43703703703703706,0.9246575342465754,0.2548955897505844,0.9597787201040255
5,57,2,64,0.08064516129032258,0.96875,0.23070204136348768,0.9602405427641241
30,159,6,195,0.15873015873015872,0.9692307692307692,0.2308213873474953,0.9612698931605631
2,1,64,67,0.6666666666666666,0.04477611940298507,0.2677504446847159,0.8276664816467038
3,11,1,15,0.21428571428571427,0.9333333333333333,0.2657812359485899,0.8229852871350009
31,39,2,72,0.44285714285714284,0.9722222222222222,0.3165152137502369,0.8261598903096038
14,46,3,63,0.23333333333333334,0.9523809523809523,0.31907931631433945,0.8236215615452623
30,83,30,143,0.26548672566371684,0.7902097902097902,0.29457212897529367,0.8044147409685787
183,394,5,582,0.317157712305026,0.9914089347079038,0.32835963626310843,0.8076517316411364
5,47,1,53,0.09615384615384616,0.9811320754716981,0.319420163037921,0.8093519182469835
38,56,3,97,0.40425531914893614,0.9690721649484536,0.2819328276782452,0.9413942104677647
2,0,0,2,1.0,1.0,0.39417772563742887,0.9509180199915742
1,14,1,16,0.06666666666666667,0.9375,0.34043622903878934,0.9459577025312568
21,74,2,97,0.22105263157894736,0.979381443298969,0.3386818430738771,0.9498149155195448
62,81,3,146,0.43356643356643354,0.9794520547945206,0.36269322991712233,0.976849524745935
20,35,4,59,0.36363636363636365,0.9322033898305084,0.3693330372501706,0.96839158976345
9,19,2,30,0.32142857142857145,0.9333333333333333,0.40151514086084555,0.9615631980293976
5,17,0,22,0.22727272727272727,1.0,0.36201071724845557,0.9671871371771628
35,75,6,116,0.3181818181818182,0.9482758620689655,0.2646081198458582,0.9597979746155864
41,69,2,112,0.37272727272727274,0.9821428571428571,0.30833106356880186,0.9661755256359944
35,78,9,122,0.30973451327433627,0.9262295081967213,0.3234526375871884,0.9583579723851859
92,308,11,411,0.23,0.9732360097323601,0.2936874712466796,0.9574108635166546
13,78,13,104,0.14285714285714285,0.875,0.2680907918969736,0.9486240154440921
9,25,1,35,0.2647058823529412,0.9714285714285714,0.26649705095231985,0.9537589726527821
2,10,2,14,0.16666666666666666,0.8571428571428571,0.2578390422943112,0.9333508093874759
3,12,1,16,0.2,0.9375,0.24095592541119432,0.9318114005204808
31,230,6,267,0.11877394636015326,0.9775280898876404,0.20467687878732008,0.9311521480554499
40,110,20,170,0.26666666666666666,0.8823529411764706,0.19852432927193872,0.924884067052557
2,23,0,25,0.08,1.0,0.17709575784336726,0.9287074942336483
11,75,40,126,0.12790697674418605,0.6825396825396826,0.17496001982723058,0.9012131631678887
11,39,1,51,0.22,0.9803921568627451,0.16857346520538186,0.9024936753727707
41,142,16,199,0.22404371584699453,0.9195979899497487,0.17677018651685725,0.9114158372023267
30,132,3,165,0.18518518518518517,0.9818181818181818,0.17465378440045518,0.9177470060334955
61,85,3,149,0.4178082191780822,0.9798657718120806,0.2173729662315879,0.9180809605941297
9,112,2,123,0.0743801652892562,0.983739837398374,0.18990346603481495,0.9325648029115445
49,163,10,222,0.23113207547169812,0.954954954954955,0.21149376253077182,0.9261297964765381
5,96,1,102,0.04950495049504951,0.9901960784313726,0.20029347306660947,0.9700807101753509
8,51,1,60,0.13559322033898305,0.9833333333333333,0.18823536168646418,0.9705008782425778
8,23,8,39,0.25806451612903225,0.7948717948717948,0.1930954760124696,0.9526828503742987
17,142,4,163,0.1069182389937107,0.9754601226993865,0.1819144836994018,0.9517745562144709
27,111,2,140,0.1956521739130435,0.9857142857142858,0.15017790580439624,0.9526100582005002
62,63,15,140,0.496,0.8928571428571429,0.21040931076307395,0.9396268161231814
23,83,2,108,0.2169811320754717,0.9814814814814815,0.20838774742075586,0.9434163199126852
19,47,1,67,0.2878787878787879,0.9850746268656716,0.24244115276128994,0.9426846839747279
7,120,4,131,0.05511811023622047,0.9694656488549618,0.23094470846089526,0.9407035861921035
23,26,1,50,0.46938775510204084,0.98,0.2611337425998965,0.96715047263899
28,71,1,100,0.2828282828282828,0.99,0.2862637488619782,0.9692275979676489
7,22,1,30,0.2413793103448276,0.9666666666666667,0.2927961969236617,0.9665065095322748
12,79,5,96,0.13186813186813187,0.9479166666666666,0.2407773586191091,0.9743721557907782
21,29,1,51,0.42,0.9803921568627451,0.26978005403689886,0.9742165379881016
12,48,2,62,0.2,0.967741935483871,0.25722594148278627,0.9717404392192729
16,172,12,200,0.0851063829787234,0.94,0.261509980446001,0.9675310608114212
46,171,5,222,0.2119815668202765,0.9774774774774775,0.2247376678343204,0.9671707004510608
57,84,11,152,0.40425531914893614,0.9276315789473685,0.24208438730869938,0.9582609260149706
5,57,2,64,0.08064516129032258,0.96875,0.2191223660151987,0.9585585450625896
33,188,6,227,0.1493212669683258,0.973568281938326,0.2216156710295121,0.9622230615299695
1,0,66,67,1.0,0.014925373134328358,0.304472813886655,0.8242992352830528
2,12,1,15,0.14285714285714285,0.9333333333333333,0.29630954858053254,0.819383720690119
31,54,2,87,0.36470588235294116,0.9770114942528736,0.3362523342054208,0.8246710770119581
14,46,5,65,0.23333333333333334,0.9230769230769231,0.3393025865644289,0.8168995692404504
26,86,31,143,0.23214285714285715,0.7832167832167832,0.3147150919921319,0.796268884136081
175,405,5,585,0.3017241379310345,0.9914529914529915,0.3462978029408051,0.7995121686293655
7,51,1,59,0.1206896551724138,0.9830508474576272,0.3422075726842461,0.8008668208464086
41,64,3,108,0.3904761904761905,0.9722222222222222,0.2551327427522734,0.9376235135732506
2,0,0,2,1.0,1.0,0.37758172234411014,0.9471473230970601
1,14,1,16,0.06666666666666667,0.9375,0.3350046915317852,0.9415028239180779
20,83,2,105,0.1941747572815534,0.9809523809523809,0.32941060923867377,0.9497707464717148
62,84,3,149,0.4246575342465753,0.9798657718120806,0.3569127059677763,0.977863459128186
20,39,4,63,0.3389830508474576,0.9365079365079365,0.36223540781297964,0.9700141655646066
9,20,2,31,0.3103448275862069,0.9354838709677419,0.389329003872093,0.9632188832089087
5,18,0,23,0.21739130434782608,1.0,0.36111731278921205,0.9671871371771628
35,74,7,116,0.3211009174311927,0.9396551724137931,0.2641317295650967,0.9585664475219903
42,68,2,112,0.38181818181818183,0.9821428571428571,0.3091533745867417,0.9649439985423985
33,86,3,122,0.2773109243697479,0.9754098360655737,0.3279647826451107,0.9641522064157116
91,310,11,412,0.22693266832917705,0.9733009708737864,0.29384753174105965,0.9632143777102412
13,78,13,104,0.14285714285714285,0.875,0.26825085239135366,0.9544275296376787
9,25,1,35,0.2647058823529412,0.9714285714285714,0.2617310030723157,0.9595624868463687
2,10,2,14,0.16666666666666666,0.8571428571428571,0.25448462626072155,0.9391543235810625
3,12,1,16,0.2,0.9375,0.23718449519912257,0.9388464418076635
31,230,6,267,0.11877394636015326,0.9775280898876404,0.19960674727654704,0.9381871893426326
40,111,20,171,0.26490066225165565,0.8830409356725146,0.19783385268824816,0.9249916321436241
3,22,0,25,0.12,1.0,0.1825577572126514,0.9288057791616546
11,80,35,126,0.12087912087912088,0.7222222222222222,0.17941803978721974,0.9069803823362578
10,40,1,51,0.2,0.9803921568627451,0.17017434230822812,0.9082608945411398
43,140,16,199,0.23497267759562843,0.9195979899497487,0.17993234386950838,0.9171830563706959
34,128,3,165,0.20987654320987653,0.9818181818181818,0.18134327861377647,0.9235142252018645
59,87,3,149,0.4041095890410959,0.9798657718120806,0.22210551328248254,0.9238481797624988
10,111,2,123,0.08264462809917356,0.983739837398374,0.19606893697498512,0.9382337371519073
49,163,10,222,0.23113207547169812,0.954954954954955,0.21194494775665626,0.9317987307169009
5,96,1,102,0.04950495049504951,0.9901960784313726,0.20174863770178894,0.970080710175351
9,50,1,60,0.15254237288135594,0.9833333333333333,0.19496897668483978,0.9705008782425779
8,23,8,39,0.25806451612903225,0.7948717948717948,0.1982678107610403,0.9526828503742987
17,142,4,163,0.1069182389937107,0.9754601226993865,0.18355948158730234,0.9517745562144709
27,111,2,140,0.1956521739130435,0.9857142857142858,0.15377985085472343,0.9526100582005003
62,63,15,140,0.496,0.8928571428571429,0.21283061826912722,0.9396268161231813
24,82,2,108,0.22641509433962265,0.9814814814814815,0.21215676382168785,0.9434163199126852
21,45,1,67,0.3181818181818182,0.9850746268656716,0.25053917349122623,0.9426846839747279
6,121,4,131,0.047244094488188976,0.9694656488549618,0.23549656229220237,0.9407035861921035
23,26,1,50,0.46938775510204084,0.98,0.2656855964312036,0.9671504726389898
29,70,1,100,0.29292929292929293,0.99,0.2922586041362868,0.9692275979676489
6,23,1,30,0.20689655172413793,0.9666666666666667,0.293864943823586,0.9665065095322748
12,80,4,96,0.13043478260869565,0.9583333333333334,0.24164134133911394,0.9758602510288734
21,29,1,51,0.42,0.9803921568627451,0.26929632786202495,0.9757046332261968
14,46,2,62,0.23333333333333334,0.967741935483871,0.25717511574081287,0.9732285344573681
16,172,12,200,0.0851063829787234,0.94,0.2625840140966035,0.9690191560495164
47,173,4,224,0.21363636363636362,0.9821428571428571,0.22604810103007816,0.969325278498496
56,85,11,152,0.3971631205673759,0.9276315789473685,0.24093864783551863,0.9604155040624057
5,58,2,65,0.07936507936507936,0.9692307692307692,0.2227198660699388,0.9607818044287061
31,190,6,227,0.14027149321266968,0.973568281938326,0.22412511044193512,0.9629582256579908
1,0,66,67,1.0,0.014925373134328358,0.30698225329907797,0.8250343994110743
1,12,2,15,0.07692307692307693,0.8666666666666667,0.28463793095475565,0.8105950752943307
31,54,2,87,0.36470588235294116,0.9770114942528736,0.3245807165796439,0.8158824316161697
13,47,5,65,0.21666666666666667,0.9230769230769231,0.3250136170125443,0.8074444410353221
27,86,31,144,0.23893805309734514,0.7847222222222222,0.30241003594539706,0.7870288186460155
178,402,5,585,0.30689655172413793,0.9914529914529915,0.33491453199669113,0.7902034218206186
7,51,1,59,0.1206896551724138,0.9830508474576272,0.33211712656236886,0.7915580740376617
41,64,3,108,0.3904761904761905,0.9722222222222222,0.24504229663039606,0.9283147667645036
2,0,0,2,1.0,1.0,0.37691042849852796,0.9473623858121227
1,14,1,16,0.06666666666666667,0.9375,0.334333397686203,0.9417178866331408
21,82,2,105,0.20388349514563106,0.9809523809523809,0.3325072303260551,0.9499858091867777
64,82,3,149,0.4383561643835616,0.9798657718120806,0.3609955319383717,0.977863459128186
19,40,4,63,0.3220338983050847,0.9365079365079365,0.3631580100213641,0.9700141655646066
8,21,2,31,0.27586206896551724,0.9354838709677419,0.3853254977060932,0.9632188832089088
5,18,0,23,0.21739130434782608,1.0,0.36348274892243637,0.9671871371771628
36,74,6,116,0.32727272727272727,0.9482758620689655,0.2673788528185403,0.9597979746155865
45,65,2,112,0.4090909090909091,0.9821428571428571,0.3162966017362892,0.9661755256359946
34,85,3,122,0.2857142857142857,0.9754098360655737,0.3349215274347239,0.9653837335093078
92,310,10,412,0.22885572139303484,0.9757281553398058,0.300100524815725,0.9647926454418398
14,77,13,104,0.15384615384615385,0.875,0.2760737041787349,0.9560057973692775
9,25,1,35,0.2647058823529412,0.9714285714285714,0.2695538548596969,0.9611407545779675
2,10,2,14,0.16666666666666666,0.8571428571428571,0.2623074780481027,0.9407325913126614
3,12,1,16,0.2,0.9375,0.24412565986628457,0.9391931824456663
29,233,6,268,0.11068702290076336,0.9776119402985075,0.20149653326769232,0.9385459086107593
39,112,20,171,0.2582781456953642,0.8830409356725146,0.19757708469356064,0.9253503514117508
2,23,0,25,0.08,1.0,0.1763119816374128,0.9288177577917784
10,79,37,126,0.11235955056179775,0.7063492063492064,0.17038532402536194,0.9047247872702365
12,38,1,51,0.24,0.9803921568627451,0.16685591226065608,0.9060052994751187
43,142,16,201,0.23243243243243245,0.9203980099502488,0.17625102165576548,0.9150417498761744
36,126,3,165,0.2222222222222222,0.9818181818181818,0.17942562483036864,0.9213729187073433
60,86,3,149,0.410958904109589,0.9798657718120806,0.22232160786020086,0.9216948946378538
9,112,2,123,0.0743801652892562,0.983739837398374,0.19605046780218544,0.9360804520272623
49,163,10,222,0.23113207547169812,0.954954954954955,0.21764076429814233,0.9296454455922559
5,96,1,102,0.04950495049504951,0.9901960784313726,0.2086615357171783,0.9701949987468509
10,49,1,60,0.1694915254237288,0.9833333333333333,0.19858889649199668,0.9706151668140778
7,24,8,39,0.22580645161290322,0.7948717948717948,0.1976423278034925,0.9526828503742989
19,140,4,163,0.11949685534591195,0.9754601226993865,0.18296727539259106,0.9517745562144707
27,111,2,140,0.1956521739130435,0.9857142857142858,0.1522091710787988,0.9526100582005002
67,58,15,140,0.536,0.8928571428571429,0.2181548617517622,0.9396268161231813
24,82,2,108,0.22641509433962265,0.9814814814814815,0.21748100730432288,0.9434163199126854
18,48,1,67,0.2727272727272727,0.9850746268656716,0.24936991048035476,0.9426846839747279
9,118,4,131,0.07086614173228346,0.9694656488549618,0.23528056995300542,0.9407035861921035
23,26,1,50,0.46938775510204084,0.98,0.2700778990228822,0.96715047263899
30,69,1,100,0.30303030303030304,0.99,0.29629696297779523,0.969227597967649
7,22,1,30,0.2413793103448276,0.9666666666666667,0.30282941103947864,0.9665065095322749
10,83,3,96,0.10752688172043011,0.96875,0.24161896557096868,0.9773483462669686
22,28,1,51,0.44,0.9803921568627451,0.2721310949510226,0.977192728464292
13,47,2,62,0.21666666666666667,0.967741935483871,0.2641224369423646,0.9747166296954634
16,173,11,200,0.08465608465608465,0.945,0.2660924287886219,0.9712215370018974
45,174,5,224,0.2054794520547945,0.9776785714285714,0.22839124263901528,0.9708899043488362
54,87,11,152,0.3829787234042553,0.9276315789473685,0.2398124455495799,0.961980129912746
6,57,2,65,0.09523809523809523,0.9692307692307692,0.218935129105761,0.9623464302790463
31,190,6,227,0.14027149321266968,0.973568281938326,0.2236129307475095,0.9630347562702356
2,0,65,67,1.0,0.029850746268656716,0.3036129307475095,0.8272431261853661
3,11,1,15,0.21428571428571427,0.9333333333333333,0.3032727946930877,0.8223276115924321
31,54,2,87,0.36470588235294116,0.9770114942528736,0.3432799086497815,0.8269006821999855
14,47,4,65,0.22950819672131148,0.9384615384615385,0.34671258645928393,0.8212982489189807
29,85,31,145,0.2543859649122807,0.7862068965517242,0.32834219238900186,0.80109472286246
170,410,5,585,0.29310344827586204,0.9914529914529915,0.3566086713943971,0.8042693260370631
7,51,1,59,0.1206896551724138,0.9830508474576272,0.35381126596007484,0.8056239782541063
41,64,3,108,0.3904761904761905,0.9722222222222222,0.26673643602810204,0.9402484748189013
2,0,0,2,1.0,1.0,0.3789813339872858,0.9497722843427109
1,14,1,16,0.06666666666666667,0.9375,0.3364043031749608,0.9441277851637289
15,88,2,105,0.14563106796116504,0.9809523809523809,0.32442185620922565,0.9501979055195636
68,78,3,149,0.4657534246575342,0.9798657718120806,0.3546172076014047,0.977863459128186
19,40,4,63,0.3220338983050847,0.9365079365079365,0.35875012903415077,0.9700141655646066
9,20,2,31,0.3103448275862069,0.9354838709677419,0.3858437250932641,0.9632188832089088
5,18,0,23,0.21739130434782608,1.0,0.3554166959147925,0.9671609728652842
37,73,6,116,0.33636363636363636,0.9482758620689655,0.2606115011095978,0.9597718103037078
44,65,2,111,0.4036697247706422,0.9819819819819819,0.3087547951244514,0.9661263791582765
33,86,3,122,0.2773109243697479,0.9754098360655737,0.32736223810164233,0.9653607513434685
90,310,11,411,0.225,0.9732360097323601,0.29394736530320786,0.9644136424749369
12,79,13,104,0.13186813186813187,0.875,0.266780827240786,0.9556267944023745
9,25,1,35,0.2647058823529412,0.9714285714285714,0.26518708629613225,0.9607617516110646
2,10,2,14,0.16666666666666666,0.8571428571428571,0.2579407094845381,0.9403535883457584
2,13,1,16,0.13333333333333333,0.9375,0.2289363804802091,0.9388141794787633
31,231,6,268,0.1183206106870229,0.9776119402985075,0.1881722213254063,0.9381898878096955
40,111,20,171,0.26490066225165565,0.8830409356725146,0.1863993267371074,0.9249943306106871
2,23,0,25,0.08,1.0,0.16568504102282172,0.9288177577917784
10,79,37,126,0.11235955056179775,0.7063492063492064,0.16289810083620254,0.9047247872702365
12,38,1,51,0.24,0.9803921568627451,0.15936868907149668,0.9060052994751187
43,142,15,200,0.23243243243243245,0.925,0.16876379846660608,0.9156991770261389
32,130,3,165,0.19753086419753085,0.9818181818181818,0.17793487430434857,0.9220303458573077
58,88,3,149,0.3972602739726027,0.9798657718120806,0.21778339763086,0.9223523217878183
9,112,2,123,0.0743801652892562,0.983739837398374,0.19056618377908863,0.9367378791772267
49,162,11,222,0.23222748815165878,0.9504504504504504,0.21231296780075418,0.9296593720987196
5,96,1,102,0.04950495049504951,0.9901960784313726,0.20333373921979017,0.9702089252533147
10,49,1,60,0.1694915254237288,0.9833333333333333,0.19326109999460853,0.9706290933205416
7,24,8,39,0.22580645161290322,0.7948717948717948,0.19231453130610437,0.9520393497307981
18,140,4,162,0.11392405063291139,0.9753086419753086,0.18037070079687303,0.9511094154675305
28,110,2,140,0.2028985507246377,0.9857142857142858,0.15260474033287802,0.9519449174535597
65,60,15,140,0.52,0.8928571428571429,0.21626471672012712,0.9389616753762411
24,82,2,108,0.22641509433962265,0.9814814814814815,0.2154343747469791,0.9433946798092456
19,47,1,67,0.2878787878787879,0.9850746268656716,0.24948778008751318,0.9426630438712883
6,121,4,131,0.047244094488188976,0.9694656488549618,0.23202386138243605,0.9406819460886637
23,26,1,50,0.46938775510204084,0.98,0.26682119045231284,0.9671288325355503
30,69,1,100,0.30303030303030304,0.99,0.2938363693662259,0.969227597967649
7,22,1,30,0.2413793103448276,0.9666666666666667,0.29933362074053876,0.9665065095322749
12,82,2,96,0.1276595744680851,0.9791666666666666,0.2432849885216938,0.9788364415050639
22,28,1,51,0.44,0.9803921568627451,0.2737971179017477,0.9786808237023872
11,48,3,62,0.1864406779661017,0.9516129032258065,0.25930595934279255,0.9739005774681208
16,173,11,200,0.08465608465608465,0.945,0.26465052936677763,0.9704054847745549
40,178,6,224,0.1834862385321101,0.9732142857142857,0.2238074555710732,0.9694360970194528
54,87,11,152,0.3829787234042553,0.9276315789473685,0.23522865848163785,0.9605263225833626
6,57,2,65,0.09523809523809523,0.9692307692307692,0.21435134203781891,0.960892622949663
32,188,6,226,0.14545454545454545,0.9734513274336283,0.2168934807501704,0.9600761459163717
1,0,66,67,1.0,0.014925373134328358,0.29689348075017047,0.8221523196694551
2,12,1,15,0.14285714285714285,0.9333333333333333,0.2906672614488906,0.8195409525419589
31,54,2,87,0.36470588235294116,0.9770114942528736,0.33067437540558436,0.8241140231495123
14,48,3,65,0.22580645161290322,0.9538461538461539,0.33672012013141195,0.8213471471683507
27,87,31,145,0.23684210526315788,0.7862068965517242,0.3158434603969695,0.80114362111183
171,409,5,585,0.29482758620689653,0.9914529914529915,0.3443562448210839,0.8043182242864333
8,50,1,59,0.13793103448275862,0.9830508474576272,0.34328145753940015,0.8056895842898617
41,64,3,108,0.3904761904761905,0.9722222222222222,0.25620662760742735,0.9424462770167035
2,0,0,2,1.0,1.0,0.37865560719926405,0.951970086540513
1,14,1,16,0.06666666666666667,0.9375,0.3360785763869391,0.9463255873615312
16,87,2,105,0.1553398058252427,0.9809523809523809,0.3260119127029876,0.9501979055195635
69,77,3,149,0.4726027397260274,0.9798657718120806,0.35969200334054047,0.977863459128186
19,40,4,63,0.3220338983050847,0.9365079365079365,0.36357861935456726,0.9700141655646066
9,20,2,31,0.3103448275862069,0.9354838709677419,0.38820916122648846,0.9632188832089087
5,18,0,23,0.21739130434782608,1.0,0.3617925355916672,0.9659305335225848
38,74,4,116,0.3392857142857143,0.9655172413793104,0.26740478048962635,0.9610044251482007
43,66,2,111,0.3944954128440367,0.9819819819819819,0.31423745851496493,0.9673589940027695
32,87,3,122,0.2689075630252101,0.9754098360655737,0.32985647207783686,0.966822303916899
82,317,11,410,0.20551378446115287,0.973170731707317,0.29382323001896743,0.9659452163282891
11,80,13,104,0.12087912087912088,0.875,0.2617410265081924,0.9577733034953593
9,25,1,35,0.2647058823529412,0.9714285714285714,0.2587398260280004,0.9632154803661076
2,11,1,14,0.15384615384615385,0.9285714285714286,0.24966194738490435,0.9530113987334545
3,12,1,16,0.2,0.9375,0.22976398820123087,0.9490089356792674
30,231,6,267,0.11494252873563218,0.9775280898876404,0.18982786190003023,0.9483726653800757
40,110,21,171,0.26666666666666666,0.8771929824561403,0.18950773384880973,0.9343416862930137
2,23,0,25,0.08,1.0,0.1715771932115022,0.9381744389062544
13,88,25,126,0.12871287128712872,0.8015873015873016,0.17269630041264614,0.9276869105615831
11,39,1,51,0.22,0.9803921568627451,0.1663097457907974,0.9289674227664652
43,143,14,200,0.23118279569892472,0.93,0.17735783748405037,0.9291715043991181
32,130,3,165,0.19753086419753085,0.9818181818181818,0.17700510379798337,0.9355026732302869
56,89,3,148,0.38620689655172413,0.9797297297297297,0.21575715634313936,0.9358171932077283
10,111,2,123,0.08264462809917356,0.983739837398374,0.18946829369064036,0.9510381724851903
49,163,9,221,0.23113207547169812,0.9592760180995475,0.2110585901865972,0.9452204607851257
5,96,1,102,0.04950495049504951,0.9901960784313726,0.1997431729305859,0.97216457176285
10,49,1,60,0.1694915254237288,0.9833333333333333,0.19252767656254718,0.9725847398300768
8,23,8,39,0.25806451612903225,0.7948717948717948,0.19636792233827682,0.9532807105260476
18,140,4,162,0.11392405063291139,0.9753086419753086,0.18442409182904546,0.9523507762627801
27,111,2,140,0.1956521739130435,0.9857142857142858,0.15720198859494822,0.9532057128320023
66,70,4,140,0.4852941176470588,0.9714285714285714,0.21472334424464612,0.9514469605506017
23,83,2,108,0.2169811320754717,0.9814814814814815,0.21270178090232808,0.9546191696051638
18,48,1,67,0.2727272727272727,0.9850746268656716,0.24459068407835996,0.9538875336672066
6,119,4,129,0.048,0.9689922480620154,0.22723475187497014,0.9518388071998755
24,25,1,50,0.4897959183673469,0.98,0.2603392379090151,0.978285693646762
31,68,1,100,0.31313131313131315,0.99,0.2887974182659296,0.9803844590788607
6,23,1,30,0.20689655172413793,0.9666666666666667,0.29040375795322887,0.9776633706434864
11,82,3,96,0.11827956989247312,0.96875,0.23797310827400228,0.9772807175822619
22,28,1,51,0.44,0.9803921568627451,0.2698329465489349,0.9771250997795854
11,49,2,62,0.18333333333333332,0.967741935483871,0.25706238377837215,0.9746490010107568
16,173,11,200,0.08465608465608465,0.945,0.2622989673006699,0.9712215370018974
38,179,7,224,0.17511520737327188,0.96875,0.21734458001580206,0.9696143941447545
54,87,11,152,0.3829787234042553,0.9276315789473685,0.22732278148336524,0.9607046197086643
6,57,2,65,0.09523809523809523,0.9692307692307692,0.21137157341393056,0.9610709200749648
30,190,6,226,0.13636363636363635,0.9734513274336283,0.2139550114812396,0.9617425382797687
10,50,7,67,0.16666666666666666,0.8955223880597015,0.17490739243362055,0.9496182855936197
2,12,1,15,0.14285714285714285,0.9333333333333333,0.1691250795084505,0.9447027710006858
32,53,2,87,0.3764705882352941,0.9770114942528736,0.21081286573405184,0.9492758416082391
14,48,3,65,0.22580645161290322,0.9538461538461539,0.21805447205399917,0.9471467207291182
29,84,32,145,0.25663716814159293,0.7793103448275862,0.20000567844504738,0.9259579729977209
173,407,5,585,0.2982758620689655,0.9914529914529915,0.2290110737066003,0.929132576172324
8,50,1,59,0.13793103448275862,0.9830508474576272,0.22923498772361775,0.9305039361757524
41,64,3,108,0.3904761904761905,0.9722222222222222,0.26120777683926405,0.9414610553418267
2,0,0,2,1.0,1.0,0.3836567564311007,0.9509848648656362
1,14,1,16,0.06666666666666667,0.9375,0.33939905334986825,0.9453403656866544
15,87,2,104,0.14705882352941177,0.9807692307692307,0.32814939219508377,0.9491865195328081
67,79,3,149,0.4589041095890411,0.9798657718120806,0.35704466954471925,0.9778372948163074
19,40,4,63,0.3220338983050847,0.9365079365079365,0.36043867472130764,0.9699880012527282
8,21,2,31,0.27586206896551724,0.9354838709677419,0.3801431082188446,0.9631927188970301
5,18,0,23,0.21739130434782608,1.0,0.3494306869566864,0.96629849176579
36,66,6,108,0.35294117647058826,0.9444444444444444,0.25699371216677036,0.958361983829282
38,54,2,94,0.41304347826086957,0.9787234042553191,0.3064761138230851,0.9642510415800417
31,68,3,102,0.31313131313131315,0.9705882352941176,0.32591153950851076,0.9629648128028166
81,292,11,384,0.21715817694369974,0.9713541666666666,0.2925478183073089,0.9618282159226854
10,73,13,96,0.12048192771084337,0.8645833333333334,0.2630062755127541,0.9521682078516603
9,21,1,31,0.3,0.967741935483871,0.2763067681235915,0.9567765027825359
2,10,2,14,0.16666666666666666,0.8571428571428571,0.2690603913119973,0.9363683395172299
1,9,1,11,0.1,0.9090909090909091,0.23292593753048468,0.9313178344667248
30,199,6,235,0.13100436681222707,0.9744680851063829,0.19263463589496435,0.9307099317311625
40,99,18,157,0.28776978417266186,0.8853503184713376,0.18901156032944272,0.9185330864707654
2,21,0,23,0.08695652173913043,1.0,0.17041132387164712,0.9226253483755272
11,71,40,122,0.13414634146341464,0.6721311475409836,0.17236338297915732,0.8951321789766201
10,37,1,48,0.2127659574468085,0.9791666666666666,0.15990137690012993,0.8967642834313052
43,134,15,192,0.24293785310734464,0.921875,0.17079726067736964,0.9060117324108969
28,111,3,142,0.2014388489208633,0.9788732394366197,0.18528852480892155,0.9159806367459985
54,84,3,141,0.391304347826087,0.9787234042553191,0.22247423638233016,0.9165885394815608
6,97,2,105,0.05825242718446602,0.9809523809523809,0.1896860425268736,0.9302459769788527
48,162,10,220,0.22857142857142856,0.9545454545454546,0.20991674350291614,0.9237524704853463
2,77,1,80,0.02531645569620253,0.9875,0.19436961696474303,0.9688051636937772
9,43,1,53,0.17307692307692307,0.9811320754716981,0.18869975491190222,0.9690859363802102
8,21,8,37,0.27586206896551724,0.7837837837837838,0.19340321432021262,0.9493586197778937
19,137,4,160,0.12179487179487179,0.975,0.18202550330221381,0.9488052998583765
29,100,2,131,0.2248062015503876,0.9847328244274809,0.15824005383425677,0.9496637884543997
61,52,14,127,0.5398230088495575,0.889763779527559,0.22703585121498412,0.9366368453937107
24,75,2,101,0.24242424242424243,0.9801980198019802,0.22901482462252895,0.9403014975732145
19,47,1,67,0.2878787878787879,0.9850746268656716,0.26652372922004114,0.9399550156968818
8,109,4,121,0.06837606837606838,0.9669421487603306,0.2515664642627762,0.9379278833095436
23,23,1,47,0.5,0.9787234042553191,0.2835861686962737,0.9657764005197629
31,67,1,99,0.3163265306122449,0.98989898989899,0.3113764056701842,0.96790482764819
7,21,1,29,0.25,0.9655172413793104,0.3149755197344145,0.9651597443555942
10,66,3,79,0.13157894736842105,0.9620253164556962,0.2566549395228236,0.9754828210596139
21,28,1,50,0.42857142857142855,0.98,0.2832473946867073,0.9754545325164738
12,45,2,59,0.21052631578947367,0.9661016949152542,0.272197041531091,0.9727441136664142
15,156,10,181,0.08771929824561403,0.9447513812154696,0.27496036008388325,0.9695740040171484
38,158,8,204,0.19387755102040816,0.9607843137254902,0.2312285816582273,0.9670112767986014
56,80,11,147,0.4117647058823529,0.9251700680272109,0.2448626066968141,0.9577642879597759
6,56,2,64,0.0967741935483871,0.96875,0.22297320577515514,0.9582261106198743
27,162,6,195,0.14285714285714285,0.9692307692307692,0.22458437655925825,0.9592554610163132
2,0,65,67,1.0,0.029850746268656716,0.30621702962048275,0.8235198533404072
2,12,1,15,0.14285714285714285,0.9333333333333333,0.29655000491586403,0.8188386588287041
34,36,2,72,0.4857142857142857,0.9722222222222222,0.3534064316971029,0.8227630646868116
14,45,4,63,0.23728813559322035,0.9365079365079365,0.3596079437789332,0.8192950107985898
29,85,31,145,0.2543859649122807,0.7862068965517242,0.33712526649749425,0.7994431291592345
171,410,5,586,0.2943201376936317,0.9914675767918089,0.3653461156611007,0.8026884972723501
5,46,1,52,0.09803921568627451,0.9807692307692307,0.35894355463669086,0.8043368489207017
39,55,3,97,0.4148936170212766,0.9690721649484536,0.27535692849687327,0.9385113373035298
2,0,0,2,1.0,1.0,0.39780590808870997,0.9480351468273394
1,14,1,16,0.06666666666666667,0.9375,0.3379419625104787,0.9430748293670218
15,79,2,96,0.1595744680851064,0.9791666666666666,0.32684001000931956,0.9491689336754119
65,77,3,145,0.45774647887323944,0.9793103448275862,0.35589151200374225,0.9767551405719636
19,36,4,59,0.34545454545454546,0.9322033898305084,0.36319642739815844,0.9682888281489207
8,20,2,30,0.2857142857142857,0.9333333333333333,0.3900071516878744,0.961512271372364
5,17,0,22,0.22727272727272727,1.0,0.3393089814997886,0.9662024516287188
36,67,5,108,0.34951456310679613,0.9537037037037037,0.24638249051504518,0.9595886950149622
39,54,2,95,0.41935483870967744,0.9789473684210527,0.2967665150926182,0.9655097476465412
29,70,3,102,0.29292929292929293,0.9705882352941176,0.31780911865949363,0.9640291554096464
75,298,12,385,0.20107238605898123,0.9688311688311688,0.286017872223475,0.9634374691036742
10,73,13,96,0.12048192771084337,0.8645833333333334,0.2596460410732081,0.9531625257930169
9,22,1,32,0.2903225806451613,0.96875,0.27156404520478283,0.9579148299404823
2,10,2,14,0.16666666666666666,0.8571428571428571,0.2629060365467742,0.9375066666751761
1,9,1,11,0.1,0.9090909090909091,0.2272610989600891,0.9311334103019197
25,203,6,234,0.10964912280701754,0.9743589743589743,0.18301742525970907,0.9304779254359085
39,98,18,155,0.2846715328467153,0.8838709677419355,0.18183774524791227,0.9180897443570253
2,21,0,23,0.08695652173913043,1.0,0.16553547891650502,0.9225424345240013
16,76,30,122,0.17391304347826086,0.7540983606557377,0.17316849545470753,0.9067588669986303
8,39,1,48,0.1702127659574468,0.9791666666666666,0.15600995049931973,0.9082469622367256
40,137,15,192,0.22598870056497175,0.921875,0.16448452677050618,0.9174944112163175
28,109,3,140,0.20437956204379562,0.9785714285714285,0.17939589277676268,0.9274201997135345
50,89,3,142,0.3597122302158273,0.9788732394366197,0.21511919383516406,0.9280650947246267
5,98,2,105,0.04854368932038835,0.9809523809523809,0.1813866447599745,0.9419338680404046
46,164,10,220,0.21904761904761905,0.9545454545454546,0.20025680151833006,0.9354403615468981
2,77,1,80,0.02531645569620253,0.9875,0.17902871754946456,0.9687834528817928
10,43,1,54,0.18867924528301888,0.9814814814814815,0.18166678602454628,0.9691141407124807
8,21,8,37,0.27586206896551724,0.7837837837837838,0.18879155293890992,0.949386824110164
18,138,4,160,0.11538461538461539,0.975,0.1760779891304556,0.9488766200285313
29,100,2,131,0.2248062015503876,0.9847328244274809,0.15680569932110708,0.9497137035986543
54,58,15,127,0.48214285714285715,0.8818897637795275,0.21874843758145973,0.9355619011453895
24,76,2,102,0.24,0.9803921568627451,0.22174163486037132,0.9392542871907168
19,47,1,67,0.2878787878787879,0.9850746268656716,0.2592505394578835,0.9389078053143842
7,111,4,122,0.059322033898305086,0.9672131147540983,0.2407709378314958,0.9368694672104724
23,24,1,48,0.48936170212765956,0.9791666666666666,0.27127088542608757,0.9647813076223127
31,67,1,99,0.3163265306122449,0.98989898989899,0.29997687331574896,0.9669097347507398
7,21,1,29,0.25,0.9655172413793104,0.3035759873799793,0.9641646514581442
11,66,2,79,0.14285714285714285,0.9746835443037974,0.25510659962487725,0.9774209058187541
20,29,1,50,0.40816326530612246,0.98,0.2791299232400376,0.9773648834097904
12,47,2,61,0.2033898305084746,0.9672131147540983,0.2670600721871357,0.974813238822423
16,162,9,187,0.0898876404494382,0.9518716577540107,0.27142658740872616,0.9726216021081246
40,162,4,206,0.19801980198019803,0.9805825242718447,0.2298063159590888,0.9728238674802929
57,79,11,147,0.41911764705882354,0.9251700680272109,0.2444907611657429,0.9635768786414675
4,57,2,63,0.06557377049180328,0.9682539682539683,0.2181441569502862,0.9639678396235613
27,166,6,199,0.13989637305699482,0.9698492462311558,0.21772118983597935,0.963277225613184
2,0,65,67,1.0,0.029850746268656716,0.3022692947922475,0.8275416179372778
2,11,1,14,0.15384615384615385,0.9285714285714286,0.2951916266976303,0.8220213770540392
35,35,2,72,0.5,0.9722222222222222,0.3537791066334249,0.824928600549498
13,46,4,63,0.22033898305084745,0.9365079365079365,0.3569675610720891,0.8186322308689397
30,84,31,145,0.2631578947368421,0.7862068965517242,0.3346875964546631,0.7987803492295845
165,415,5,585,0.28448275862068967,0.9914529914529915,0.36596030904450405,0.8020944954008735
6,46,1,53,0.11538461538461539,0.9811320754716981,0.36245862937702134,0.8037063281495224
40,54,3,97,0.425531914893617,0.9690721649484536,0.28039176007610944,0.9378808165323506
2,0,0,2,1.0,1.0,0.40127088095523034,0.9480848981650036
1,14,1,16,0.06666666666666667,0.9375,0.3393661190504684,0.9431245807046861
17,79,2,98,0.17708333333333334,0.9795918367346939,0.33318674051939495,0.9492794235942228
64,78,3,145,0.4507042253521127,0.9793103448275862,0.3599790734644336,0.9768656304907746
18,37,4,59,0.32727272727272727,0.9322033898305084,0.3660919261290104,0.9684014016875627
6,23,2,31,0.20689655172413793,0.9354838709677419,0.3791650598917994,0.961880229615569
5,19,0,24,0.20833333333333334,1.0,0.3352163912421498,0.9662024516287188
37,73,6,116,0.33636363636363636,0.9482758620689655,0.24041119643695502,0.9588132890671426
41,68,2,111,0.3761467889908257,0.9819819819819819,0.28462264248326347,0.9651678579217113
32,87,3,122,0.2689075630252101,0.9754098360655737,0.3036205329015667,0.9643760657950246
78,322,12,412,0.195,0.970873786407767,0.27096180274283654,0.964076181999995
13,77,13,103,0.14444444444444443,0.8737864077669902,0.2480131882687983,0.9551159636084314
9,22,1,32,0.2903225806451613,0.96875,0.25993119240037305,0.9598682677558968
2,10,2,14,0.16666666666666666,0.8571428571428571,0.2539788114479921,0.9394601044905907
2,12,1,15,0.14285714285714285,0.9333333333333333,0.2263350266613502,0.9373254575283576
27,231,6,264,0.10465116279069768,0.9772727272727273,0.18754993720418905,0.9366527068556069
39,111,21,171,0.26,0.8771929824561403,0.18627742820058762,0.9226217277685448
3,21,0,24,0.125,1.0,0.17627742820058762,0.9267826154245782
13,81,32,126,0.13829787234042554,0.746031746031746,0.17539934647144206,0.9085319494624005
10,40,1,51,0.2,0.9803921568627451,0.16249612066499042,0.9101951147285068
38,148,14,200,0.20430107526881722,0.93,0.16787246475101195,0.920603277993813
34,126,3,163,0.2125,0.9815950920245399,0.1778214443428487,0.9274978149496996
49,97,3,149,0.3356164383561644,0.9798657718120806,0.21081648370934394,0.927868249883893
11,110,2,123,0.09090909090909091,0.983739837398374,0.18666063955349976,0.943089229161355
45,166,10,221,0.2132701421800948,0.9547511312217195,0.19927065986494188,0.9366251050501722
5,97,1,103,0.049019607843137254,0.9902912621359223,0.186516622079615,0.9715193216364828
10,49,1,60,0.1694915254237288,0.9833333333333333,0.1821582685687191,0.9719394897037098
8,23,8,39,0.25806451612903225,0.7948717948717948,0.1898387601201784,0.9526354603996804
16,143,4,163,0.10062893081761007,0.9754601226993865,0.1738571788084084,0.9517590362103728
27,111,2,140,0.1956521739130435,0.9857142857142858,0.15386228388796258,0.9525945381964023
54,83,4,141,0.39416058394160586,0.9716312056737588,0.19718392574975038,0.9508647336643143
25,80,2,107,0.23809523809523808,0.9813084112149533,0.2007303680233423,0.9546586308062048
19,47,1,67,0.2878787878787879,0.9850746268656716,0.23485310802843526,0.9539133971961691
8,119,4,131,0.06299212598425197,0.9694656488549618,0.21963890810851,0.9519322994135446
23,26,1,50,0.46938775510204084,0.98,0.24982794224751123,0.978379185860431
30,68,1,99,0.30612244897959184,0.98989898989899,0.2791841591277943,0.9804418811746601
8,21,1,30,0.27586206896551724,0.9666666666666667,0.290642715563862,0.9777207927392858
11,81,2,94,0.11956521739130435,0.9787234042553191,0.25141480605667604,0.978733963965223
20,30,1,51,0.4,0.9803921568627451,0.27454405775735635,0.9786030704863362
11,48,3,62,0.1864406779661017,0.9516129032258065,0.2600528991984012,0.9738228242520697
14,166,13,193,0.07777777777777778,0.9326424870466321,0.2621651351689049,0.9685623725651655
39,177,5,221,0.18055555555555555,0.9773755656108597,0.22090339237654982,0.968187453366717
56,86,11,153,0.39436619718309857,0.9281045751633987,0.2335096421199079,0.959359679833061
4,58,2,64,0.06451612903225806,0.96875,0.20331736498658518,0.9596572988806801
28,189,6,223,0.12903225806451613,0.9730941704035875,0.20466979936847257,0.958853122616147
1,0,66,67,1.0,0.014925373134328358,0.29038408508275826,0.8209292963692303
2,12,1,15,0.14285714285714285,0.9333333333333333,0.28415786578147845,0.8183179292417341
38,46,2,86,0.4523809523809524,0.9767441860465116,0.33767260501050345,0.8246181719560025
14,46,5,65,0.23333333333333334,0.9230769230769231,0.34521228755018596,0.8168612230225831
24,96,23,143,0.2,0.8391608391608392,0.3174456879526004,0.8041549750222174
160,424,5,589,0.273972602739726,0.9915110356536503,0.3473680413393816,0.8074065515441676
7,51,1,59,0.1206896551724138,0.9830508474576272,0.3461762409262241,0.808828933980459
41,64,3,108,0.3904761904761905,0.9722222222222222,0.2591014109942513,0.9455856267073008
2,0,0,2,1.0,1.0,0.3815503905860881,0.9551094362311103
1,14,1,16,0.06666666666666667,0.9375,0.32644834976976156,0.9495031239387516
15,88,2,105,0.14563106796116504,0.9809523809523809,0.3139194547165946,0.9577710464923884
61,83,4,148,0.4236111111111111,0.972972972972973,0.34586389916103905,0.9768870656084075
18,41,4,63,0.3050847457627119,0.9365079365079365,0.3503084910214656,0.9690294800161626
6,23,2,31,0.20689655172413793,0.9354838709677419,0.3626237619574262,0.9622341976604647
5,19,0,24,0.20833333333333334,1.0,0.3431316779490788,0.9671677025939697
36,74,6,116,0.32727272727272727,0.9482758620689655,0.24702778184518268,0.9597785400323933
41,68,2,111,0.3761467889908257,0.9819819819819819,0.2912392278914911,0.9661331088869621
33,86,3,122,0.2773109243697479,0.9754098360655737,0.3114375985018712,0.9653413167602755
80,320,12,412,0.2,0.970873786407767,0.27892528323093524,0.9640761819999951
13,77,13,103,0.14444444444444443,0.8737864077669902,0.25355536125084377,0.9551159636084314
9,22,1,32,0.2903225806451613,0.96875,0.26054725700803427,0.9598682677558968
2,10,2,14,0.16666666666666666,0.8571428571428571,0.25459487605565334,0.9394601044905907
3,12,1,16,0.2,0.9375,0.23641305787383518,0.9379206956235956
28,231,6,265,0.10810810810810811,0.9773584905660377,0.19812181774773263,0.9372601968498893
39,111,22,172,0.26,0.872093023255814,0.1956488285520544,0.9225006521627808
3,22,0,25,0.12,1.0,0.18422025712348294,0.926661539818814
13,82,31,126,0.1368421052631579,0.753968253968254,0.18313420866901345,0.909544660704709
9,41,1,51,0.18,0.9803921568627451,0.16737384000541897,0.9112078259708153
37,149,14,200,0.1989247311827957,0.93,0.17198213493629452,0.9216159892361214
34,127,3,164,0.2111801242236025,0.9817073170731707,0.1735792955396663,0.9279313202465743
48,97,4,149,0.3310344827586207,0.9731543624161074,0.20542592048973957,0.9273307305108701
11,110,2,123,0.09090909090909091,0.983739837398374,0.1812700763338954,0.9432802753883786
46,165,10,221,0.21800947867298578,0.9547511312217195,0.19527143043003625,0.9368161512771956
5,97,1,103,0.049019607843137254,0.9902912621359223,0.18272535937003329,0.970576581015434
9,50,1,60,0.15254237288135594,0.9833333333333333,0.17880284121022696,0.970996749082661
8,23,8,39,0.25806451612903225,0.7948717948717948,0.18725138191683222,0.9516927197786316
16,144,4,164,0.1,0.975609756097561,0.17136850702774614,0.9508216396392587
28,110,2,140,0.2028985507246377,0.9857142857142858,0.15306337388003427,0.9526159143961414
54,83,4,141,0.39416058394160586,0.9716312056737588,0.19638501574182213,0.9508861098640535
26,79,2,107,0.24761904761904763,0.9813084112149533,0.2006149541626881,0.954680007005944
20,46,1,67,0.30303030303030304,0.9850746268656716,0.2369021963322832,0.9539347733959083
9,118,4,131,0.07086614173228346,0.9694656488549618,0.22523416331098717,0.9519536756132838
23,26,1,50,0.46938775510204084,0.98,0.25542319744998837,0.9784005620601702
29,69,1,99,0.29591836734693877,0.98989898989899,0.28341153564240823,0.9804418811746601
8,21,1,30,0.27586206896551724,0.9666666666666667,0.29383489539110524,0.977720792739286
10,82,2,94,0.10869565217391304,0.9787234042553191,0.25305419085286346,0.978733963965223
19,30,2,51,0.3877551020408163,0.9607843137254902,0.27307362719883044,0.975801950038157
10,50,2,62,0.16666666666666666,0.967741935483871,0.2535931077183109,0.9733258512693282
14,166,13,193,0.07777777777777778,0.9326424870466321,0.2545804842962387,0.968065399582424
39,178,6,223,0.17972350230414746,0.9730941704035875,0.2131998767536825,0.9670788524972223
56,86,11,153,0.39436619718309857,0.9281045751633987,0.22726385244456246,0.9582510789635663
5,57,2,64,0.08064516129032258,0.96875,0.19937572277667748,0.9585486980111854
28,190,6,224,0.12844036697247707,0.9732142857142857,0.20219639631932954,0.9577616810767521
1,0,66,67,1.0,0.014925373134328358,0.28965995317064147,0.8226389752780147
2,12,1,15,0.14285714285714285,0.9333333333333333,0.2862585926264238,0.8177234606850806
38,46,2,86,0.4523809523809524,0.9767441860465116,0.3397733318554487,0.8240237033993492
14,46,5,65,0.23333333333333334,0.9230769230769231,0.3474318791453324,0.8168783823526828
24,96,23,143,0.2,0.8391608391608392,0.3196652795477469,0.8041721343523172
161,423,5,589,0.2756849315068493,0.9915110356536503,0.3475281038643936,0.8074237108742672
7,51,1,59,0.1206896551724138,0.9830508474576272,0.3464208593215274,0.808828933980459
41,64,3,108,0.3904761904761905,0.9722222222222222,0.25934602938955464,0.9455856267073008
2,0,0,2,1.0,1.0,0.3817950089813914,0.9551094362311103
1,14,1,16,0.06666666666666667,0.9375,0.3266929681650648,0.9495031239387516
14,89,2,105,0.13592233009708737,0.9809523809523809,0.3127771105598868,0.9577710464923884
61,83,4,148,0.4236111111111111,0.972972972972973,0.34472155500433127,0.9768870656084075
18,41,4,63,0.3050847457627119,0.9365079365079365,0.3489215284694545,0.9690294800161626
6,23,2,31,0.20689655172413793,0.9354838709677419,0.3612367994054151,0.9622341976604647
4,20,0,24,0.16666666666666666,1.0,0.33586496556371676,0.9671677025939697
37,71,8,116,0.3425925925925926,0.9310344827586207,0.24194962164837278,0.9573154858452012
42,68,2,112,0.38181818181818183,0.9821428571428571,0.2869712666700178,0.9636930368656094
33,86,3,122,0.2773109243697479,0.9754098360655737,0.3002348245203424,0.9629012447389228
79,321,12,412,0.1975,0.970873786407767,0.2683505880671404,0.9616361099786424
10,80,13,103,0.1111111111111111,0.8737864077669902,0.245482683843304,0.9526758915870784
9,22,1,32,0.2903225806451613,0.96875,0.2524745796004945,0.957428195734544
2,10,2,14,0.16666666666666666,0.8571428571428571,0.2524745796004945,0.9370200324692378
3,12,1,16,0.2,0.9375,0.23210420923012415,0.9379436777894349
29,229,7,265,0.1124031007751938,0.9735849056603774,0.19361634050969728,0.9367211132919379
39,110,23,172,0.26174496644295303,0.8662790697674418,0.19139263223444086,0.921131003820776
2,23,0,25,0.08,1.0,0.1746069179487266,0.9252918914768095
13,82,31,126,0.1368421052631579,0.753968253968254,0.17828277425616185,0.908175012362704
8,42,1,51,0.16,0.9803921568627451,0.15966526273542453,0.9098381776288106
37,148,16,201,0.2,0.9203980099502488,0.16442716749732927,0.9188746280298666
33,128,3,164,0.20496894409937888,0.9817073170731707,0.16513701665438343,0.9251899590403195
46,100,3,149,0.3150684931506849,0.9798657718120806,0.19408921556516787,0.92608722563342
10,111,2,123,0.08264462809917356,0.983739837398374,0.1685034529446279,0.9428673352949818
45,166,10,221,0.2132701421800948,0.9547511312217195,0.18754204468464147,0.9364032111837989
5,97,1,103,0.049019607843137254,0.9902912621359223,0.17499597362463853,0.970163640922037
10,49,1,60,0.1694915254237288,0.9833333333333333,0.17635190582802834,0.9705838089892641
8,23,8,39,0.25806451612903225,0.7948717948717948,0.18464683670360435,0.9526514925494849
18,142,4,164,0.1125,0.975609756097561,0.17143698754655023,0.951780412410112
29,109,2,140,0.21014492753623187,0.9857142857142858,0.15644790674448553,0.9526159143961414
57,69,15,141,0.4523809523809524,0.8936170212765957,0.2092673816418825,0.9397412263787446
25,81,2,108,0.2358490566037736,0.9814814814814815,0.21249294084526518,0.9435598478444247
17,49,1,67,0.25757575757575757,0.9850746268656716,0.2422866765213538,0.9428146142343891
9,118,4,131,0.07086614173228346,0.9694656488549618,0.22819733599400446,0.9408335164517645
23,26,1,50,0.46938775510204084,0.98,0.2583863701330057,0.9672804028986509
30,68,1,99,0.30612244897959184,0.98989898989899,0.28604671998723313,0.9693217220131408
8,21,1,30,0.27586206896551724,0.9666666666666667,0.29543488304855964,0.9666006335777667
11,81,2,94,0.11956521739130435,0.9787234042553191,0.24788977805003845,0.9787586882890127
22,28,1,51,0.44,0.9803921568627451,0.2770541985352136,0.9786030704863362
10,50,2,62,0.16666666666666666,0.967741935483871,0.2640671855482007,0.9761269717175075
15,167,11,193,0.08241758241758242,0.9430051813471503,0.2657173913603862,0.9723469049306773
39,179,5,223,0.17889908256880735,0.9775784753363229,0.2242190095699243,0.9720009728358663
56,86,11,153,0.39436619718309857,0.9281045751633987,0.2368252593132824,0.9631731993022105
6,56,2,64,0.0967741935483871,0.96875,0.21124127711083523,0.9634708183498295
27,192,6,225,0.1232876712328767,0.9733333333333334,0.21177305623105985,0.9627008082181172
2,0,65,67,1.0,0.029850746268656716,0.29177305623105987,0.8269091781332475
2,12,1,15,0.14285714285714285,0.9333333333333333,0.2883716956868421,0.8219936635403136
37,47,2,86,0.44047619047619047,0.9767441860465116,0.3395229254095004,0.8268135213545081
15,47,3,65,0.24193548387096775,0.9538461538461539,0.3485281255955234,0.8234231897130552
27,93,23,143,0.225,0.8391608391608392,0.32433295456936645,0.8107169417126895
166,418,5,589,0.2842465753424658,0.9915110356536503,0.351114723397092,0.8139685182346396
7,51,1,59,0.1206896551724138,0.9830508474576272,0.35074357824559727,0.8153567345381102
42,63,3,108,0.4,0.9722222222222222,0.2650292925313115,0.9499812311029052
2,0,0,2,1.0,1.0,0.3874782721231483,0.9595050406267147
1,14,1,16,0.06666666666666667,0.9375,0.3340769115789306,0.953898728334356
14,89,2,105,0.13592233009708737,0.9809523809523809,0.31893217532551915,0.9577710464923885
62,83,3,148,0.42758620689655175,0.9797297297297297,0.3478730620250265,0.9778523165736586
19,40,4,63,0.3220338983050847,0.9365079365079365,0.35327125101968637,0.9699947309814136
7,22,2,31,0.2413793103448276,0.9354838709677419,0.3705126303300312,0.9631994486257157
5,19,0,24,0.20833333333333334,1.0,0.33630724547757934,0.9671218392828003
36,77,3,116,0.3185840707964602,0.9741379310344828,0.2389621127342165,0.9634272580020121
41,69,2,112,0.37272727272727274,0.9821428571428571,0.28268505645716024,0.9698048090224203
31,87,3,121,0.2627118644067797,0.9752066115702479,0.2978063592155517,0.9690101491368514
78,321,13,412,0.19548872180451127,0.9684466019417476,0.267201573441593,0.967417972737859
11,79,13,103,0.12222222222222222,0.8737864077669902,0.2459209708050582,0.9584577543462951
8,23,1,32,0.25806451612903225,0.96875,0.24830457163137315,0.9632100584937605
2,10,2,14,0.16666666666666666,0.8571428571428571,0.2423521906789922,0.9428018952284545
3,12,1,16,0.2,0.9375,0.22541160913664074,0.9375679050806713
26,231,6,263,0.10116731517509728,0.9771863117870723,0.18661732948632997,0.936859827172702
41,108,23,172,0.2751677852348993,0.8662790697674418,0.18839674674748988,0.9212987497723011
2,23,0,25,0.08,1.0,0.17189835791827401,0.9258063780663373
11,83,32,126,0.11702127659574468,0.746031746031746,0.1711553656859201,0.9075557121041596
7,43,1,51,0.14,0.9803921568627451,0.15428900623891548,0.909218877370266
38,147,16,201,0.20540540540540542,0.9203980099502488,0.15982311177302103,0.9182553277713218
33,128,3,164,0.20496894409937888,0.9817073170731707,0.16053296093007516,0.9245706587817748
45,101,3,149,0.3082191780821918,0.9798657718120806,0.19011179848823148,0.9249534387853474
7,114,2,123,0.05785123966942149,0.983739837398374,0.15906657769316324,0.9417335484469092
46,164,11,221,0.21904761904761905,0.9502262443438914,0.1789305232713945,0.9346230119246081
5,97,1,103,0.049019607843137254,0.9902912621359223,0.16921599916387917,0.9695172285109187
9,50,1,60,0.15254237288135594,0.9833333333333333,0.17100776671835857,0.9699373965781458
7,24,8,39,0.22580645161290322,0.7948717948717948,0.1739222018908583,0.9520050801383666
19,140,4,163,0.11949685534591195,0.9754601226993865,0.16171190349750586,0.9511126237992545
29,109,2,140,0.21014492753623187,0.9857142857142858,0.14770129627665443,0.9519481257852839
56,70,15,141,0.4444444444444444,0.8936170212765957,0.20292889695880056,0.939073437767887
25,81,2,108,0.2358490566037736,0.9814814814814815,0.20532910232396553,0.9435384716446855
16,50,1,67,0.24242424242424243,0.9850746268656716,0.23295833583555198,0.9427932380346498
8,119,4,131,0.06299212598425197,0.9694656488549618,0.22016544342167998,0.9408121402520253
22,27,1,50,0.4489795918367347,0.98,0.252047320596513,0.9672590266989117
28,70,1,99,0.2857142857142857,0.98989898989899,0.275792667791995,0.9693217220131408
8,21,1,30,0.27586206896551724,0.9666666666666667,0.28518083085332147,0.9666006335777667
10,81,3,94,0.10989010989010989,0.9680851063829787,0.23738735448841655,0.9772389314501071
21,29,1,51,0.42,0.9803921568627451,0.2636946321164489,0.9770833136474304
10,50,2,62,0.16666666666666666,0.967741935483871,0.2528721212939381,0.9746072148786018
14,165,12,191,0.0782122905027933,0.93717277486911,0.25504643051087256,0.9699939471663371
34,185,4,223,0.1552511415525114,0.9820627802690582,0.21308522332741206,0.970288630061917
56,86,11,153,0.39436619718309857,0.9281045751633987,0.22860692496581395,0.9614608565282611
4,58,2,64,0.06451612903225806,0.96875,0.19841464783249116,0.96175847557588
28,191,6,225,0.1278538812785388,0.9733333333333334,0.200980900887981,0.9625082222830736
7,50,10,67,0.12280701754385964,0.8507462686567164,0.15852476053710382,0.9439873811107838
2,12,1,15,0.14285714285714285,0.9333333333333333,0.15512339999288613,0.9390718665178499
36,48,2,86,0.42857142857142855,0.9767441860465116,0.20517470543126257,0.9447249252574788
16,46,3,65,0.25806451612903225,0.9538461538461539,0.2198623303707656,0.9406939786256352
30,91,22,143,0.24793388429752067,0.8461538461538461,0.19894342852996874,0.9289867316242706
162,418,5,585,0.2793103448275862,0.9914529914529915,0.22962831650072987,0.9322300161175551
7,51,1,59,0.1206896551724138,0.9830508474576272,0.22860485562842633,0.9336182324210256
42,63,3,108,0.4,0.9722222222222222,0.26820385312216066,0.9509719400732407
2,0,0,2,1.0,1.0,0.3906528327139974,0.9604957495970502
1,14,1,16,0.06666666666666667,0.9375,0.33895215244188853,0.9548894373046914
19,84,2,105,0.18446601941747573,0.9809523809523809,0.3284380814830948,0.9587617554627238
61,84,3,148,0.4206896551724138,0.9797297297297297,0.3531174773223652,0.9778440245449929
16,43,4,63,0.2711864406779661,0.9365079365079365,0.3519569195867052,0.9699947309814136
7,22,2,31,0.2413793103448276,0.9354838709677419,0.36919829889705,0.9631994486257157
5,19,0,24,0.20833333333333334,1.0,0.33848150744894184,0.966101448836131
35,77,4,116,0.3125,0.9655172413793104,0.24026722173465617,0.9611753404617468
44,64,2,110,0.4074074074074074,0.9818181818181818,0.28894447041190485,0.9675065092929155
32,86,3,121,0.2711864406779661,0.9752066115702479,0.30512899953131356,0.9669101047602411
78,318,12,408,0.19696969696969696,0.9705882352941176,0.27894157193543523,0.9656640891126027
9,80,13,102,0.10112359550561797,0.8725490196078431,0.24841425489126426,0.9573090229482061
8,22,1,31,0.26666666666666666,0.967741935483871,0.2520267343658127,0.9619173178790816
2,11,1,14,0.15384615384615385,0.9285714285714286,0.2442428515819299,0.9517132362464285
3,12,1,16,0.2,0.9375,0.22817142301050136,0.9477107731922414
24,233,6,263,0.0933852140077821,0.9771863117870723,0.18331110966769773,0.9470490774735113
40,108,23,171,0.2702702702702703,0.8654970760233918,0.18318022818088406,0.9313762866811034
3,22,0,25,0.12,1.0,0.17218455718521303,0.9355779673533723
14,90,22,126,0.1346153846153846,0.8253968253968254,0.17696909848660827,0.9288419396089411
7,43,1,51,0.14,0.9803921568627451,0.1588738603913702,0.9306491140916374
35,152,14,201,0.18716577540106952,0.9303482587064676,0.1636338063277867,0.9309029469680715
32,127,3,162,0.20125786163522014,0.9814814814814815,0.16381350084710386,0.9371860157511405
43,102,3,148,0.296551724137931,0.9797297297297297,0.19283728800855368,0.93754936117152
7,114,2,123,0.05785123966942149,0.983739837398374,0.16249171220843245,0.9544411842250888
47,164,10,221,0.22274881516587677,0.9547511312217195,0.17717011437498625,0.9479770601139059
5,97,1,103,0.049019607843137254,0.9902912621359223,0.16494214626466522,0.9715334082194913
9,50,1,60,0.15254237288135594,0.9833333333333333,0.16673391381914465,0.9719535762867181
7,24,8,39,0.22580645161290322,0.7948717948717948,0.17225401042083519,0.9525997957389077
19,140,4,163,0.11949685534591195,0.9754601226993865,0.16057386666521972,0.9517396016271799
30,108,2,140,0.21739130434782608,0.9857142857142858,0.1492652352666333,0.9525945381964022
54,83,4,141,0.39416058394160586,0.9716312056737588,0.1973094273055168,0.9508647336643143
24,81,2,107,0.22857142857142856,0.9813084112149533,0.1981412292205956,0.9546586308062048
16,50,1,67,0.24242424242424243,0.9850746268656716,0.22577046273218207,0.9539133971961691
10,117,4,131,0.07874015748031496,0.9694656488549618,0.21522728910346192,0.9519322994135446
22,27,1,50,0.4489795918367347,0.98,0.24710916627829502,0.978379185860431
27,70,2,99,0.27835051546391754,0.9797979797979798,0.26980254629515293,0.9789988797316587
8,21,1,30,0.27586206896551724,0.9666666666666667,0.2781555126691088,0.9762777912962844
11,81,2,94,0.11956521739130435,0.9787234042553191,0.23892760316192288,0.9772909625222217
20,30,1,51,0.4,0.9803921568627451,0.2634173990802902,0.9771600690433347
9,49,2,60,0.15517241379310345,0.9666666666666667,0.2509528521329847,0.9745303604434769
13,160,11,184,0.07514450867052024,0.9402173913043478,0.2504391880172997,0.9703520379362462
32,182,5,219,0.14953271028037382,0.9771689497716894,0.20766106208067672,0.9699476021893448
56,86,11,153,0.39436619718309857,0.9281045751633987,0.2242347308977026,0.9625628300986904
5,57,2,64,0.08064516129032258,0.96875,0.19634660122981762,0.9628604491463094
27,189,6,222,0.125,0.972972972972973,0.19712299874534558,0.962038958963117
8,49,10,67,0.14035087719298245,0.8507462686567164,0.16003026691577166,0.9435181177908273
2,11,2,15,0.15384615384615385,0.8666666666666667,0.15984080120906458,0.929232403505113
35,49,2,86,0.4166666666666667,0.9767441860465116,0.2086296809227998,0.9344505170397079
15,47,3,65,0.24193548387096775,0.9538461538461539,0.22183007715002748,0.9311186890503457
28,93,22,143,0.23140495867768596,0.8461538461538461,0.1985499002206828,0.919411442048981
155,425,5,585,0.2672413793103448,0.9914529914529915,0.2252065027949717,0.9226547265422654
6,51,1,58,0.10526315789473684,0.9827586206896551,0.22238695392279123,0.9240526762160772
42,63,3,108,0.4,0.9722222222222222,0.2594796857523652,0.9414063838682923
2,0,0,2,1.0,1.0,0.3803588066314861,0.9604540029159113
1,14,1,16,0.06666666666666667,0.9375,0.3303588066314861,0.9548476906235525
16,86,2,104,0.1568627450980392,0.9807692307692307,0.3182055582353534,0.9586938444697063
59,85,3,147,0.4097222222222222,0.9795918367346939,0.34367945302743,0.9777564145526847
16,43,4,63,0.2711864406779661,0.9365079365079365,0.34424303322280453,0.9699071209891054
7,22,2,31,0.2413793103448276,0.9354838709677419,0.36368819785853174,0.9631535853145464
5,17,0,22,0.22727272727272727,1.0,0.3399837750901581,0.9659507778035755
36,68,4,108,0.34615384615384615,0.9629629629629629,0.2465771816835647,0.9606597725125701
40,50,2,92,0.4444444444444444,0.9782608695652174,0.3005454356518187,0.9664827538790298
29,70,3,102,0.29292929292929293,0.9705882352941176,0.31807636807636813,0.9652572636829514
75,296,12,383,0.20215633423180593,0.9686684073107049,0.2960067934461466,0.9637167426138348
8,74,13,95,0.0975609756097561,0.8631578947368421,0.2657882315202676,0.9538531004575967
7,23,1,31,0.23333333333333334,0.967741935483871,0.2634072791393152,0.9587686150505307
2,10,2,14,0.16666666666666666,0.8571428571428571,0.2547492704813065,0.9383604517852246
1,10,1,12,0.09090909090909091,0.9166666666666666,0.2182857340177701,0.931746695171468
24,202,6,232,0.10619469026548672,0.9741379310344828,0.16996434056363327,0.9311577039527916
40,97,21,158,0.291970802919708,0.8670886075949367,0.16982741341940685,0.9163720428529086
2,21,0,23,0.08695652173913043,1.0,0.15337029734902466,0.9208479846656651
12,80,31,123,0.13043478260869565,0.7479674796747967,0.15806655549173027,0.9043922110853728
6,42,1,49,0.125,0.9795918367346939,0.14259036501553982,0.9060850541212047
35,138,16,189,0.2023121387283237,0.9153439153439153,0.14768257531006226,0.9143994910070701
30,109,3,142,0.2158273381294964,0.9788732394366197,0.1655280391986916,0.9232861442599206
41,97,3,141,0.2971014492753623,0.9787234042553191,0.19280043334295957,0.9239412118628972
6,96,2,104,0.058823529411764705,0.9807692307692307,0.15949367998468192,0.9401813008877963
47,162,11,220,0.22488038277511962,0.95,0.17919708870410897,0.9330384437449392
2,77,1,80,0.02531645569620253,0.9875,0.1641801848594671,0.9672573752199684
8,45,1,54,0.1509433962264151,0.9814814814814815,0.16788638432038352,0.9675273244695094
7,22,8,37,0.2413793103448276,0.7837837837837838,0.17346740883702694,0.9487330199609192
18,139,4,161,0.11464968152866242,0.9751552795031055,0.15901345789405066,0.9482018828275599
26,104,1,131,0.2,0.9923664122137404,0.14514182228328462,0.9501508839644772
51,62,15,128,0.45132743362831856,0.8828125,0.20121380859993515,0.9361570652831587
23,77,2,102,0.23,0.9803921568627451,0.2019451824892038,0.9404988019778365
16,50,1,67,0.24242424242424243,0.9850746268656716,0.23296058059320948,0.940152320101504
7,111,4,122,0.059322033898305086,0.9672131147540983,0.2198718145463366,0.938113981997592
21,25,1,47,0.45652173913043476,0.9787234042553191,0.2506064472299948,0.9659624992078113
26,72,1,99,0.2653061224489796,0.98989898989899,0.27212879593289724,0.9680687435500805
6,22,1,29,0.21428571428571427,0.9655172413793104,0.2741696122594279,0.9642331477165904
10,67,2,79,0.12987012987012986,0.9746835443037974,0.22824714029397233,0.977357582617133
18,30,1,49,0.375,0.9795918367346939,0.24896142600825805,0.9772432511702686
9,48,2,59,0.15789473684210525,0.9661016949152542,0.236885782353667,0.9745328323202089
13,156,9,178,0.07692307692307693,0.949438202247191,0.23940021707149153,0.9719935591049366
33,167,4,204,0.165,0.9803921568627451,0.19775425433857233,0.9722319523345686
56,81,11,148,0.40875912408759124,0.9256756756756757,0.2182475402869454,0.9630571931598096
3,59,2,64,0.04838709677419355,0.96875,0.1945477377852996,0.9635190158199081
25,171,6,202,0.12755102040816327,0.9702970297029703,0.19421643643359007,0.9628923708769328
9,47,11,67,0.16071428571428573,0.835820895522388,0.1636041915356309,0.9423536649894605
2,12,1,15,0.14285714285714285,0.9333333333333333,0.1614559638234934,0.9376724704777575
35,37,2,74,0.4861111111111111,0.972972972972973,0.21991139727892686,0.9410345805814407
12,48,3,63,0.2,0.9523809523809523,0.22491139727892687,0.9370329799411846
30,85,22,137,0.2608695652173913,0.8394160583941606,0.20378431744032688,0.9247101774723967
151,424,5,580,0.26260869565217393,0.9913793103448276,0.2343874029943241,0.9279429360930863
7,46,1,54,0.1320754716981132,0.9814814814814815,0.23503375317860264,0.9295407149185879
40,54,3,97,0.425531914893617,0.9690721649484536,0.27286484306136427,0.9485766105508829
2,0,0,2,1.0,1.0,0.395313822653201,0.9581004200746924
1,14,1,16,0.06666666666666667,0.9375,0.3353931877325661,0.953032852507125
15,80,2,97,0.15789473684210525,0.979381443298969,0.3293781501385811,0.956890065495413
54,88,3,145,0.38028169014084506,0.9793103448275862,0.3464370251276459,0.976874963557331
17,37,4,58,0.3148148148148148,0.9310344827586207,0.3538950421508803,0.9682542739021586
7,22,2,31,0.2413793103448276,0.9354838709677419,0.3695098762432681,0.9616831866859101
4,18,0,22,0.18181818181818182,1.0,0.32603717478513916,0.965237200663468
35,68,5,108,0.33980582524271846,0.9537037037037037,0.23172372124838467,0.9586234440497112
40,50,2,92,0.4444444444444444,0.9782608695652174,0.28569197521663864,0.9644464254161708
28,68,3,99,0.2916666666666667,0.9696969696969697,0.30378027849911665,0.9628385095225408
79,294,12,385,0.21179624664879357,0.9688311688311688,0.28808283920918404,0.9632120741818195
9,73,13,95,0.10975609756097561,0.8631578947368421,0.26502136162104256,0.9527334967859489
7,23,1,31,0.23333333333333334,0.967741935483871,0.25894582795930204,0.9573417917168247
2,10,2,14,0.16666666666666666,0.8571428571428571,0.25678132579479984,0.9369336284515184
2,9,1,12,0.18181818181818182,0.9166666666666666,0.23421166244843747,0.9316426231605132
22,205,6,233,0.09691629955947137,0.9742489270386266,0.18456478460772702,0.9310694885138572
39,101,21,161,0.2785714285714286,0.8695652173913043,0.1826940363084073,0.9167649524701907
2,20,0,22,0.09090909090909091,1.0,0.16542444263130693,0.9212176426371668
11,80,32,123,0.12087912087912088,0.7398373983739838,0.16701344596247056,0.9036004288710442
6,42,1,49,0.125,0.9795918367346939,0.15153725548628008,0.9052932719068759
35,139,15,189,0.20114942528735633,0.9206349206349206,0.15646336386066428,0.9143635666914565
25,111,3,139,0.18382352941176472,0.9784172661870504,0.15674984208831902,0.9231850809086541
41,96,4,141,0.29927007299270075,0.9716312056737588,0.18565752400735175,0.922811120713673
4,99,2,105,0.038834951456310676,0.9809523809523809,0.1514094558480492,0.9387235726509696
47,162,11,220,0.22488038277511962,0.95,0.17054821182891047,0.9315807155081125
2,77,1,80,0.02531645569620253,0.9875,0.15689640251706496,0.9669610871689719
8,45,1,54,0.1509433962264151,0.9814814814814815,0.1606026019779814,0.9672310364185132
7,22,8,37,0.2413793103448276,0.7837837837837838,0.16634972841476303,0.9476808740112077
15,142,4,161,0.09554140127388536,0.9751552795031055,0.1537379958236374,0.9472148759135014
25,105,1,131,0.19230769230769232,0.9923664122137404,0.13845765572577906,0.950177048276356
51,62,15,128,0.45132743362831856,0.8828125,0.19738515317892302,0.9361570652831587
23,78,2,103,0.22772277227722773,0.9805825242718447,0.19779120882208137,0.9405259973219936
14,52,1,67,0.21212121212121213,0.9850746268656716,0.22447760259708271,0.9401795154456609
8,110,4,122,0.06779661016949153,0.9672131147540983,0.21259949030323647,0.9381411773417491
21,25,1,47,0.45652173913043476,0.9787234042553191,0.24333412298689464,0.9659896945519684
25,73,1,99,0.25510204081632654,0.98989898989899,0.2661285000643862,0.9680959388942376
5,23,1,29,0.17857142857142858,0.9655172413793104,0.2641661766734914,0.9642603430607476
10,67,2,79,0.12987012987012986,0.9746835443037974,0.2182437047080359,0.9773847779612901
20,29,1,50,0.40816326530612246,0.98,0.244020917997878,0.9773015602081694
9,48,2,59,0.15789473684210525,0.9661016949152542,0.23627427867229134,0.9745911413581098
14,155,9,178,0.08284023668639054,0.949438202247191,0.23842336817470547,0.9720518681428373
30,167,6,203,0.15228426395939088,0.9704433497536946,0.1949608717216992,0.9708690032140338
54,82,11,147,0.39705882352941174,0.9251700680272109,0.2152404121092828,0.9616220143752082
4,58,2,64,0.06451612903225806,0.96875,0.19894679788940128,0.9620838370353068
23,170,6,199,0.11917098445595854,0.9698492462311558,0.19741834854451965,0.9613932230249294
8,44,15,67,0.15384615384615385,0.7761194029850746,0.16108733262166702,0.9322674234513687
2,11,1,14,0.15384615384615385,0.9285714285714286,0.16050896362224537,0.9269059568308221
33,37,2,72,0.4714285714285714,0.9722222222222222,0.21602158287112835,0.9301608168272552
13,47,3,63,0.21666666666666667,0.9523809523809523,0.22521906897216776,0.9275804743454348
28,87,21,136,0.24347826086956523,0.8455882352941176,0.2032789885921897,0.91621164109785
145,430,5,580,0.25217391304347825,0.9913793103448276,0.23008724345093542,0.9194443997185396
7,45,1,53,0.1346153846153846,0.9811320754716981,0.23229358633085345,0.9210562324671886
38,57,3,98,0.4,0.9693877551020408,0.2674584214956886,0.9486659970553265
2,0,0,2,1.0,1.0,0.3883375423748095,0.9588700786879798
1,14,1,16,0.06666666666666667,0.9375,0.33051441312310875,0.9539097612276622
16,78,2,96,0.1702127659574468,0.9791666666666666,0.32387814159322026,0.9577362918399072
51,92,3,146,0.35664335664335667,0.9794520547945206,0.340044583846619,0.9768596946256789
17,38,4,59,0.3090909090909091,0.9322033898305084,0.3481755832819663,0.9684059916950619
7,21,2,30,0.25,0.9333333333333333,0.3646590997654828,0.9615775999610099
4,20,0,24,0.16666666666666666,1.0,0.32632932408173143,0.9652372006634679
34,75,6,115,0.3119266055045872,0.9478260869565217,0.22803312486810098,0.9577837845143995
40,66,2,108,0.37735849056603776,0.9814814814814815,0.27241767113943977,0.9640668532974682
31,86,3,120,0.26495726495726496,0.975,0.28807730815830007,0.9632165131614138
79,320,12,411,0.19799498746867167,0.9708029197080292,0.2714072614130653,0.9638717565173872
11,79,13,103,0.12222222222222222,0.8737864077669902,0.24528404376442398,0.9549115381258233
7,24,1,32,0.22580645161290322,0.96875,0.2381332412854791,0.9596638422732887
2,10,2,14,0.16666666666666666,0.8571428571428571,0.23813324128547908,0.9392556790079827
3,12,1,16,0.2,0.9375,0.22214372621339523,0.9377805237284795
22,235,6,263,0.08560311284046693,0.9771863117870723,0.1804643865383137,0.9371669280578497
39,108,24,171,0.2653061224489796,0.8596491228070176,0.18051422332284434,0.9206882313159951
3,22,0,25,0.12,1.0,0.16937208225589123,0.9248592427862766
11,89,25,125,0.11,0.8,0.16762605050985951,0.9143183273909923
6,44,1,51,0.12,0.9803921568627451,0.1525108431365876,0.9159814926570987
29,154,14,197,0.15846994535519127,0.9289340101522843,0.15133988294923398,0.9262373716584454
30,126,4,160,0.19230769230769232,0.975,0.1502409818503329,0.9315945145155883
42,103,4,149,0.2896551724137931,0.9731543624161074,0.17939127607509375,0.9310185217483076
7,114,2,123,0.05785123966942149,0.983739837398374,0.1497548642494426,0.94874576668993
46,163,11,220,0.22009569377990432,0.95,0.16405424907514324,0.9416029095470728
4,97,1,102,0.039603960396039604,0.9901960784313726,0.15399767198886316,0.9687737778944118
7,52,1,60,0.11864406779661017,0.9833333333333333,0.1538039673883789,0.9691939459616387
7,24,8,39,0.22580645161290322,0.7948717948717948,0.16342346828233775,0.9500422009215688
14,146,4,164,0.0875,0.975609756097561,0.14845094080981028,0.950129308935506
26,113,1,140,0.18705035971223022,0.9928571428571429,0.13379311042387274,0.9529439918556539
53,84,4,141,0.38686131386861317,0.9716312056737588,0.18079454959518584,0.951214187323566
23,82,2,107,0.21904761904761905,0.9813084112149533,0.18064482463343076,0.9556868174971308
15,51,1,67,0.22727272727272727,0.9850746268656716,0.20745464847295758,0.9549551815591736
3,123,4,130,0.023809523809523808,0.9692307692307692,0.19390685647480238,0.9529405295445216
22,27,1,50,0.4489795918367347,0.98,0.22578873364963545,0.9793874159914081
23,75,1,99,0.23469387755102042,0.98989898989899,0.2468164304426384,0.9814287351058979
6,23,1,30,0.20689655172413793,0.9666666666666667,0.24965160073005377,0.9776872385072585
10,81,2,93,0.10989010989010989,0.978494623655914,0.2100842858759819,0.9786677267904234
20,30,1,51,0.4,0.9803921568627451,0.2359346260120363,0.9785368333115365
9,51,2,62,0.15,0.967741935483871,0.22489566497307525,0.9760607345427079
14,157,9,180,0.08187134502923976,0.95,0.23319021086160613,0.9733134817954552
30,187,6,223,0.1382488479262673,0.9730941704035875,0.1888001045886822,0.9723269347102532
54,88,11,153,0.38028169014084506,0.9281045751633987,0.20959836353008574,0.9634991611765974
4,58,2,64,0.06451612903225806,0.96875,0.18925830314553146,0.9637967802242164
24,195,6,225,0.1095890410958904,0.9733333333333334,0.1892152933177858,0.9630594530352764
8,47,12,67,0.14545454545454545,0.8208955223880597,0.15285165695414943,0.9402742195388927
2,11,1,14,0.15384615384615385,0.9285714285714286,0.15340110750359998,0.9346784328371153
34,49,2,85,0.40963855421686746,0.9764705882352941,0.20022499453040396,0.9384599454421573
13,48,4,65,0.21311475409836064,0.9384615384615385,0.21092012398356014,0.9335124265932933
25,97,21,143,0.20491803278688525,0.8531468531468531,0.18586817293299446,0.9228041805909294
149,430,5,584,0.25734024179620035,0.9914383561643836,0.21341447475641478,0.9260453743286986
8,50,1,59,0.13793103448275862,0.9830508474576272,0.21746333095453882,0.927433590632169
39,67,3,109,0.36792452830188677,0.9724770642201835,0.24924475707558758,0.9490880966081868
2,0,0,2,1.0,1.0,0.37012387795470847,0.9592921782408398
1,14,1,16,0.06666666666666667,0.9375,0.3211278940189655,0.9537249513500835
17,86,2,105,0.1650485436893204,0.9809523809523809,0.3142612925319597,0.9597950717059182
46,97,5,148,0.32167832167832167,0.9662162162162162,0.3309413338021649,0.9759478378586843
16,43,4,63,0.2711864406779661,0.9365079365079365,0.3329193622138457,0.9681006350506206
8,21,2,31,0.27586206896551724,0.9354838709677419,0.35262379571138275,0.9613053526949226
4,20,0,24,0.16666666666666666,1.0,0.3237388111463909,0.9671677025939697
34,75,6,115,0.3119266055045872,0.9478260869565217,0.22544261193276047,0.9597142864449014
39,67,2,108,0.36792452830188677,0.9814814814814815,0.2684794493092205,0.9659973552279703
33,84,3,120,0.28205128205128205,0.975,0.28658108877008326,0.9651470150919158
82,318,12,412,0.205,0.970873786407767,0.27350227103609315,0.9638818803316352
11,79,13,103,0.12222222222222222,0.8737864077669902,0.24737905338745175,0.9549216619400717
7,24,1,32,0.22580645161290322,0.96875,0.24022825090850689,0.9596739660875372
2,10,2,14,0.16666666666666666,0.8571428571428571,0.24022825090850689,0.9392658028222309
3,12,1,16,0.2,0.9375,0.224238735836423,0.9377906475427278
22,234,7,263,0.0859375,0.973384030418251,0.18395487465043917,0.9366338688194091
41,106,25,172,0.2789115646258503,0.8546511627906976,0.1835063435896632,0.919441177789509
3,22,0,25,0.12,1.0,0.17136348644680607,0.9236020654455422
10,94,21,125,0.09615384615384616,0.832,0.16763943272275234,0.9176325786216865
7,43,1,51,0.14,0.9803921568627451,0.15538136820662332,0.9192957438877928
29,155,14,198,0.15760869565217392,0.9292929292929293,0.15408737234741005,0.9296028970520889
31,125,4,160,0.1987179487179487,0.975,0.1539042221642599,0.9349600399092317
45,100,4,149,0.3103448275862069,0.9731543624161074,0.1859624118194323,0.9349272301946397
8,113,2,123,0.06611570247933884,0.983739837398374,0.15556300294135922,0.9533684694243079
46,163,11,220,0.22009569377990432,0.95,0.16986238776705984,0.9462256122814506
4,97,1,102,0.039603960396039604,0.9901960784313726,0.16178383265880172,0.968825052057361
8,51,1,60,0.13559322033898305,0.9833333333333333,0.1611542927072279,0.9692452201245879
7,24,8,39,0.22580645161290322,0.7948717948717948,0.17089682927304636,0.9500422009215688
14,146,4,164,0.0875,0.975609756097561,0.155008550884768,0.9501293089355061
24,115,1,140,0.17266187050359713,0.9928571428571429,0.13533955701582376,0.9529439918556539
51,85,5,141,0.375,0.9645390070921985,0.17946588523306106,0.9502010160976289
24,81,2,107,0.22857142857142856,0.9813084112149533,0.18067670448899306,0.9546736462711936
14,52,1,67,0.21212121212121213,0.9850746268656716,0.2053220261640177,0.9539420103332363
3,123,4,130,0.023809523809523808,0.9692307692307692,0.18935292665980927,0.9519273583185842
21,28,1,50,0.42857142857142855,0.98,0.21831935193959856,0.9783742447654707
24,74,1,99,0.24489795918367346,0.98989898989899,0.24080477468012337,0.9804155638799605
6,23,1,30,0.20689655172413793,0.9666666666666667,0.2456954434259149,0.9766740672813211
11,81,1,93,0.11956521739130435,0.989247311827957,0.20920476019610126,0.9802038251007152
21,29,1,51,0.42,0.9803921568627451,0.23655169897161146,0.9800729316218284
7,53,2,62,0.11666666666666667,0.967741935483871,0.22291533533524782,0.9775968328529997
14,157,9,180,0.08187134502923976,0.95,0.23120988122377867,0.974849580105747
34,186,5,225,0.15454545454545454,0.9777777777777777,0.1920633135057824,0.9745321197882867
54,88,11,153,0.38028169014084506,0.9281045751633987,0.21140384649966407,0.9657043462546309
4,58,2,64,0.06451612903225806,0.96875,0.1910637861151098,0.9660019653022499
25,194,6,225,0.1141552511415525,0.9733333333333334,0.19029093379371664,0.9637285398030179
8,47,12,67,0.14545454545454545,0.8208955223880597,0.15107015457293743,0.9409433063066343
2,11,1,14,0.15384615384615385,0.9285714285714286,0.15638150988429275,0.9353475196048568
34,49,2,85,0.40963855421686746,0.9764705882352941,0.2032053969110967,0.9391290322098987
12,48,5,65,0.2,0.9230769230769231,0.2096989034046032,0.931314624395491
26,96,21,143,0.21311475409836064,0.8531468531468531,0.18581791254139116,0.9206063783931272
152,427,5,584,0.26252158894645944,0.9914383561643836,0.2141044068148485,0.9238475721308964
8,50,1,59,0.13793103448275862,0.9830508474576272,0.21750094729216365,0.925235788434367
39,67,3,109,0.36792452830188677,0.9724770642201835,0.2492823734132124,0.9468902944103846
2,0,0,2,1.0,1.0,0.37016149429233325,0.9570943760430376
1,14,1,16,0.06666666666666667,0.9375,0.32116551035659036,0.9515271491522813
16,87,2,105,0.1553398058252427,0.9809523809523809,0.31478548261733924,0.9597950717059183
45,98,5,148,0.3146853146853147,0.9662162162162162,0.3292955627011898,0.9759478378586843
18,41,4,63,0.3050847457627119,0.9365079365079365,0.33537601367494013,0.9681006350506205
8,21,2,31,0.27586206896551724,0.9354838709677419,0.35508044717247716,0.9613053526949226
4,20,0,24,0.16666666666666666,1.0,0.31561703936500374,0.9662024516287188
35,75,5,115,0.3181818181818182,0.9565217391304348,0.2182144419624063,0.9599912715044951
38,69,2,109,0.35514018691588783,0.981651376146789,0.25942494485515216,0.9662986109540365
31,87,3,121,0.2627118644067797,0.9752066115702479,0.27337684781478927,0.9654777867565889
82,318,12,412,0.205,0.970873786407767,0.2649641494020908,0.9651779029615595
10,80,13,103,0.1111111111111111,0.8737864077669902,0.2420962451782544,0.9562176845699957
7,24,1,32,0.22580645161290322,0.96875,0.23494544269930956,0.9609699887174611
2,10,2,14,0.16666666666666666,0.8571428571428571,0.23494544269930953,0.940561825452155
3,12,1,16,0.2,0.9375,0.21806232581619264,0.9378444341478073
20,237,6,263,0.07782101167315175,0.9771863117870723,0.17844530078151608,0.9372065678107049
40,107,25,172,0.272108843537415,0.8546511627906976,0.1797877263716068,0.9199843608421975
3,22,0,25,0.12,1.0,0.1676448692287497,0.9241452484982309
10,90,25,125,0.1,0.8,0.1660575676414481,0.9136043331029466
7,43,1,51,0.14,0.9803921568627451,0.15379950312531906,0.9152674983690531
28,157,14,199,0.15135135135135136,0.9296482412060302,0.15161160093741688,0.9256254103780777
30,128,3,161,0.189873417721519,0.9813664596273292,0.1501649463262053,0.9318920474676962
42,103,4,149,0.2896551724137931,0.9731543624161074,0.18042696928915405,0.9313160547004155
5,116,2,123,0.04132231404958678,0.983739837398374,0.14745746507660717,0.9497572939300836
47,163,10,220,0.22380952380952382,0.9545454545454546,0.1622873970493963,0.943263787436577
4,97,1,102,0.039603960396039604,0.9901960784313726,0.15365939139168766,0.970434655783916
8,51,1,60,0.13559322033898305,0.9833333333333333,0.15302985144011383,0.9708548238511429
7,24,8,39,0.22580645161290322,0.7948717948717948,0.16366629433462124,0.951601045803395
15,145,4,164,0.09375,0.975609756097561,0.14993437751726138,0.9507786595848566
27,112,1,140,0.19424460431654678,0.9928571428571429,0.1363042963605119,0.9535933425050046
57,80,4,141,0.41605839416058393,0.9716312056737588,0.18983802209065434,0.9518635379729167
24,81,2,107,0.22857142857142856,0.9813084112149533,0.19051829419949787,0.9556868174971308
16,50,1,67,0.24242424242424243,0.9850746268656716,0.21949262020352683,0.9549551815591736
3,123,4,130,0.023809523809523808,0.9692307692307692,0.2035235206993184,0.9529405295445216
22,27,1,50,0.4489795918367347,0.98,0.23540539787415146,0.9793874159914081
25,73,1,99,0.25510204081632654,0.98989898989899,0.25845568941934094,0.9814287351058979
5,24,1,30,0.1724137931034483,0.9666666666666667,0.25533700210318405,0.9776872385072585
11,80,2,93,0.12087912087912088,0.978494623655914,0.21316853449154646,0.9786677267904234
23,27,1,51,0.46,0.9803921568627451,0.2462297589813424,0.9785368333115365
8,52,2,62,0.13333333333333333,0.967741935483871,0.2306453433969268,0.9760607345427079
14,157,9,180,0.08187134502923976,0.95,0.23893988928545765,0.9733134817954551
34,184,7,225,0.1559633027522936,0.9688888888888889,0.1970804194162518,0.9717261802081535
53,89,11,153,0.3732394366197183,0.9281045751633987,0.21395719024530774,0.9628984066744977
5,57,2,64,0.08064516129032258,0.96875,0.2008473857005755,0.9631960257221167
24,195,6,225,0.1095890410958904,0.9733333333333334,0.199234517160114,0.9624586985331766
9,47,11,67,0.16071428571428573,0.835820895522388,0.1564794151192977,0.9418056611988399
2,12,1,15,0.14285714285714285,0.9333333333333333,0.15783995933698475,0.9368901466059059
35,48,2,85,0.42168674698795183,0.9764705882352941,0.20638501675965792,0.940671659210948
13,49,3,65,0.20967741935483872,0.9538461538461539,0.21405846198859294,0.9385226970619858
26,96,21,143,0.21311475409836064,0.8531468531468531,0.19118350734268466,0.9278144510596221
158,421,5,584,0.27288428324697755,0.9914383561643836,0.21864623905077826,0.9310556447973912
8,50,1,59,0.13793103448275862,0.9830508474576272,0.22269509524890227,0.9324438611008619
39,67,3,109,0.36792452830188677,0.9724770642201835,0.2522965584757024,0.9519661709148325
2,0,0,2,1.0,1.0,0.3747455380675392,0.961489980438642
1,14,1,16,0.06666666666666667,0.9375,0.3240283837359271,0.9559227535478858
16,87,2,105,0.1553398058252427,0.9809523809523809,0.3162658675174133,0.9597950717059183
43,102,3,148,0.296551724137931,0.9797297297297297,0.3281854346659233,0.9778783397891864
18,41,4,63,0.3050847457627119,0.9365079365079365,0.3327855007395997,0.9700311369811223
8,21,2,31,0.27586206896551724,0.9354838709677419,0.35248993423713654,0.9632358546254245
4,20,0,24,0.16666666666666666,1.0,0.3161936194699972,0.9671415382820913
35,76,4,115,0.3153153153153153,0.9652173913043478,0.21838152165789942,0.9621725941827123
40,67,2,109,0.37383177570093457,0.981651376146789,0.2622622515199377,0.9684799336322536
30,88,3,121,0.2542372881355932,0.9752066115702479,0.27757346074939215,0.9676852737466846
85,311,15,411,0.21464646464646464,0.9635036496350365,0.2698135960929758,0.9653672623045856
9,92,2,103,0.0891089108910891,0.9805825242718447,0.24138121290308298,0.9716636319851439
7,24,1,32,0.22580645161290322,0.96875,0.2342304104241381,0.9764159361326094
2,11,1,14,0.15384615384615385,0.9285714285714286,0.23239890859263626,0.9662118544999562
3,12,1,16,0.2,0.9375,0.2159252921190198,0.9622522271707636
19,237,6,262,0.07421875,0.9770992366412213,0.1731234313046006,0.9616019215271111
41,105,26,172,0.2808219178082192,0.8488372093023255,0.17692123554354713,0.9435491497745508
2,23,0,25,0.08,1.0,0.15768602630833792,0.9487629141124028
10,100,15,125,0.09090909090909091,0.88,0.15794319488233818,0.9343939820735677
6,44,1,51,0.12,0.9803921568627451,0.14282798750906628,0.9360571473396743
29,156,14,199,0.15675675675675677,0.9296482412060302,0.1432437879248667,0.9362109777160459
29,129,3,161,0.18354430379746836,0.9813664596273292,0.1408929741816479,0.9424776148056644
41,105,3,149,0.2808219178082192,0.9798657718120806,0.17040771243996491,0.9428728341157872
7,114,2,123,0.05785123966942149,0.983739837398374,0.13855475842013668,0.9621446381295083
48,161,11,220,0.22966507177033493,0.95,0.15993548295875598,0.9550017809866512
4,97,1,102,0.039603960396039604,0.9901960784313726,0.1526061785997486,0.9707440779054186
8,51,1,60,0.13559322033898305,0.9833333333333333,0.15483378150531762,0.9711642459726455
7,24,8,39,0.22580645161290322,0.7948717948717948,0.16469802362762428,0.9519104679248976
13,146,4,163,0.08176100628930817,0.9754601226993865,0.15015755255502997,0.9510667055066201
26,113,1,140,0.18705035971223022,0.9928571428571429,0.1367616156841744,0.9529226156559147
54,83,4,141,0.39416058394160586,0.9716312056737588,0.18480580772305785,0.9511928111238268
23,82,2,107,0.21904761904761905,0.9813084112149533,0.1832890287626699,0.9556654412973916
16,50,1,67,0.24242424242424243,0.9850746268656716,0.21226335476669886,0.9549338053594342
3,123,4,130,0.023809523809523808,0.9692307692307692,0.1962942552624904,0.9529191533447824
22,27,1,50,0.4489795918367347,0.98,0.22817613243732346,0.9793660397916687
21,76,1,98,0.21649484536082475,0.9897959183673469,0.2474238237332544,0.9814140106013775
4,25,1,30,0.13793103448275862,0.9666666666666667,0.24040677727190132,0.977672514002738
11,80,2,93,0.12087912087912088,0.978494623655914,0.20136656826297486,0.9786530022859029
22,28,1,51,0.44,0.9803921568627451,0.23293119411331503,0.9785221088070161
7,52,3,62,0.11864406779661017,0.9516129032258065,0.21524831202365327,0.9737418625727496
14,157,9,180,0.08187134502923976,0.95,0.22354285791218412,0.9709946098254969
36,181,7,224,0.16589861751152074,0.96875,0.18310271872286785,0.969387466968354
61,89,3,153,0.4066666666666667,0.9803921568627451,0.2102701217665596,0.9680440724676966
5,56,2,63,0.08196721311475409,0.9682539682539683,0.2022752901425589,0.9682708298373112
25,194,6,225,0.1141552511415525,0.9733333333333334,0.20131473732290628,0.9675335026483711
8,47,12,67,0.14545454545454545,0.8208955223880597,0.1592368152449842,0.9447482691519874
2,12,1,15,0.14285714285714285,0.9333333333333333,0.16269582596791743,0.9421369020244913
38,45,2,85,0.4578313253012048,0.9764705882352941,0.21640439457819818,0.9459184146295333
13,49,3,65,0.20967741935483872,0.9538461538461539,0.22265850912724355,0.9437892937504124
27,94,21,142,0.2231404958677686,0.852112676056338,0.196440484727401,0.9254636536352114
151,428,5,584,0.2607944732297064,0.9914383561643836,0.2219872361723942,0.9287757090509849
6,51,1,58,0.10526315789473684,0.9827586206896551,0.22071693713713483,0.9301221786733167
37,69,3,109,0.3490566037735849,0.9724770642201835,0.24980294546842613,0.9517766846493344
2,0,0,2,1.0,1.0,0.3722519250602629,0.9613004941731439
1,14,1,16,0.06666666666666667,0.9375,0.31637125954104317,0.9557332672823876
17,86,2,105,0.1650485436893204,0.9809523809523809,0.3099957058745405,0.9596055854404201
38,106,4,148,0.2638888888888889,0.972972972972973,0.3158169048775577,0.9768713421427965
16,43,4,63,0.2711864406779661,0.9365079365079365,0.3173014716558806,0.9690241393347326
8,21,2,31,0.27586206896551724,0.9354838709677419,0.341672744665992,0.9622706036601736
4,20,0,24,0.16666666666666666,1.0,0.32120547581073894,0.9645737592857966
35,77,3,115,0.3125,0.9739130434782609,0.22299119009645324,0.9608470512112623
40,65,2,107,0.38095238095238093,0.9813084112149533,0.2678891492801267,0.9671053956705414
34,82,3,119,0.29310344827586204,0.9747899159663865,0.2826934012894604,0.9678771329368765
86,309,15,410,0.21772151898734177,0.9634146341463414,0.273121872255906,0.9655661039956832
8,93,2,103,0.07920792079207921,0.9805825242718447,0.24287884795347578,0.9724774089158742
7,24,1,32,0.22580645161290322,0.96875,0.23942262675531908,0.977536932725398
2,11,1,14,0.15384615384615385,0.9285714285714286,0.23759112492381732,0.9673328510927449
2,12,1,15,0.14285714285714285,0.9333333333333333,0.21335643104626628,0.9615357496434696
19,236,6,261,0.07450980392156863,0.9770114942528736,0.1695789200418645,0.9609219043631725
39,102,30,171,0.2765957446808511,0.8245614035087719,0.16722067667114865,0.9394606882977989
2,23,0,25,0.08,1.0,0.14754617395867126,0.9446871691340358
11,112,2,125,0.08943089430894309,0.984,0.1490065987467947,0.9451753799523439
4,46,1,51,0.08,0.9803921568627451,0.12817710565923707,0.9468385452184503
28,165,6,199,0.14507772020725387,0.9698492462311558,0.12692447228225137,0.952735376312697
29,129,3,161,0.18354430379746836,0.9813664596273292,0.13273692384515498,0.9595972514975536
43,103,3,149,0.2945205479452055,0.9798657718120806,0.16416703013424597,0.9600050054345831
9,111,2,122,0.075,0.9836065573770492,0.13536763803698154,0.9827257417014799
47,163,10,220,0.22380952380952382,0.9545454545454546,0.1559118557240564,0.9762322352079733
4,97,1,102,0.039603960396039604,0.9901960784313726,0.14879372230792734,0.9771173892695979
8,50,1,59,0.13793103448275862,0.9830508474576272,0.1570695843768928,0.977497202211724
7,31,1,39,0.18421052631578946,0.9743589743589743,0.16265998524954076,0.9781414490871266
13,146,4,163,0.08176100628930817,0.9754601226993865,0.14811951417694647,0.9772976866688491
26,113,1,140,0.18705035971223022,0.9928571428571429,0.13276663014366427,0.9791535968181437
53,83,4,140,0.3897058823529412,0.9714285714285714,0.1777246133369416,0.9774138845397898
25,77,2,104,0.24509803921568626,0.9807692307692307,0.1807658298235362,0.9811601382860436
18,47,1,66,0.27692307692307694,0.9848484848484849,0.21466856075597013,0.980396196345631
3,123,4,130,0.023809523809523808,0.9692307692307692,0.19836548780265087,0.9784218994560799
20,29,1,50,0.40816326530612246,0.98,0.2303587362298413,0.9792277602619407
24,73,1,98,0.24742268041237114,0.9897959183673469,0.2540246896759931,0.9812757310716493
4,26,0,30,0.13333333333333333,1.0,0.24635082876472217,0.9822961392349147
11,81,1,93,0.11956521739130435,0.989247311827957,0.20775930519877406,0.9848416735776839
19,31,1,51,0.38,0.9803921568627451,0.22703101388224742,0.9847878058767574
7,53,2,62,0.11666666666666667,0.967741935483871,0.20413724098847455,0.9823440131103841
13,158,9,180,0.07602339181286549,0.95,0.2115963649889519,0.9795967603631314
35,180,6,221,0.16279069767441862,0.9728506787330317,0.17654314104156565,0.9785754287535643
64,87,2,153,0.423841059602649,0.9869281045751634,0.20174576664017677,0.9781657410689668
4,57,2,63,0.06557377049180328,0.9682539682539683,0.19206582909138678,0.9736305936766765
25,192,6,223,0.1152073732718894,0.9730941704035875,0.19144327993147034,0.9713230020446237
8,47,12,67,0.14545454545454545,0.8208955223880597,0.15793678642497685,0.9485377685482401
2,12,1,15,0.14285714285714285,0.9333333333333333,0.1616782830236163,0.9436222539553061
38,45,2,85,0.4578313253012048,0.9764705882352941,0.2162222735219505,0.9474037665603481
13,49,3,65,0.20967741935483872,0.9538461538461539,0.22292037661915337,0.9446888344336514
27,94,21,142,0.2231404958677686,0.852112676056338,0.19424886751417045,0.9254294875023906
147,432,5,584,0.2538860103626943,0.9914383561643836,0.22115061606715486,0.9287415429181642
5,52,1,58,0.08771929824561403,0.9827586206896551,0.2172237482062584,0.9301221786733167
38,67,3,108,0.3619047619047619,0.9722222222222222,0.24814520769914644,0.9517402786496255
2,0,0,2,1.0,1.0,0.3705941872909832,0.9612640881734352
1,14,1,16,0.06666666666666667,0.9375,0.3147135217717635,0.9556968612826788
15,87,2,104,0.14705882352941177,0.9807692307692307,0.3057680080824167,0.9595430151288327
39,106,3,148,0.2689655172413793,0.9797297297297297,0.31231443970721834,0.9777740227964601
17,42,4,63,0.288135593220339,0.9365079365079365,0.3172072372583104,0.9699268199883961
8,21,2,31,0.27586206896551724,0.9354838709677419,0.34408477593258224,0.9631732843138371
4,18,0,22,0.18181818181818182,1.0,0.3250721500721501,0.9646179327993577
35,69,3,107,0.33653846153846156,0.9719626168224299,0.23029193029193026,0.9606125923454192
40,50,2,92,0.4444444444444444,0.9782608695652174,0.28426018426018423,0.9664355737118788
30,69,3,102,0.30303030303030304,0.9705882352941176,0.30076451326451326,0.9665628973686141
81,292,15,388,0.21715817694369974,0.961340206185567,0.28912837981202594,0.9639555215758817
8,85,2,95,0.08602150537634409,0.9789473684210527,0.25985872473591926,0.9706332328031024
7,23,2,32,0.23333333333333334,0.9375,0.2574777723549669,0.9712284708983405
2,11,1,14,0.15384615384615385,0.9285714285714286,0.25348176835896286,0.9610243892656875
2,9,1,12,0.18181818181818182,0.9166666666666666,0.23137887125606577,0.9531249678148642
19,209,6,234,0.08333333333333333,0.9743589743589743,0.17979156966876417,0.9525675542139724
36,91,29,156,0.28346456692913385,0.8141025641025641,0.1769964645114543,0.9302124583294648
3,20,0,23,0.13043478260869565,1.0,0.16460740817788228,0.9357352860172409
9,111,2,122,0.075,0.9836065573770492,0.16303290740983314,0.9364008844395261
4,44,1,49,0.08333333333333333,0.9795918367346939,0.1416043359812617,0.9424140039730536
27,157,6,190,0.14673913043478262,0.968421052631579,0.14058904692249435,0.948106807410218
27,115,3,145,0.19014084507042253,0.9793103448275862,0.1417779988156716,0.9570559042903494
40,99,3,142,0.28776978417266186,0.9788732394366197,0.17098320607843284,0.9577007993014416
6,97,2,105,0.05825242718446602,0.9809523809523809,0.138810043257766,0.9815364874228439
46,163,11,220,0.22009569377990432,0.95,0.15161874485365295,0.9743936302799868
2,77,1,80,0.02531645569620253,0.9875,0.14452109566739615,0.9749498363689798
9,44,1,54,0.16981132075471697,0.9814814814814815,0.15687509387045098,0.9752197856185211
7,29,1,37,0.19444444444444445,0.972972972972973,0.16369013872897412,0.9758700599530058
12,145,4,161,0.07643312101910828,0.9751552795031055,0.14744617815021493,0.9752764791923657
28,101,2,131,0.21705426356589147,0.9847328244274809,0.1373439609206763,0.9761135627624887
46,78,4,128,0.3709677419354839,0.96875,0.18201757731367887,0.9743703654835771
24,74,2,100,0.24489795918367346,0.98,0.18556075808564584,0.9786560797692915
19,47,1,67,0.2878787878787879,0.9850746268656716,0.22306966268315806,0.9783095978929588
3,115,4,122,0.025423728813559324,0.9672131147540983,0.20244286383442125,0.9762712597890468
18,30,1,49,0.375,0.9795918367346939,0.22823651462807204,0.977216811755007
25,72,1,98,0.25773195876288657,0.9897959183673469,0.25413634859146894,0.9793083315927558
7,22,0,29,0.2413793103448276,1.0,0.2576113552741741,0.9814893566745442
10,68,1,79,0.1282051282051282,0.9873417721518988,0.22293098188412333,0.9841453241248156
18,31,1,50,0.3673469387755102,0.98,0.2404236932543857,0.9841453241248156
7,50,2,59,0.12280701754385964,0.9661016949152542,0.2168420117779674,0.9814349052747559
13,155,11,179,0.07738095238095238,0.9385474860335196,0.2242644722875949,0.9773398154575305
30,167,7,204,0.15228426395939088,0.9656862745098039,0.19244793856750794,0.9753533065682605
61,85,2,148,0.4178082191780822,0.9864864864864865,0.21531597576967873,0.9748805305852803
4,57,2,63,0.06557377049180328,0.9682539682539683,0.1902008986478181,0.97034538319299
22,169,6,197,0.11518324607329843,0.9695431472081218,0.18834062977184243,0.9678027224867362
7,43,17,67,0.14,0.746268656716418,0.15586249566105526,0.9344125305890817
2,12,1,15,0.14285714285714285,0.9333333333333333,0.15872679927723857,0.9297313360773787
38,34,2,74,0.5277777777777778,0.972972972972973,0.22306920290535648,0.9346492627830149
14,47,3,64,0.22950819672131148,0.953125,0.23410119329991658,0.9328547949959
29,84,21,134,0.25663716814159293,0.8432835820895522,0.21107675743756096,0.9123972372249094
145,430,5,580,0.25217391304347825,0.9913793103448276,0.23773392065922883,0.9157008575236035
6,48,1,55,0.1111111111111111,0.9818181818181818,0.23715218709320204,0.9174544338964693
40,55,4,99,0.42105263157894735,0.9595959595959596,0.2773025630330517,0.947929762879261
2,0,0,2,1.0,1.0,0.39975154262488843,0.9574535724030705
1,14,1,16,0.06666666666666667,0.9375,0.3338785267518726,0.952386004835503
18,77,3,98,0.18947368421052632,0.9693877551020408,0.32815931067890325,0.9547092555643658
41,103,3,147,0.2847222222222222,0.9795918367346939,0.3321714612618503,0.9741818633708147
16,39,4,59,0.2909090909090909,0.9322033898305084,0.3377050580997949,0.9657281604401977
7,21,2,30,0.25,0.9333333333333333,0.3575463279410647,0.9588017535137906
4,19,0,23,0.17391304347826086,1.0,0.3156991953223257,0.961208635095277
36,68,3,107,0.34615384615384615,0.9719626168224299,0.2222926019157323,0.9572032946413385
38,53,2,93,0.4175824175824176,0.978494623655914,0.2730186615703634,0.9625344593652925
30,67,3,100,0.30927835051546393,0.97,0.2924199419647008,0.9651835578396336
83,290,16,389,0.2225201072386059,0.9588688946015425,0.28195500758631253,0.9641667721315936
8,86,2,96,0.0851063829787234,0.9791666666666666,0.25779344970675966,0.9702608764399836
7,23,2,32,0.23333333333333334,0.9375,0.25541249732580734,0.9708561145352217
2,11,1,14,0.15384615384615385,0.9285714285714286,0.2525457988069349,0.9606520329025686
2,9,1,12,0.18181818181818182,0.9166666666666666,0.2290692753304114,0.9527526114517454
20,211,11,242,0.08658008658008658,0.9545454545454546,0.18178322804436411,0.9493313015788225
37,95,24,156,0.2803030303030303,0.8461538461538461,0.17764389658544502,0.9316389938865149
3,20,0,23,0.13043478260869565,1.0,0.16448885020974355,0.9375148660862945
11,109,2,122,0.09166666666666666,0.9836065573770492,0.16542603359373545,0.9381491361877777
5,44,1,50,0.10204081632653061,0.98,0.14666995973562078,0.9442205647592062
29,154,8,191,0.15846994535519127,0.9581151832460733,0.147330501379769,0.9484411011412985
27,115,4,146,0.19014084507042253,0.9726027397260274,0.14851945327294622,0.9564319687212072
38,99,5,142,0.2773722627737226,0.9647887323943662,0.17577547844346567,0.9578952941281945
6,97,2,105,0.05825242718446602,0.9809523809523809,0.14405396371224222,0.9771522276708423
46,164,10,220,0.21904761904761905,0.9545454545454546,0.15671294034637412,0.9706587211773358
2,77,1,80,0.02531645569620253,0.9875,0.14723433877916495,0.9712149272663287
8,45,1,54,0.1509433962264151,0.9814814814814815,0.15422042162200558,0.971426567477969
7,29,1,37,0.19444444444444445,0.972972972972973,0.1593596357776132,0.9735491088675261
12,143,4,159,0.07741935483870968,0.9748427672955975,0.14325656574451134,0.973869112806036
27,103,1,131,0.2076923076923077,0.9923664122137404,0.13330228644716638,0.977808781351661
47,77,4,128,0.3790322580645161,0.96875,0.1791279765728878,0.9760655840727495
24,77,2,103,0.2376237623762376,0.9805825242718447,0.181781711334119,0.9797851654622338
19,47,1,67,0.2878787878787879,0.9850746268656716,0.2192906159316312,0.979438683585901
3,115,4,122,0.025423728813559324,0.9672131147540983,0.20135923487265184,0.9774003454819893
18,30,1,49,0.375,0.9795918367346939,0.22715288566630262,0.9783458974479494
25,72,1,98,0.25773195876288657,0.9897959183673469,0.2529118290840422,0.9804820618867708
7,22,0,29,0.2413793103448276,1.0,0.2577242580344022,0.981572574427665
10,68,1,79,0.1282051282051282,0.9873417721518988,0.2218918109116325,0.9842285418779362
19,31,1,51,0.38,0.9803921568627451,0.2422312734293128,0.9842013465337791
7,50,2,59,0.12280701754385964,0.9661016949152542,0.2186495919528945,0.9814909276837194
12,155,12,179,0.0718562874251497,0.9329608938547486,0.2252828146116931,0.9765977532695266
32,164,7,203,0.16326530612244897,0.9655172413793104,0.19503500120061437,0.9745870967901862
58,87,2,147,0.4,0.9863945578231292,0.21535900709163056,0.9741011881410121
3,58,2,63,0.04918032786885246,0.9682539682539683,0.1879020095950627,0.9695660407487219
22,171,7,200,0.11398963730569948,0.965,0.18587122518085858,0.9663743590127363
8,45,14,67,0.1509433962264151,0.7910447761194029,0.15314885321320362,0.939324733192259
2,12,1,15,0.14285714285714285,0.9333333333333333,0.15601315682938693,0.9346435386805559
38,33,2,73,0.5352112676056338,0.9726027397260274,0.22220672542659894,0.9403066595193101
14,47,3,64,0.22950819672131148,0.953125,0.2316699955121507,0.9385363393222657
28,84,22,134,0.25,0.835820895522388,0.21024142408357932,0.9170258161364456
143,432,5,580,0.24869565217391304,0.9913793103448276,0.23874361327001653,0.9203294364351399
6,47,1,54,0.11320754716981132,0.9814814814814815,0.2386318861077468,0.9226839337896372
38,57,4,99,0.4,0.9595959595959596,0.27421140093254465,0.946762674286288
2,0,0,2,1.0,1.0,0.3966603805243814,0.9562864838100976
1,14,1,16,0.06666666666666667,0.9375,0.32972543753310035,0.9512718067063793
18,78,3,99,0.1875,0.9696969696969697,0.32372426657291303,0.9536392309488037
43,101,3,147,0.2986111111111111,0.9795918367346939,0.33066871101735745,0.974177936836276
16,39,4,59,0.2909090909090909,0.9322033898305084,0.33669920226523997,0.9657242339056589
7,21,2,30,0.25,0.9333333333333333,0.3562409812409812,0.9588459270273519
4,19,0,23,0.17391304347826086,1.0,0.31735558649011947,0.9621804523936248
36,76,4,116,0.32142857142857145,0.9655172413793104,0.2204168109799154,0.9572543440192406
35,65,5,105,0.35,0.9523809523809523,0.2614882395513439,0.9588549842753432
30,81,4,115,0.2702702702702703,0.9652173913043478,0.2709437592109452,0.9608208529360197
82,309,17,408,0.20971867007672634,0.9583333333333334,0.25894552726386416,0.9587557411770303
7,90,3,100,0.07216494845360824,0.97,0.23535650052963386,0.9635403216758965
7,23,2,32,0.23333333333333334,0.9375,0.2329755481486815,0.9641355597711347
2,11,1,14,0.15384615384615385,0.9285714285714286,0.2301088496298091,0.9539314781384817
3,12,1,16,0.2,0.9375,0.21276191085429885,0.9499290150842945
21,226,22,269,0.08502024291497975,0.9182156133828996,0.17490765984215312,0.9450482523702869
39,100,31,170,0.2805755395683453,0.8176470588235294,0.17637984117044955,0.9239667763015985
3,20,1,24,0.13043478260869565,0.9583333333333334,0.16505357153215944,0.9239667763015985
11,112,2,125,0.08943089430894309,0.984,0.16752013522577872,0.9259667763015986
5,45,1,51,0.1,0.9803921568627451,0.14847251617815968,0.9320942272819908
26,165,8,199,0.13612565445026178,0.9597989949748744,0.1459410162644608,0.9365553081967687
29,125,7,161,0.18831168831168832,0.9565217391304348,0.14427125745184483,0.9392726995011166
40,101,7,148,0.28368794326241137,0.9527027027027027,0.17265235750147795,0.9441994265468027
8,110,4,122,0.06779661016949153,0.9672131147540983,0.14225536758735596,0.9655660059654554
46,163,11,220,0.22009569377990432,0.95,0.15506406918324292,0.9643755297749792
5,97,1,103,0.049019607843137254,0.9902912621359223,0.14929102825955637,0.9652742815086823
10,49,1,60,0.1694915254237288,0.9833333333333333,0.15921838903437477,0.9656944495759092
7,31,1,39,0.18421052631578946,0.9743589743589743,0.16608765644373585,0.9677744466307807
11,145,5,161,0.07051282051282051,0.968944099378882,0.14925924675818333,0.969549069523416
26,112,2,140,0.18840579710144928,0.9857142857142858,0.1356475115923316,0.9742650099536422
56,80,4,140,0.4117647058823529,0.9714285714285714,0.18478581097988322,0.9748672180499955
27,77,2,106,0.25961538461538464,0.9811320754716981,0.19043148109923755,0.9793146574030952
17,49,1,67,0.25757575757575757,0.9850746268656716,0.22022521677532617,0.9785694237930594
3,122,4,129,0.024,0.9689922480620154,0.19944071314336492,0.9765206973257283
19,30,1,50,0.3877551020408163,0.98,0.2285185096755116,0.9773265581315892
24,72,2,98,0.25,0.9795918367346939,0.25415953531653723,0.9788476634681336
7,23,0,30,0.23333333333333334,1.0,0.26057775477823497,0.9808884797946641
12,80,1,93,0.13043478260869565,0.989247311827957,0.22038776573914107,0.9834340141374335
19,32,1,52,0.37254901960784315,0.9807692307692307,0.23652114216663514,0.9833821791799382
6,54,2,62,0.1,0.967741935483871,0.21401031965581266,0.9809060804111096
13,153,14,180,0.0783132530120482,0.9222222222222223,0.22176935580039095,0.974224648148282
27,182,10,219,0.1291866028708134,0.954337899543379,0.18483099877610482,0.9705586337973361
58,93,2,153,0.3841059602649007,0.9869281045751634,0.20398899309966206,0.9716066720602604
4,57,2,63,0.06557377049180328,0.9682539682539683,0.18002334126515776,0.9670715246679702
25,188,9,222,0.11737089201877934,0.9594594594594594,0.178157071180884,0.9628161171867562
7,44,16,67,0.13725490196078433,0.7611940298507462,0.14454362580273275,0.9314482313412584
2,12,1,15,0.14285714285714285,0.9333333333333333,0.15066607478232458,0.9265327167483245
44,38,2,84,0.5365853658536586,0.9761904761904762,0.2161335194739832,0.9342424673152179
13,48,4,65,0.21311475409836064,0.9384615384615385,0.22812325536363282,0.9319744157320977
26,93,23,142,0.2184873949579832,0.8380281690140845,0.20446346031978746,0.9107029963662293
143,436,5,584,0.2469775474956822,0.9914383561643836,0.2303782856060559,0.9140150517820029
7,50,1,58,0.12280701754385964,0.9827586206896551,0.2311548749667816,0.9173435033863166
37,67,4,108,0.3557692307692308,0.9629629629629629,0.26237120765370253,0.9461676366880619
2,0,0,2,1.0,1.0,0.38482018724553935,0.9556914462118714
1,15,1,17,0.0625,0.9411764705882353,0.31709370640930234,0.9506894454115512
17,81,5,103,0.17346938775510204,0.9514563106796117,0.31143008264597966,0.9525458414427046
42,100,5,147,0.29577464788732394,0.9659863945578231,0.3224711187787427,0.970825587948953
15,44,4,63,0.2542372881355932,0.9365079365079365,0.3235082245844442,0.962978385140889
7,21,2,30,0.25,0.9333333333333333,0.3416786506496071,0.9559176298042716
4,19,0,23,0.17391304347826086,1.0,0.3219634829174555,0.9608735069119222
36,76,4,116,0.32142857142857145,0.9655172413793104,0.22502470740725142,0.955947398537538
35,65,5,105,0.35,0.9523809523809523,0.26609613597868004,0.9575480387936404
30,81,4,115,0.2702702702702703,0.9652173913043478,0.27846710753332504,0.9608208529360196
82,309,19,410,0.20971867007672634,0.9536585365853658,0.266468875586244,0.9580879130701778
8,90,3,101,0.08163265306122448,0.9702970297029703,0.24181107057561987,0.9629149263837542
7,23,2,32,0.23333333333333334,0.9375,0.23432807737834094,0.9635101644789923
2,11,1,14,0.15384615384615385,0.9285714285714286,0.23146137885946855,0.9533060828463392
3,12,1,16,0.2,0.9375,0.21411444008395833,0.949303619792152
22,227,22,271,0.08835341365461848,0.9188191881918819,0.17673635632033238,0.9445090820508562
39,103,28,170,0.2746478873239437,0.8352941176470589,0.1773617301851429,0.9259486143855292
3,20,2,25,0.13043478260869565,0.92,0.16603546054685278,0.9211402520161912
13,110,2,125,0.10569105691056911,0.984,0.16947237538247342,0.9230978192014812
5,45,1,51,0.1,0.9803921568627451,0.15042475633485441,0.9292252701818733
26,165,8,199,0.13612565445026178,0.9597989949748744,0.1478932564211555,0.9336863510966512
27,127,7,161,0.17532467532467533,0.9565217391304348,0.14436821003896627,0.9364037424009991
39,101,8,148,0.2785714285714286,0.9459459459459459,0.17154221216993917,0.9402789935087226
7,111,4,122,0.059322033898305086,0.9672131147540983,0.1407813759662765,0.9591245645240141
46,163,11,220,0.22009569377990432,0.95,0.15359007756216347,0.9634102788097282
5,97,1,103,0.049019607843137254,0.9902912621359223,0.14549415626681603,0.9643090305434315
10,49,1,60,0.1694915254237288,0.9833333333333333,0.15542151704163445,0.9647291986106584
7,31,1,39,0.18421052631578946,0.9743589743589743,0.16229078445099554,0.9668091956655298
11,144,6,161,0.07096774193548387,0.9627329192546584,0.1473826511096825,0.9676965071118474
26,113,1,140,0.18705035971223022,0.9928571428571429,0.1343082127012256,0.9743981066705898
55,80,5,140,0.4074074074074074,0.9642857142857143,0.18403469463109734,0.9739799066036777
26,78,2,106,0.25,0.9811320754716981,0.1883067383768253,0.9784273459567776
18,48,1,67,0.2727272727272727,0.9850746268656716,0.22026497621741606,0.9776821123467416
3,122,4,129,0.024,0.9689922480620154,0.19948047258545482,0.9756333858794105
19,30,1,50,0.3877551020408163,0.98,0.22855826911760152,0.9764392466852714
23,73,2,98,0.23958333333333334,0.9795918367346939,0.2526462107458657,0.9788476634681337
8,22,0,30,0.26666666666666666,1.0,0.2640199688822138,0.979868071631399
11,81,1,93,0.11956521739130435,0.989247311827957,0.22289965602277048,0.9834340141374336
20,31,1,52,0.39215686274509803,0.9807692307692307,0.24320777927207018,0.9833821791799383
7,53,2,62,0.11666666666666667,0.967741935483871,0.2209134069776979,0.9809060804111096
13,152,14,179,0.07878787878787878,0.9217877094972067,0.22874024680453772,0.9741625749018512
27,183,11,221,0.12857142857142856,0.9502262443438914,0.19171400773748234,0.9699091812366928
57,94,2,153,0.37748344370860926,0.9869281045751634,0.2114140235053789,0.970957219499617
4,57,2,63,0.06557377049180328,0.9682539682539683,0.18268646690896986,0.9664220721073268
26,187,9,222,0.12206572769953052,0.9594594594594594,0.18304368266728788,0.9621666646261129
7,45,15,67,0.1346153846153846,0.7761194029850746,0.14625204293447167,0.9329309749426619
2,12,1,15,0.14285714285714285,0.9333333333333333,0.14999353953311112,0.9280154603497281
43,40,2,85,0.5180722891566265,0.9764705882352941,0.2127484553000751,0.9358273001694549
13,48,4,65,0.21311475409836064,0.9384615384615385,0.22482607323249396,0.9341466279005471
25,94,24,143,0.21008403361344538,0.8321678321678322,0.2009118717903277,0.9120380175566428
146,432,5,583,0.25259515570934254,0.9914236706689536,0.22762921253569043,0.9153479750444978
6,51,1,58,0.10526315789473684,0.9827586206896551,0.22522884542071991,0.9186764266488116
39,66,4,109,0.37142857142857144,0.963302752293578,0.25905930067974664,0.9454169051214549
2,0,0,2,1.0,1.0,0.3815082802715834,0.9549407146452644
1,15,1,17,0.0625,0.9411764705882353,0.3164265246777796,0.9498986978385416
20,78,5,103,0.20408163265306123,0.9514563106796117,0.3151360787570225,0.9517550938696951
42,101,4,147,0.2937062937062937,0.9727891156462585,0.3270821159131437,0.9718438486523274
14,45,4,63,0.23728813559322035,0.9365079365079365,0.32489539875369766,0.963998743772182
7,21,2,30,0.25,0.9333333333333333,0.34557209048302095,0.9569379884355645
4,19,0,23,0.17391304347826086,1.0,0.3127944120482808,0.960031631700299
36,77,3,116,0.3185840707964602,0.9741379310344828,0.21544927930491806,0.9563370504195109
38,62,5,105,0.38,0.9523809523809523,0.2608064221620609,0.9579376906756132
28,82,4,114,0.2545454545454545,0.9649122807017544,0.2674081537637925,0.9613285206918304
77,313,19,409,0.19743589743589743,0.9535452322738386,0.25365524001087875,0.9585793944957703
8,90,3,101,0.08163265306122448,0.9702970297029703,0.23384005001236116,0.9634064078093466
7,23,2,32,0.23333333333333334,0.9375,0.23420635037866155,0.9646819180134283
2,11,1,14,0.15384615384615385,0.9285714285714286,0.23133965185978914,0.9544778363807751
3,12,1,16,0.2,0.9375,0.21439907031743766,0.9492438462329919
20,202,51,273,0.09009009009009009,0.8131868131868132,0.17298336890173624,0.9293589692052578
41,104,25,170,0.2827586206896552,0.8529411764705882,0.17701382120805062,0.913363097172234
2,21,2,25,0.08695652173913043,0.92,0.16123105325136963,0.9085709211331141
11,112,2,125,0.08943089430894309,0.984,0.16234508771532943,0.910528488318404
5,45,1,51,0.1,0.9803921568627451,0.1432974686677104,0.9166559392987963
25,161,13,199,0.13440860215053763,0.9346733668341709,0.14052067556833664,0.9175276447649025
25,130,7,162,0.16129032258064516,0.9567901234567902,0.13499072165128595,0.9202833766873011
39,100,9,148,0.2805755395683453,0.9391891891891891,0.16220292871960812,0.9382837161162118
6,112,4,122,0.05084745762711865,0.9672131147540983,0.12907276256781716,0.9546082787281419
46,165,11,222,0.21800947867298578,0.9504504504504504,0.14779461355836793,0.9589583430782062
5,97,1,103,0.049019607843137254,0.9902912621359223,0.1420215726346814,0.9598570948119093
10,48,2,60,0.1724137931034483,0.9666666666666667,0.1523664002208883,0.9578963104981838
7,31,1,39,0.18421052631578946,0.9743589743589743,0.15948096081592425,0.9635656830017272
11,144,6,161,0.07096774193548387,0.9627329192546584,0.14657773500947263,0.9644146538299941
26,113,1,140,0.18705035971223022,0.9928571428571429,0.13321699503002765,0.9720815043539874
54,82,4,140,0.39705882352941174,0.9714285714285714,0.1826757615874981,0.9726837124503407
24,80,3,107,0.23076923076923078,0.9719626168224299,0.18449858331553307,0.9757568790749093
18,48,1,67,0.2727272727272727,0.9850746268656716,0.21645682115612383,0.9750116454648735
3,121,5,129,0.024193548387096774,0.9612403100775194,0.19528250048235937,0.9742364516664238
20,29,1,50,0.40816326530612246,0.98,0.2272757489095498,0.9750423124722847
23,72,3,98,0.24210526315789474,0.9693877551020408,0.2517239662270371,0.9759930033076251
7,23,0,30,0.23333333333333334,1.0,0.25833581960148033,0.9770134114708904
12,80,1,93,0.13043478260869565,0.989247311827957,0.2202466708985209,0.9795589458136597
20,31,1,52,0.39215686274509803,0.9807692307692307,0.24330204689507337,0.9808170335203455
7,53,2,62,0.11666666666666667,0.967741935483871,0.22100767460070106,0.978340934751517
13,145,22,180,0.08227848101265822,0.8777777777777778,0.22930552211863842,0.9664177158515538
27,184,10,221,0.12796208530805686,0.9547511312217195,0.1892767821189148,0.9628107345975137
58,92,3,153,0.38666666666666666,0.9803921568627451,0.2099284111915965,0.9643827919919
4,56,4,64,0.06666666666666667,0.9375,0.1861188873820727,0.9554542205633286
26,185,10,221,0.12322274881516587,0.9547511312217195,0.18508859684013987,0.9505261947624375
8,46,13,67,0.14814814814814814,0.8059701492537313,0.15023020904057557,0.9255548974030805
2,12,1,15,0.14285714285714285,0.9333333333333333,0.15397170563921506,0.9206393828101466
42,41,2,85,0.5060240963855421,0.9764705882352941,0.214506793549627,0.9347383557326489
13,49,3,65,0.20967741935483872,0.9538461538461539,0.2261804126991673,0.9346090732504252
32,101,7,140,0.24060150375939848,0.95,0.20531396085527184,0.9302673365557473
144,434,5,583,0.2491349480968858,0.9914236706689536,0.231380858202446,0.9379707180798835
6,50,3,59,0.10714285714285714,0.9491525423728814,0.22908373082068761,0.9371709196729067
40,65,4,109,0.38095238095238093,0.963302752293578,0.26234147836414945,0.9596470058214562
2,0,0,2,1.0,1.0,0.38479045795598615,0.9691708153452657
1,15,1,17,0.0625,0.9411764705882353,0.3214298727580515,0.964128798538543
18,80,6,104,0.1836734693877551,0.9423076923076923,0.31771502276275393,0.9624804468901915
42,101,4,147,0.2937062937062937,0.9727891156462585,0.32530142132659606,0.965736034839657
15,44,4,63,0.2542372881355932,0.9365079365079365,0.32603032704641144,0.9578909299595116
8,20,2,30,0.2857142857142857,0.9333333333333333,0.3515405311280441,0.9556310429538619
4,19,0,23,0.17391304347826086,1.0,0.32098027364831483,0.9513350299068722
36,76,4,116,0.32142857142857145,0.9655172413793104,0.22404149813811078,0.9464089215324881
39,61,5,105,0.39,0.9523809523809523,0.27082721242382507,0.9480095617885904
28,80,5,113,0.25925925925925924,0.9557522123893806,0.2805086263605582,0.9502598778442163
77,312,19,408,0.19794344473007713,0.9534313725490197,0.26811165814739457,0.9465226686748343
6,91,4,101,0.061855670103092786,0.9603960396039604,0.24062856985703737,0.9499352548314091
7,23,1,31,0.23333333333333334,0.967741935483871,0.23396190319037066,0.9650313933980704
2,11,1,14,0.15384615384615385,0.9285714285714286,0.23109520467149827,0.9548273117654175
3,12,1,16,0.2,0.9375,0.21374826589598808,0.9508248487112302
21,194,56,271,0.09767441860465116,0.7933579335793358,0.17198746855379538,0.9281072745967137
42,108,20,170,0.28,0.8823529411764706,0.17495043151675832,0.9176216644234406
2,21,2,25,0.08695652173913043,0.92,0.15909515680376593,0.912845754059295
11,112,2,125,0.08943089430894309,0.984,0.16303447454745884,0.9162177484015864
5,45,1,51,0.1,0.9803921568627451,0.1439868554998398,0.9180249228842827
26,159,13,198,0.14054054054054055,0.9343434343434344,0.1420860535990379,0.9188494951374263
25,129,7,161,0.16233766233766234,0.9565217391304348,0.13670571964727538,0.9215668864417743
38,101,9,148,0.2733812949640288,0.9391891891891891,0.1618067019843293,0.9423999229574676
6,112,4,122,0.05084745762711865,0.9672131147540983,0.12907062450248913,0.9545228048971287
46,163,13,222,0.22009569377990432,0.9414414414414415,0.14809050622259967,0.9575858679601917
5,97,1,103,0.049019607843137254,0.9902912621359223,0.14231746529891312,0.958484619693895
10,48,2,60,0.1724137931034483,0.9666666666666667,0.15266229288512,0.9565238353801695
7,31,1,39,0.18421052631578946,0.9743589743589743,0.15890086228158415,0.9622403410966752
11,144,5,160,0.07096774193548387,0.96875,0.14584801650984439,0.963987235506613
26,113,1,140,0.18705035971223022,0.9928571428571429,0.13351502575958743,0.9716540860306065
56,80,4,140,0.4117647058823529,0.9714285714285714,0.18507463265319232,0.9722562941269598
25,77,5,107,0.24509803921568626,0.9532710280373832,0.18864639628687546,0.9739462350692373
16,50,1,67,0.24242424242424243,0.9850746268656716,0.2162756297984619,0.9732010014592013
3,121,5,129,0.024193548387096774,0.9612403100775194,0.19510130912469742,0.9724258076607517
20,29,1,50,0.40816326530612246,0.98,0.22709455755188787,0.9732316684666126
23,72,3,98,0.24210526315789474,0.9693877551020408,0.2515427748693751,0.9733227763383326
6,24,0,30,0.2,1.0,0.25339272348191366,0.974343184501598
12,80,1,93,0.13043478260869565,0.989247311827957,0.21320273444281976,0.9768887188443675
19,32,1,52,0.37254901960784315,0.9807692307692307,0.23141001735598501,0.9808170335203454
7,53,2,62,0.11666666666666667,0.967741935483871,0.21344464939061705,0.978340934751517
15,144,21,180,0.09433962264150944,0.8833333333333333,0.22346551714124743,0.9672113666452046
29,181,10,220,0.1380952380952381,0.9545454545454546,0.1848843703968354,0.9635750030088409
59,91,3,153,0.3933333333333333,0.9803921568627451,0.20648838042189804,0.9651470604032272
4,51,9,64,0.07272727272727272,0.859375,0.18830656224007986,0.9450577746889415
26,186,10,222,0.12264150943396226,0.954954954954955,0.18719323750083225,0.9401588665642269
8,45,14,67,0.1509433962264151,0.7910447761194029,0.15553529130348537,0.913055373042823
2,12,1,15,0.14285714285714285,0.9333333333333333,0.15927678790212482,0.908139858449889
42,40,2,84,0.5121951219512195,0.9761904761904762,0.21897043066065483,0.921405164572338
13,49,3,65,0.20967741935483872,0.9538461538461539,0.2291964565548835,0.9213052644724379
30,102,8,140,0.22727272727272727,0.9428571428571428,0.2054735128319398,0.9159431196144948
148,430,5,583,0.2560553633217993,0.9914236706689536,0.2316632400597293,0.9348072154243453
5,50,3,58,0.09090909090909091,0.9482758620689655,0.22713003741331908,0.9338530592977754
39,64,3,106,0.3786407766990291,0.9716981132075472,0.25965823462369253,0.9596606788817958
2,0,0,2,1.0,1.0,0.3821072142155293,0.9691844884056054
1,15,1,17,0.0625,0.9411764705882353,0.3178650539367836,0.9641824876052854
20,76,6,102,0.20833333333333334,0.9411764705882353,0.31767304164799715,0.9623725328541541
42,101,4,147,0.2937062937062937,0.9727891156462585,0.3271635511385066,0.9666485289668848
13,46,4,63,0.22033898305084745,0.9365079365079365,0.3220612110997992,0.9588034240867396
6,20,2,28,0.23076923076923078,0.9285714285714286,0.3420412310798192,0.9559885050156629
4,18,0,22,0.18181818181818182,1.0,0.3269570035048428,0.9459845378829497
36,76,3,115,0.32142857142857145,0.9739130434782609,0.23001822799463872,0.9422578298084154
39,61,5,105,0.39,0.9523809523809523,0.27680394228035304,0.9438584700645178
29,79,5,113,0.26851851851851855,0.9557522123893806,0.286906273811256,0.9449778337391913
83,303,18,404,0.21502590673575128,0.9554455445544554,0.2791237539021789,0.9415891020088755
6,89,5,100,0.06315789473684211,0.95,0.2491852713321174,0.9441314748902314
7,23,1,31,0.23333333333333334,0.967741935483871,0.2390403437958855,0.9650333840409885
2,10,2,14,0.16666666666666666,0.8571428571428571,0.23687584163138334,0.9446252207756823
3,11,2,16,0.21428571428571427,0.875,0.22156971918240376,0.9304947859930737
20,204,46,270,0.08928571428571429,0.8296296296296296,0.17861053550893438,0.9129588827428847
40,108,22,170,0.2702702702702703,0.8705882352941177,0.17886078575918463,0.9007926003007043
3,20,2,25,0.13043478260869565,0.92,0.1667763394553195,0.8957289510786391
8,115,2,125,0.06504065040650407,0.984,0.16704530455098549,0.900586093935782
3,45,1,49,0.0625,0.9795918367346939,0.1426405426462236,0.9022789369716139
27,157,13,197,0.14673913043478262,0.934010152284264,0.13979375175595446,0.913259979134672
23,131,6,160,0.14935064935064934,0.9625,0.13051731390808805,0.9257599791346721
38,101,8,147,0.2733812949640288,0.9455782312925171,0.1568166825764187,0.9423240650865131
6,112,4,122,0.05084745762711865,0.9672131147540983,0.12547056648453989,0.9561276192950817
47,162,13,222,0.22488038277511962,0.9414414414414415,0.1389627950797433,0.9591906823581449
5,97,1,103,0.049019607843137254,0.9902912621359223,0.13667407471354803,0.960089434091848
10,48,2,60,0.1724137931034483,0.9666666666666667,0.1523760451568978,0.958242981224987
7,31,1,39,0.18421052631578946,0.9743589743589743,0.15772910171132734,0.9640070986642313
11,143,5,159,0.07142857142857142,0.9685534591194969,0.14659737629388764,0.9648718785384451
25,113,2,140,0.18115942028985507,0.9857142857142858,0.1334228227690057,0.9706056005986978
53,83,4,140,0.3897058823529412,0.9714285714285714,0.1818311691584089,0.9712078086950512
23,76,6,105,0.23232323232323232,0.9428571428571428,0.18289443337956787,0.971410051754437
16,50,1,67,0.24242424242424243,0.9850746268656716,0.21052366689115432,0.9706648181444013
3,121,5,129,0.024193548387096774,0.9612403100775194,0.18934934621738983,0.9698896243459517
20,29,1,50,0.40816326530612246,0.98,0.22134259464458023,0.9706954851518124
22,73,2,97,0.23157894736842105,0.979381443298969,0.24422121977884448,0.9722423400345941
6,24,0,30,0.2,1.0,0.24691273116600804,0.9742831563611247
14,78,1,93,0.15217391304347827,0.989247311827957,0.2129795926932276,0.9768286907038941
18,33,1,52,0.35294117647058826,0.9807692307692307,0.2302107275714213,0.9822447032627639
7,53,2,62,0.11666666666666667,0.967741935483871,0.21224535960605334,0.9797686044939351
13,143,23,179,0.08333333333333333,0.8715083798882681,0.2206939003126586,0.9669497573240421
28,182,10,220,0.13333333333333333,0.9545454545454546,0.181432481459403,0.9633133936876785
56,92,4,152,0.3783783783783784,0.9736842105263158,0.20240382874653975,0.9624995032915853
5,49,9,63,0.09259259259259259,0.8571428571428571,0.18705991340262437,0.942091340026279
26,185,9,220,0.12322274881516587,0.9590909090909091,0.18292403279857977,0.937783282492415
8,41,18,67,0.16326530612244897,0.7313432835820896,0.15582747989170273,0.9021510043228235
2,12,1,15,0.14285714285714285,0.9333333333333333,0.1595689764903422,0.8972354897298895
42,39,2,83,0.5185185185185185,0.9759036144578314,0.22173828865965436,0.9121490946683986
13,49,3,65,0.20967741935483872,0.9538461538461539,0.23264458666272655,0.9120491945684984
29,103,6,138,0.2196969696969697,0.9565217391304348,0.20997581399395387,0.9095974129405155
149,431,5,585,0.25689655172413794,0.9914529914529915,0.23344780815560323,0.9287845749848204
6,49,3,58,0.10909090909090909,0.9482758620689655,0.23142897390928083,0.9272395682673998
39,64,3,106,0.3786407766990291,0.9716981132075472,0.2621968982773637,0.9615759724996081
2,0,0,2,1.0,1.0,0.3846458778692004,0.9710997820234176
1,15,1,17,0.0625,0.9411764705882353,0.31950037522369773,0.9661387614706182
18,76,6,100,0.19148936170212766,0.94,0.3169020812733105,0.9641607394925963
41,103,3,147,0.2847222222222222,0.9795918367346939,0.3261914030626323,0.9674564677217761
15,44,4,63,0.2542372881355932,0.9365079365079365,0.32581150826426875,0.9596071741581967
7,18,4,29,0.28,0.8620689655172413,0.35022709267985314,0.9472919032222362
4,19,0,23,0.17391304347826086,1.0,0.3252200107840793,0.9447670054154172
35,67,6,108,0.3431372549019608,0.9444444444444444,0.23138247577007373,0.9368304974789092
35,50,4,89,0.4117647058823529,0.9550561797752809,0.28127743375326697,0.9388133130770585
28,65,4,97,0.3010752688172043,0.9587628865979382,0.2966384168561856,0.9415803055347727
77,297,19,393,0.20588235294117646,0.9516539440203562,0.28754967497645495,0.9376499165852997
6,85,5,96,0.06593406593406594,0.9479166666666666,0.25800778829171117,0.9398946704190367
7,23,1,31,0.23333333333333334,0.967741935483871,0.24786286075547923,0.9607965795697938
2,11,1,14,0.15384615384615385,0.9285714285714286,0.24499616223660683,0.9505924979371407
2,8,2,12,0.2,0.8333333333333334,0.22454798296489814,0.9347194820641249
20,223,16,259,0.0823045267489712,0.9382239382239382,0.17748224308870078,0.9323148761282187
44,96,28,168,0.3142857142857143,0.8333333333333334,0.17936944958420217,0.9143963685189895
2,20,1,23,0.09090909090909091,0.9565217391304348,0.1629446978653328,0.9150917678204292
10,110,2,122,0.08333333333333333,0.9836065573770492,0.16543030749379956,0.9201903236361982
3,44,2,49,0.06382978723404255,0.9591836734693877,0.14121551519390088,0.9189677147769864
26,150,13,189,0.14772727272727273,0.9312169312169312,0.140341389319775,0.9193456437263439
23,116,4,143,0.16546762589928057,0.972027972027972,0.13540819301967225,0.9391591635398636
38,96,8,142,0.2835820895522388,0.9436619718309859,0.16416213056299617,0.9399360254837276
6,96,3,105,0.058823529411764705,0.9714285714285714,0.12766753272386053,0.9596639166401902
44,164,14,222,0.21153846153846154,0.9369369369369369,0.14490029995662776,0.9568660877554047
2,77,1,80,0.02531645569620253,0.9875,0.13661217457989477,0.9574222938443978
9,43,2,54,0.17307692307692307,0.9629629629629629,0.15221890827173487,0.9579621923434799
7,29,1,37,0.19444444444444445,0.972972972972973,0.15889278994561654,0.9639273411657715
11,139,7,157,0.07333333333333333,0.9554140127388535,0.1457307481504812,0.9615539184101832
26,104,1,131,0.2,0.9923664122137404,0.13379044964301853,0.9685116956077195
49,77,4,130,0.3888888888888889,0.9692307692307692,0.18094264385403627,0.9681977238651764
25,72,6,103,0.25773195876288657,0.941747572815534,0.187541714886097,0.9688849575621188
16,50,1,67,0.24242424242424243,0.9850746268656716,0.2185571129901027,0.9685384756857862
4,116,5,125,0.03333333333333333,0.96,0.19859374302673277,0.9681151952625058
19,27,2,48,0.41304347826086957,0.9583333333333334,0.22982217642907915,0.9660238181711288
21,74,2,97,0.22105263157894736,0.979381443298969,0.2509249333213098,0.9694477368225739
5,24,0,29,0.1724137931034483,1.0,0.24698404662180237,0.9705382493634681
10,67,1,78,0.12987012987012986,0.9871794871794872,0.20998136676197962,0.9731023519275707
19,31,1,51,0.38,0.9803921568627451,0.22744822979585297,0.978623006791458
6,52,2,60,0.10344827586206896,0.9666666666666667,0.20759452028697106,0.9759932981916001
14,143,21,178,0.08917197452229299,0.8820224719101124,0.21557146902825103,0.9648536513216162
29,168,8,205,0.14720812182741116,0.9609756097560975,0.17759498953775696,0.965231119382011
52,87,4,143,0.37410071942446044,0.972027972027972,0.19945900208711595,0.9641806234861542
4,49,10,63,0.07547169811320754,0.8412698412698413,0.18561013137422444,0.941504886524703
22,167,8,197,0.1164021164021164,0.9593908629441624,0.18368612945022253,0.9375350830625138
6,38,23,67,0.13636363636363635,0.6567164179104478,0.14888093464502772,0.8912956917836141
2,12,1,15,0.14285714285714285,0.9333333333333333,0.15451077278718112,0.8865337870217094
42,30,2,74,0.5833333333333334,0.972972972972973,0.22510525261732975,0.8995267157449752
13,48,3,64,0.21311475409836064,0.953125,0.23452048579889392,0.8984052000655327
28,89,6,123,0.23931623931623933,0.9512195121951219,0.21526556006914807,0.8954325629465542
139,438,5,582,0.24090121317157712,0.9914089347079038,0.23889834793462944,0.9168810048662773
8,44,3,55,0.15384615384615385,0.9454545454545454,0.24424749614092048,0.9148901023677606
39,56,3,98,0.4105263157894737,0.9693877551020408,0.2834135932017544,0.9595574362522739
2,0,0,2,1.0,1.0,0.40586257279359117,0.9690812457760835
1,15,1,17,0.0625,0.9411764705882353,0.33145781088882925,0.9645388882925495
18,73,5,96,0.1978021978021978,0.9479166666666666,0.3292703028465202,0.9637948406735017
38,103,3,144,0.2695035460992908,0.9791666666666666,0.333582775244099,0.9677872913122939
15,40,4,59,0.2727272727272727,0.9322033898305084,0.338129355180627,0.9593293563298089
7,16,5,28,0.30434782608695654,0.8214285714285714,0.3596295940721702,0.941611360040384
4,19,0,23,0.17391304347826086,1.0,0.30613869877110506,0.9485977724423102
35,67,6,108,0.3431372549019608,0.9444444444444444,0.21230116375709937,0.9406612645058023
34,50,5,89,0.40476190476190477,0.9438202247191011,0.26119572158022863,0.9410389436673545
26,68,7,101,0.2765957446808511,0.9306930693069307,0.2766492490158389,0.9382808107112017
81,295,17,393,0.2154255319148936,0.9567430025445293,0.275002845773691,0.9350774301223249
6,86,5,97,0.06521739130434782,0.9484536082474226,0.2455786958631741,0.9367839546565373
7,24,1,32,0.22580645161290322,0.96875,0.24355104609358885,0.9561291927517753
2,11,1,14,0.15384615384615385,0.9285714285714286,0.24068434757471646,0.9459251111191221
2,8,2,12,0.2,0.8333333333333334,0.22023616830300777,0.9300520952461065
20,221,15,256,0.08298755186721991,0.94140625,0.17426840360376708,0.9297072417148062
45,95,27,167,0.32142857142857145,0.8383233532934131,0.18067309313915567,0.9165115679985895
3,19,2,24,0.13636363636363635,0.9166666666666666,0.16937853663183325,0.9107863771588948
8,112,2,122,0.06666666666666667,0.9836065573770492,0.16958557596930737,0.9158082270345557
2,45,2,49,0.0425531914893617,0.9591836734693877,0.14340653880880144,0.9144416089587539
27,149,16,192,0.1534090909090909,0.9166666666666666,0.14334410124636385,0.9127409286866451
23,116,5,144,0.16546762589928057,0.9652777777777778,0.1384109049462611,0.9315901350358514
35,99,10,144,0.26119402985074625,0.9305555555555556,0.163868973229622,0.9300400358295022
9,93,3,105,0.08823529411764706,0.9714285714285714,0.13055564789948995,0.9490550669916676
44,156,18,218,0.22,0.9174311926605505,0.14250369984754188,0.9491642849907941
2,77,1,80,0.02531645569620253,0.9875,0.1365965268517613,0.949720491079787
9,43,1,53,0.17307692307692307,0.9811320754716981,0.15524277422141292,0.9528559770801169
7,26,4,37,0.21212121212121213,0.8918918918918919,0.1636302201088588,0.9493167235408635
9,138,7,154,0.061224489795918366,0.9545454545454546,0.14873834352266418,0.9477835345076746
26,103,1,130,0.20155038759689922,0.9923076923076923,0.14021782320068604,0.9566052683294082
53,74,4,131,0.41732283464566927,0.9694656488549618,0.1872303289904035,0.9563248508188925
25,73,6,104,0.25510204081632654,0.9423076923076923,0.19224490624987872,0.95987863648277
15,51,1,67,0.22727272727272727,0.9850746268656716,0.22109580218938227,0.9595321546064374
4,117,5,126,0.03305785123966942,0.9603174603174603,0.20109307764120318,0.9565586381558321
20,27,2,49,0.425531914893617,0.9591836734693877,0.23158032089440386,0.96617174980976
19,74,1,94,0.20430107526881722,0.9893617021276596,0.25201983310481796,0.9711454994643606
5,24,0,29,0.1724137931034483,1.0,0.24785746246289642,0.9722444005632617
10,67,1,78,0.12987012987012986,0.9871794871794872,0.2067927903521051,0.9747749488953368
16,33,1,50,0.32653061224489793,0.98,0.21699687198475814,0.9801595642799522
7,51,2,60,0.1206896551724138,0.9666666666666667,0.20177071882757053,0.9775298556800944
14,144,20,178,0.08860759493670886,0.8876404494382022,0.20970639649857614,0.967147425554486
26,172,7,205,0.13131313131313133,0.9658536585365853,0.1676751417013639,0.9681002805640857
55,86,5,146,0.3900709219858156,0.9657534246575342,0.19421369123236368,0.964727669496925
6,47,10,63,0.11320754716981132,0.8412698412698413,0.18575565609898698,0.9420519325354738
24,166,8,198,0.12631578947368421,0.9595959595959596,0.185247893185209,0.9381114285949698
10,48,7,65,0.1724137931034483,0.8923076923076924,0.16323120473643046,0.9255839560674973
2,12,1,15,0.14285714285714285,0.9333333333333333,0.1663979886913918,0.9208220513055924
42,30,2,74,0.5833333333333334,0.972972972972973,0.23707309417662387,0.9330124118105597
14,47,3,64,0.22950819672131148,0.953125,0.25110096066350673,0.9311940320196191
29,89,5,123,0.2457627118644068,0.959349593495935,0.23048550207473403,0.9302791989965334
139,438,5,582,0.24090121317157712,0.9914089347079038,0.24872745436070057,0.9517276409162566
8,45,3,56,0.1509433962264151,0.9464285714285714,0.25224568389680496,0.9498465854637725
39,56,3,98,0.4105263157894737,0.9693877551020408,0.2862617585662372,0.9608580230058222
2,0,0,2,1.0,1.0,0.4087107381580739,0.9703818325296318
1,15,1,17,0.0625,0.9411764705882353,0.334305976253312,0.965839475046098
18,75,6,99,0.1935483870967742,0.9393939393939394,0.32916886059266387,0.9638778949595179
38,103,3,144,0.2695035460992908,0.9791666666666666,0.33256040834050443,0.9667089054124796
15,40,4,59,0.2727272727272727,0.9322033898305084,0.3371069882770324,0.9582509704299944
7,16,5,28,0.30434782608695654,0.8214285714285714,0.3590219068285383,0.9403938275728516
4,19,0,23,0.17391304347826086,1.0,0.3107886649102355,0.9477457649726556
37,74,5,116,0.3333333333333333,0.9568965517241379,0.21555056967214026,0.9415881295046752
37,63,5,105,0.37,0.9523809523809523,0.2594791411007117,0.9431887697607778
30,77,8,115,0.2803738317757009,0.9304347826086956,0.27449572678884565,0.9402536826824681
72,304,32,408,0.19148936170212766,0.9215686274509803,0.2681778805013945,0.933017454858005
6,89,5,100,0.06315789473684211,0.95,0.2360382092894664,0.9349448924997283
7,24,1,32,0.22580645161290322,0.96875,0.23401055951988115,0.9542901305949665
2,11,1,14,0.15384615384615385,0.9285714285714286,0.23114386100100875,0.9440860489623134
4,10,2,16,0.2857142857142857,0.875,0.22434113991257335,0.9323865415731508
20,240,8,268,0.07692307692307693,0.9701492537313433,0.1824730080444415,0.9349248703374924
44,94,31,169,0.3188405797101449,0.8165680473372781,0.18796825774936204,0.9186581938701471
2,21,1,24,0.08695652173913043,0.9583333333333334,0.17303499489750532,0.9239102947104831
9,114,2,125,0.07317073170731707,0.984,0.17446540017900175,0.928767437567626
3,46,2,51,0.061224489795918366,0.9607843137254902,0.1509536913480039,0.9276294823855532
26,155,18,199,0.143646408839779,0.9095477386934674,0.14949658491852175,0.9249118124029874
25,126,7,158,0.16556291390728478,0.9556962025316456,0.13233210323180736,0.9364398413360797
36,101,11,148,0.26277372262773724,0.9256756756756757,0.15888219547533028,0.9300864730424128
8,104,4,116,0.07142857142857142,0.9655172413793104,0.1235376228636769,0.9513649293341316
45,155,18,218,0.225,0.9174311926605505,0.14325811975808686,0.945521766380877
6,96,1,103,0.058823529411764705,0.9902912621359223,0.14120851943015078,0.9464205181145802
9,49,1,59,0.15517241379310345,0.9830508474576272,0.15462965142974866,0.9496014515048854
7,27,5,39,0.20588235294117646,0.8717948717948718,0.16352050058709114,0.9442081848050862
8,140,8,156,0.05405405405405406,0.9487179487179487,0.14759066346520106,0.9432112914031295
26,103,2,131,0.20155038759689922,0.9847328244274809,0.1388444727465099,0.9516480269391014
54,81,4,139,0.4,0.9712230215827338,0.18578324825671397,0.9524631383967334
29,71,6,106,0.29,0.9433962264150944,0.19506896254242825,0.9561724289330968
16,50,1,67,0.24242424242424243,0.9850746268656716,0.22129763582992507,0.9554271953230611
5,117,6,128,0.040983606557377046,0.953125,0.20498494908196419,0.9511520742576858
20,28,1,49,0.4166666666666667,0.9795918367346939,0.23509699389989133,0.9665516406776603
18,76,1,95,0.19148936170212766,0.9894736842105263,0.2547306092781875,0.9723738886051713
6,24,0,30,0.2,1.0,0.2545091253357734,0.97455491368696
12,81,1,94,0.12903225806451613,0.9893617021276596,0.21579944791641856,0.9771461537648064
16,35,1,52,0.3137254901960784,0.9807692307692307,0.2191888036587155,0.9824851543868258
8,52,2,62,0.13333333333333333,0.967741935483871,0.2036043880742999,0.9800090556179972
14,144,20,178,0.08860759493670886,0.8876404494382022,0.210407814985633,0.9706541198234547
28,179,10,217,0.13526570048309178,0.9539170506912442,0.17020767695940803,0.9669862932458191
57,91,4,152,0.38513513513513514,0.9736842105263158,0.1978713588784091,0.9647306541480747
5,48,10,63,0.09433962264150944,0.8412698412698413,0.1827770192557676,0.9420549171866234
26,184,8,218,0.12380952380952381,0.963302752293578,0.18203091436219723,0.938332210067469
9,48,8,65,0.15789473684210525,0.8769230769230769,0.1597693781687725,0.9234970452323041
2,12,1,15,0.14285714285714285,0.9333333333333333,0.16112992238645957,0.9185815306393702
42,39,2,83,0.5185185185185185,0.9759036144578314,0.2225457686124324,0.9311905542136029
13,48,4,65,0.21311475409836064,0.9384615384615385,0.23366706198604223,0.9289826238950736
28,103,7,138,0.21374045801526717,0.9492753623188406,0.20918210811177537,0.92549564557972
130,450,5,585,0.22413793103448276,0.9914529914529915,0.22772472359648588,0.94695038132017
7,48,3,58,0.12727272727272726,0.9482758620689655,0.22821946694837209,0.9448036827166539
42,61,4,107,0.4077669902912621,0.9626168224299065,0.26391550315539447,0.9570456463604866
2,0,0,2,1.0,1.0,0.3863644827472313,0.9665694558842962
1,15,1,17,0.0625,0.9411764705882353,0.32121898010172856,0.9616084353314968
16,79,5,100,0.16842105263157894,0.95,0.31483416560647404,0.9632567869798484
32,109,3,144,0.22695035460992907,0.9791666666666666,0.31672129369142576,0.9675269733152521
16,43,4,63,0.2711864406779661,0.9365079365079365,0.3234425093547805,0.9596776797516727
6,19,5,30,0.24,0.8333333333333334,0.3395464054586766,0.9432573185037254
4,19,0,23,0.17391304347826086,1.0,0.3095204475243259,0.9465296871436745
37,75,4,116,0.33035714285714285,0.9655172413793104,0.2138571822182034,0.9416035787692902
38,62,5,105,0.38,0.9523809523809523,0.25921432507534625,0.9432042190253929
29,80,7,116,0.26605504587155965,0.9396551724137931,0.27365812397010514,0.9415863304906685
72,305,32,409,0.1909814323607427,0.921760391198044,0.2657444983653251,0.9363616244713414
6,90,5,101,0.0625,0.9504950495049505,0.233510842190991,0.938359783470915
7,24,1,32,0.22580645161290322,0.96875,0.23280187374008704,0.956936972411007
2,11,1,14,0.15384615384615385,0.9285714285714286,0.2299351752212146,0.946732890778354
4,10,2,16,0.2857142857142857,0.875,0.22355762420080644,0.9338018562955953
20,242,8,270,0.07633587786259542,0.9703703703703703,0.18017703532403437,0.9363717731512265
45,94,31,170,0.3237410071942446,0.8176470588235294,0.18841788694156078,0.9189420426383317
2,21,1,24,0.08695652173913043,0.9583333333333334,0.1735571854241876,0.9241667486576588
9,114,2,125,0.07317073170731707,0.984,0.17508157566809007,0.9289531701569516
3,46,2,51,0.061224489795918366,0.9607843137254902,0.1515698668370922,0.9278152149748787
25,157,17,199,0.13736263736263737,0.914572864321608,0.14921507876801843,0.9258154200820472
26,127,6,159,0.16993464052287582,0.9622641509433962,0.13267512945495988,0.9382817273596753
37,100,11,148,0.27007299270072993,0.9256756756756757,0.16035186014612196,0.9318967709747188
8,104,4,116,0.07142857142857142,0.9655172413793104,0.12430722646531149,0.9530210827684018
47,153,18,218,0.235,0.9174311926605505,0.14545629478829286,0.9471779198151472
6,96,1,103,0.058823529411764705,0.9902912621359223,0.14340669446035684,0.9480766715488504
7,51,1,59,0.1206896551724138,0.9830508474576272,0.15190171808557043,0.9512576049391557
7,28,4,39,0.2,0.8974358974358975,0.1608499127480508,0.9488094668126256
8,140,8,156,0.05405405405405406,0.9487179487179487,0.14429554325250485,0.946874295066133
26,104,1,131,0.2,0.9923664122137404,0.13428511572382915,0.9564015431429995
54,80,5,139,0.40298507462686567,0.9640287769784173,0.1816503304664426,0.9561889053714433
30,70,6,106,0.3,0.9433962264150944,0.19093604475215686,0.9598981959078067
16,50,1,67,0.24242424242424243,0.9850746268656716,0.21716471803965368,0.9591529622977708
4,118,6,128,0.03278688524590164,0.953125,0.2046071794787234,0.9548778412323955
20,28,1,49,0.4166666666666667,0.9795918367346939,0.23555956043110435,0.9666144039893664
19,75,1,95,0.20212765957446807,0.9894736842105263,0.25671293264830636,0.9724366519168777
6,24,0,30,0.2,1.0,0.25671293264830636,0.9735271644577718
12,81,1,94,0.12903225806451613,0.9893617021276596,0.21757681599654213,0.9771461537648065
17,34,1,52,0.3333333333333333,0.9807692307692307,0.22233872075844688,0.9824851543868258
7,52,3,62,0.11864406779661017,0.9516129032258065,0.20465583866878512,0.9777049081525595
14,143,21,178,0.08917197452229299,0.8820224719101124,0.21271085142255533,0.9675474041397184
28,181,10,219,0.1339712918660287,0.954337899543379,0.17232579787960706,0.9639396988266734
60,88,4,152,0.40540540540540543,0.9736842105263158,0.20136547585545525,0.961684059728929
5,48,10,63,0.09433962264150944,0.8412698412698413,0.18627113623281374,0.9390083227674777
25,185,8,218,0.11904761904761904,0.963302752293578,0.18484475923039986,0.9352856156483231
9,48,8,65,0.15789473684210525,0.8769230769230769,0.15978210258879585,0.9204504508131585
2,12,1,15,0.14285714285714285,0.9333333333333333,0.16324111331172908,0.9178390836856624
42,39,2,83,0.5185185185185185,0.9759036144578314,0.22457633388261847,0.9312506754781936
13,48,4,65,0.21311475409836064,0.9384615384615385,0.2358825427729516,0.9289826238950736
27,104,7,138,0.20610687022900764,0.9492753623188406,0.2074113234620376,0.9254956455797199
129,451,5,585,0.22241379310344828,0.9914529914529915,0.22570763352802886,0.94695038132017
7,49,3,59,0.125,0.9491525423728814,0.2265579736640833,0.9449289227600703
40,64,4,108,0.38461538461538464,0.9629629629629629,0.2589466376316946,0.9572203350514826
2,0,0,2,1.0,1.0,0.3813956172235314,0.9667441445752922
1,15,1,17,0.0625,0.9411764705882353,0.3162501145780287,0.9617831240224927
17,80,5,102,0.17525773195876287,0.9509803921568627,0.31084196855808616,0.9635715316932533
33,107,4,144,0.2357142857142857,0.9722222222222222,0.3150715993416973,0.9668496545365937
17,42,4,63,0.288135593220339,0.9365079365079365,0.3244604279298246,0.9590003609730144
6,19,5,30,0.24,0.8333333333333334,0.34088899935839606,0.9424547596816504
4,19,0,23,0.17391304347826086,1.0,0.31736581896282534,0.9293144677225728
36,76,4,116,0.32142857142857145,0.9655172413793104,0.2204270434526213,0.9243883593481884
39,60,6,105,0.3939393939393939,0.9428571428571428,0.25884695687253473,0.9246284553866039
30,79,7,116,0.27522935779816515,0.9396551724137931,0.2709545522042454,0.941217849765045
72,314,35,421,0.18652849740932642,0.9168646080760094,0.2647135050715593,0.9343016826647924
6,90,5,101,0.0625,0.9504950495049505,0.23490115640327836,0.9362998416643658
7,24,1,32,0.22580645161290322,0.96875,0.23419218795237445,0.9548770306044579
2,11,1,14,0.15384615384615385,0.9285714285714286,0.231325489433502,0.9446729489718049
4,10,2,16,0.2857142857142857,0.875,0.22622344861717547,0.9317419144890463
21,240,11,272,0.08045977011494253,0.9595588235294118,0.1814406452136824,0.9341278688707989
47,90,31,168,0.34306569343065696,0.8154761904761905,0.19113155030403842,0.9163880143082842
2,21,1,24,0.08695652173913043,0.9583333333333334,0.17690698235115326,0.9223121179164734
8,115,2,125,0.06504065040650407,0.984,0.17726993240922526,0.9270985394157661
3,46,2,51,0.061224489795918366,0.9607843137254902,0.1537582235782274,0.9259605842336933
26,158,17,201,0.14130434782608695,0.9154228855721394,0.15196653700393212,0.9240822209480807
24,130,6,160,0.15584415584415584,0.9625,0.13341366130819932,0.9365822209480807
39,99,10,148,0.2826086956521739,0.9324324324324325,0.1622920792420895,0.9327070222199408
10,102,4,116,0.08928571428571429,0.9655172413793104,0.1260377965070977,0.9541414580632435
47,153,18,218,0.235,0.9174311926605505,0.1471868648300791,0.948298295109989
6,96,1,103,0.058823529411764705,0.9902912621359223,0.14629870468797343,0.9491970468436921
7,51,1,59,0.1206896551724138,0.9830508474576272,0.15479372831318705,0.9523779802339973
8,30,1,39,0.21052631578947367,0.9743589743589743,0.16468258087938517,0.9607974214892595
8,140,8,156,0.05405405405405406,0.9487179487179487,0.15014113776651347,0.9588285570203949
26,104,1,131,0.2,0.9923664122137404,0.13833989553048864,0.9673905541320105
54,81,4,139,0.4,0.9712230215827338,0.18272765063252946,0.9682056655896424
31,70,6,107,0.3069306930693069,0.9439252336448598,0.19300346392814474,0.9719905285874008
17,49,1,67,0.25757575757575757,0.9850746268656716,0.22139663938014373,0.971245294977365
4,119,6,129,0.032520325203252036,0.9534883720930233,0.2088010208131206,0.967022084210993
20,28,1,49,0.4166666666666667,0.9795918367346939,0.23824964236700533,0.9677696359789529
20,75,1,96,0.21052631578947367,0.9895833333333334,0.26060282261492246,0.973607548066865
5,25,0,30,0.16666666666666666,1.0,0.2558409178530176,0.9746980606077592
12,81,1,94,0.12903225806451613,0.9893617021276596,0.2171312404336628,0.9772893006856058
16,35,1,52,0.3137254901960784,0.9807692307692307,0.2181019257374873,0.9825527288462302
8,52,2,62,0.13333333333333333,0.967741935483871,0.20035300798856956,0.9800766300774015
14,143,22,179,0.08917197452229299,0.8770949720670391,0.20844610074843256,0.9691632872165467
20,190,11,221,0.09523809523809523,0.9502262443438914,0.1625277334014938,0.9649682025892892
59,89,5,153,0.39864864864864863,0.9673202614379085,0.18940235238137593,0.9617877637470856
6,48,10,64,0.1111111111111111,0.84375,0.181465844444868,0.9394663351756571
24,186,8,218,0.11428571428571428,0.963302752293578,0.17935919533361058,0.9357436280565025
10,48,7,65,0.1724137931034483,0.8923076923076924,0.15917181003466338,0.9231062654191399
3,11,1,15,0.21428571428571427,0.9333333333333333,0.17073643588500356,0.9181907508262059
43,38,2,83,0.5308641975308642,0.9759036144578314,0.23383532488622802,0.9323062711677477
14,48,3,65,0.22580645161290322,0.9538461538461539,0.2524879472254863,0.9328234010966423
28,104,7,139,0.21212121212121213,0.9496402877697842,0.22584117057870962,0.9302976905726246
135,445,5,585,0.23275862068965517,0.9914529914529915,0.24321938623278738,0.951398117923052
6,50,3,59,0.10714285714285714,0.9491525423728814,0.2421989780695221,0.9493766593629525
40,64,4,108,0.38461538461538464,0.9629629629629629,0.27251349114265583,0.9594702694565626
2,0,0,2,1.0,1.0,0.38475838910183946,0.968994078980372
1,15,1,17,0.0625,0.9411764705882353,0.3178492180260018,0.9640330584275726
16,81,5,102,0.16494845360824742,0.9509803921568627,0.30915521831105097,0.963623663900531
34,104,6,144,0.2463768115942029,0.9583333333333334,0.3140488753786211,0.9648655275524666
17,42,4,63,0.288135593220339,0.9365079365079365,0.32195987145443306,0.9570162339888872
6,20,5,31,0.23076923076923078,0.8387096774193549,0.3396207819724864,0.9412386818526691
4,18,0,22,0.18181818181818182,1.0,0.30998766927279303,0.929802329533964
35,78,3,116,0.30973451327433627,0.9741379310344828,0.21137831402626958,0.9261077482531759
37,63,5,105,0.37,0.9523809523809523,0.2463783140262696,0.9277083885092783
28,80,7,115,0.25925925925925924,0.9391304347826087,0.25554078660337637,0.944727022049651
80,315,23,418,0.20253164556962025,0.9449760765550239,0.2528412257663833,0.9408347155257655
6,90,5,101,0.0625,0.9504950495049505,0.2254501846041557,0.9428328745253388
7,24,1,32,0.22580645161290322,0.96875,0.23023572164775727,0.9614100634654311
2,11,1,14,0.15384615384615385,0.9285714285714286,0.22623971765175324,0.9512059818327779
4,10,2,16,0.2857142857142857,0.875,0.22280825657174602,0.9370434202564234
21,241,9,271,0.08015267175572519,0.966789667896679,0.18140149539399247,0.9391018081872414
46,93,23,162,0.33093525179856115,0.8580246913580247,0.19164092289960705,0.9275152734123008
2,21,1,24,0.08695652173913043,0.9583333333333334,0.1751301909238228,0.9294234529520592
6,117,2,125,0.04878048780487805,0.984,0.17317026061023394,0.9342098744513521
3,46,2,51,0.061224489795918366,0.9607843137254902,0.1496585517792361,0.9330719192692792
22,160,19,201,0.12087912087912088,0.9054726368159204,0.14494897564108852,0.9297720918756353
23,131,6,160,0.14935064935064934,0.9625,0.12546845616056904,0.9422720918756353
37,102,9,148,0.26618705035971224,0.9391891891891891,0.15204479596113862,0.9383291663459937
8,104,3,115,0.07142857142857142,0.9739130434782609,0.11497241305114012,0.9548846452203134
47,153,18,218,0.235,0.9174311926605505,0.13612148137412147,0.9490414822670586
6,96,1,103,0.058823529411764705,0.9902912621359223,0.1375562016036767,0.9499402340007619
8,50,1,59,0.13793103448275862,0.9830508474576272,0.14851427941608245,0.953121167391067
7,27,5,39,0.20588235294117646,0.8717948717948718,0.1606575982820904,0.9483100581023459
7,141,8,156,0.0472972972972973,0.9487179487179487,0.1460785479887544,0.9463411936334813
26,104,1,131,0.2,0.9923664122137404,0.13662325508022405,0.9539379397798459
55,80,4,139,0.4074074074074074,0.9712230215827338,0.1846202316486292,0.9535536509376277
30,70,6,106,0.3,0.9433962264150944,0.19390594593434352,0.9572629414739912
18,47,2,67,0.27692307692307694,0.9701492537313433,0.22506302415024523,0.9543855117019083
5,119,5,129,0.04032258064516129,0.9612403100775194,0.21111895931630276,0.9512697206476073
20,28,1,49,0.4166666666666667,0.9795918367346939,0.24123100413422996,0.9666692870675818
20,75,1,96,0.21052631578947367,0.9895833333333334,0.264549435347398,0.9725071991554939
5,25,0,30,0.16666666666666666,1.0,0.25978753058549325,0.9735977116963882
12,81,1,94,0.12903225806451613,0.9893617021276596,0.22001965210793734,0.9761889517742347
17,34,1,52,0.3333333333333333,0.9807692307692307,0.2247815568698421,0.9815279523962541
9,51,2,62,0.15,0.967741935483871,0.20664968873797399,0.9811840497894725
13,144,22,179,0.08280254777070063,0.8770949720670391,0.21271825547019388,0.9691632872165467
26,184,11,221,0.12380952380952381,0.9502262443438914,0.17088152077631633,0.9649682025892892
60,90,2,152,0.4,0.9868421052631579,0.19794918994924865,0.9645765985792643
6,39,19,64,0.13333333333333333,0.703125,0.1931872851873439,0.9221658842935498
24,186,9,219,0.11428571428571428,0.958904109589041,0.19108063607608647,0.9178147996451758
10,48,7,65,0.1724137931034483,0.8923076923076924,0.16809213032896006,0.9051774370078132
2,12,1,15,0.14285714285714285,0.9333333333333333,0.16707172216569474,0.9002619224148792
43,38,2,83,0.5308641975308642,0.9759036144578314,0.23108052927428954,0.914377442756421
14,48,3,65,0.22580645161290322,0.9538461538461539,0.24565151896048662,0.9148945726853156
27,105,7,139,0.20454545454545456,0.9496402877697842,0.2177294410384087,0.9095800273291194
133,447,5,585,0.2293103448275862,0.9914529914529915,0.2314404426804448,0.9507697403938324
3,52,3,58,0.05454545454545454,0.9482758620689655,0.2229061198604077,0.9492514193195359
39,65,4,108,0.375,0.9629629629629629,0.2518470065599151,0.9593450294131459
2,0,0,2,1.0,1.0,0.3742959861517518,0.9688688389369554
2,14,1,17,0.125,0.9411764705882353,0.31631538650448554,0.9639078183841561
16,68,18,102,0.19047619047619047,0.8235294117647058,0.3112682063420979,0.9452911409439492
32,107,5,144,0.2302158273381295,0.9652777777777778,0.31493540245533724,0.9475250680879482
16,43,4,63,0.2711864406779661,0.9365079365079365,0.3209177018625344,0.9396757745243691
6,20,5,31,0.23076923076923078,0.8387096774193549,0.34609252703735954,0.9240234624315675
4,18,0,22,0.18181818181818182,1.0,0.3107835905605055,0.929034280378818
34,79,3,116,0.3008849557522124,0.9741379310344828,0.2109100128108215,0.9253396990980299
39,60,5,104,0.3939393939393939,0.9519230769230769,0.25825849765930636,0.9268749285744358
27,80,6,113,0.2523364485981308,0.9469026548672567,0.2646898370060777,0.9450038792697583
75,320,23,418,0.189873417721519,0.9449760765550239,0.25814114157853957,0.9411115727458729
7,88,5,100,0.07368421052631578,0.95,0.2275052297651077,0.9430390103875962
7,24,1,32,0.22580645161290322,0.96875,0.23119186570980815,0.9623842484828342
2,11,1,14,0.15384615384615385,0.9285714285714286,0.22719586171380415,0.9521801668501811
4,10,2,16,0.2857142857142857,0.875,0.22502862313695746,0.9380176052738264
22,238,10,270,0.08461538461538462,0.9629629629629629,0.1808394789478133,0.939594731850953
45,87,29,161,0.3409090909090909,0.8198757763975155,0.19349271356366474,0.9214480349267042
2,21,0,23,0.08695652173913043,1.0,0.1787902998518949,0.9293085954188437
6,117,2,125,0.04878048780487805,0.984,0.17523262517740382,0.9341657382759865
3,46,2,51,0.061224489795918366,0.9607843137254902,0.15172091634640597,0.9330277830939137
24,156,19,199,0.13333333333333333,0.9045226130653267,0.14879051341600305,0.9295922380216135
22,130,5,157,0.14473684210526316,0.9681528662420382,0.1286508786147141,0.9428997903419046
34,102,10,146,0.25,0.9315068493150684,0.15227725224108773,0.938406059820777
7,105,3,115,0.0625,0.9739130434782609,0.11250452496836048,0.9604113836894548
47,153,18,218,0.235,0.9174311926605505,0.13365359329134183,0.9486158397838192
6,96,1,103,0.058823529411764705,0.9902912621359223,0.1350883135208971,0.9495145915175224
8,50,1,59,0.13793103448275862,0.9830508474576272,0.14604639133330283,0.9526955249078276
7,27,5,39,0.20588235294117646,0.8717948717948718,0.15641053699156612,0.9480201332977627
9,139,8,156,0.060810810810810814,0.9487179487179487,0.14442110394950153,0.945243716508607
26,104,1,131,0.2,0.9923664122137404,0.13727824680664438,0.9539379397798459
55,80,4,139,0.4074074074074074,0.9712230215827338,0.18655073357913116,0.9535536509376278
29,70,6,105,0.29292929292929293,0.9428571428571428,0.19482634685474443,0.9571859295371408
18,46,3,67,0.28125,0.9552238805970149,0.22660155693877804,0.9521763036030112
4,119,5,128,0.032520325203252036,0.9609375,0.2115428841845628,0.9490172539662074
19,29,1,49,0.3958333333333333,0.9795918367346939,0.23867873852629953,0.9644168203861819
21,74,1,96,0.22105263157894736,0.9895833333333334,0.2615704272074618,0.9702547324740941
5,25,0,30,0.16666666666666666,1.0,0.2568085224455571,0.9713452450149882
13,80,1,94,0.13978494623655913,0.9893617021276596,0.21857674227829302,0.9739364850928348
16,35,1,52,0.3137254901960784,0.9807692307692307,0.22154762760211957,0.9793524976517045
8,52,2,62,0.13333333333333333,0.967741935483871,0.20041667522116718,0.9811407912069697
14,144,21,179,0.08860759493670886,0.88268156424581,0.20842914232594673,0.9699613718135139
28,179,11,218,0.13526570048309178,0.9495412844036697,0.1712051947759122,0.9656684357662247
60,89,2,151,0.40268456375838924,0.9867549668874173,0.19715261365868963,0.9652643834168082
7,37,20,64,0.1590909090909091,0.6875,0.19607036257643856,0.9206215262739511
24,185,9,218,0.11483253588516747,0.9587155963302753,0.19250573252623976,0.9162435111600391
9,47,9,65,0.16071428571428573,0.8615384615384616,0.17064698902884076,0.899210544127072
2,12,1,15,0.14285714285714285,0.9333333333333333,0.17200753324652787,0.8942950295341381
43,38,2,83,0.5308641975308642,0.9759036144578314,0.23518704790283576,0.9076124652787125
14,48,3,65,0.22580645161290322,0.9538461538461539,0.24812144092138028,0.9082274466276389
25,106,8,139,0.19083969465648856,0.9424460431654677,0.2178578881925373,0.901897600381646
128,452,5,585,0.2206896551724138,0.9914529914529915,0.2266577090613237,0.945319456303502
4,50,3,57,0.07407407407407407,0.9473684210526315,0.2208350716597389,0.9436984312638385
39,65,4,108,0.375,0.9629629629629629,0.2514473165576981,0.9581876457530532
2,0,0,2,1.0,1.0,0.37389629614953485,0.9677114552768626
2,14,1,17,0.125,0.9411764705882353,0.31591569650226853,0.9627504347240631
16,66,18,100,0.1951219512195122,0.82,0.3115321964460698,0.9436295556031841
31,109,4,144,0.22142857142857142,0.9722222222222222,0.31590203598493877,0.9478832954684346
15,44,4,63,0.2542372881355932,0.9365079365079365,0.3206945549796787,0.9400340019048554
5,21,5,31,0.19230769230769232,0.8387096774193549,0.33758507187019554,0.9245113242429587
4,19,0,23,0.17391304347826086,1.0,0.31605134150831565,0.9335086948532325
35,77,3,115,0.3125,0.9739130434782609,0.21783705579402993,0.9297819867786983
36,57,5,98,0.3870967741935484,0.9489795918367347,0.26420802353596545,0.9308967183856268
25,80,5,110,0.23809523809523808,0.9545454545454546,0.26823926566244566,0.9503772378661465
71,312,21,404,0.185378590078329,0.948019801980198,0.2618339460539027,0.9469474992878929
7,87,5,99,0.07446808510638298,0.9494949494949495,0.22888870881728432,0.9488027868574662
7,24,2,33,0.22580645161290322,0.9393939393939394,0.22817974036638036,0.9591923972470766
2,11,1,14,0.15384615384615385,0.9285714285714286,0.22531304184750794,0.9489883156144235
3,9,2,14,0.25,0.8571428571428571,0.21638447041893652,0.9323068604236516
24,236,10,270,0.09230769230769231,0.9629629629629629,0.1742717444352428,0.9343044848702556
45,91,21,157,0.33088235294117646,0.8662420382165605,0.18752704655609112,0.921689711108985
2,21,7,30,0.08695652173913043,0.7666666666666667,0.1734667510790628,0.8957821203499091
7,114,2,123,0.05785123966942149,0.983739837398374,0.17109291601663967,0.9006742471932555
2,46,1,49,0.041666666666666664,0.9795918367346939,0.1447872324528916,0.9064168039562205
24,154,18,196,0.1348314606741573,0.9081632653061225,0.14207084771403494,0.9035013520611768
25,117,6,148,0.176056338028169,0.9594594594594594,0.13150746743234482,0.918118009534977
37,98,12,147,0.2740740740740741,0.9183673469387755,0.15747409339897075,0.9117472072458073
7,102,2,111,0.06422018348623854,0.9819819819819819,0.11937949776255108,0.9282814849265818
46,154,18,218,0.23,0.9174311926605505,0.1398142803712467,0.9498192743542795
2,82,1,85,0.023809523809523808,0.9882352941176471,0.13495117810554705,0.9504614824570329
7,47,1,55,0.12962962962962962,0.9818181818181818,0.14751731567168463,0.950779531754674
7,26,5,38,0.21212121212121213,0.868421052631579,0.15855870873554959,0.9451020728011679
8,139,7,154,0.05442176870748299,0.9545454545454546,0.1411823416897373,0.9444000720991672
28,101,1,130,0.21705426356589147,0.9923076923076923,0.13303665447428265,0.9549629785804409
51,79,4,134,0.3923076923076923,0.9701492537313433,0.17990629859163318,0.9532725888303497
28,70,6,104,0.2857142857142857,0.9423076923076923,0.1878654822651026,0.9568263744942271
15,50,2,67,0.23076923076923078,0.9701492537313433,0.21743115468791788,0.9542426544390408
4,116,5,125,0.03333333333333333,0.96,0.2036745409313041,0.9511257713221577
20,28,1,49,0.4166666666666667,0.9795918367346939,0.23289532015208333,0.9670073119083169
22,72,1,95,0.23404255319148937,0.9894736842105263,0.2585554322212271,0.9719970590033272
4,26,0,30,0.13333333333333333,1.0,0.24659529933086163,0.9730959601022283
10,80,1,91,0.1111111111111111,0.989010989010989,0.20642435915992147,0.9757904937136063
15,36,1,52,0.29411764705882354,0.9807692307692307,0.20762483935199832,0.9812849992081117
8,52,2,62,0.13333333333333333,0.967741935483871,0.19370542543258437,0.9809410966013301
14,143,21,178,0.08917197452229299,0.8820224719101124,0.2016823741738643,0.9698014497313461
19,185,8,212,0.09313725490196079,0.9622641509433962,0.15546388677890635,0.9673260660468751
57,90,2,149,0.3877551020408163,0.9865771812080537,0.17742282232881018,0.9669122799036646
6,37,21,64,0.13953488372093023,0.671875,0.17830875809846689,0.9200372799036646
23,180,9,212,0.11330049261083744,0.9575471698113207,0.17862152688414207,0.9155424485894262
9,49,7,65,0.15517241379310345,0.8923076923076924,0.1587722078461821,0.9029050859520636
2,11,2,15,0.15384615384615385,0.8666666666666667,0.16170261077658502,0.8884657618353201
44,36,2,82,0.55,0.975609756097561,0.2275351858448289,0.9018353738620986
14,48,3,65,0.22580645161290322,0.9538461538461539,0.24648792823210636,0.9006328028482067
24,105,5,134,0.18604651162790697,0.9626865671641791,0.21767241531597645,0.8972198579847961
135,441,5,581,0.234375,0.9913941480206541,0.23122100335584356,0.9428654505591753
4,49,3,56,0.07547169811320754,0.9464285714285714,0.22581688985618215,0.9412770793616396
40,62,3,105,0.39215686274509803,0.9714285714285714,0.2596718111350385,0.9525800620931938
2,0,0,2,1.0,1.0,0.38055093201415946,0.9716276811408129
1,15,1,17,0.0625,0.9411764705882353,0.3109080748713022,0.9667086403537664
17,65,18,100,0.2073170731707317,0.82,0.30826673509384916,0.9475877612328871
33,107,4,144,0.2357142857142857,0.9722222222222222,0.3153621313919032,0.9489499976697504
17,42,4,63,0.288135593220339,0.9365079365079365,0.323042216137666,0.9411091103107908
5,20,5,30,0.2,0.8333333333333334,0.34083197355006495,0.9249526477257568
4,19,0,23,0.17391304347826086,1.0,0.315313424164596,0.9331338322171734
34,80,2,116,0.2982456140350877,0.9827586206896551,0.21506279759817995,0.9306707780299813
38,55,5,98,0.40860215053763443,0.9489795918367347,0.2645059619606992,0.93178550963691
24,82,4,110,0.22641509433962265,0.9636363636363636,0.2682795468663595,0.9515560303783045
78,309,20,407,0.20155038759689922,0.9508599508599509,0.2574478504125276,0.9505300293523034
8,86,5,99,0.0851063829787234,0.9494949494949495,0.23086498502692152,0.9523853169218767
7,24,2,33,0.22580645161290322,0.9393939393939394,0.23137701779701883,0.9621604879873704
2,11,1,14,0.15384615384615385,0.9285714285714286,0.22851031927814638,0.9519564063547173
4,9,2,15,0.3076923076923077,0.8666666666666667,0.22985984694346354,0.9353718414942903
24,235,9,268,0.09266409266409266,0.9664179104477612,0.18472583867581469,0.9378630298672942
44,91,23,158,0.32592592592592595,0.8544303797468354,0.1989416717595723,0.922262175025933
2,21,7,30,0.08695652173913043,0.7666666666666667,0.18257111949417676,0.8959488487126067
7,114,2,123,0.05785123966942149,0.983739837398374,0.1786775275928479,0.900840975555953
3,46,1,50,0.061224489795918366,0.98,0.1551658187618501,0.9066418413568188
26,154,17,197,0.14444444444444443,0.9137055837563451,0.15382271741874873,0.9045181492403783
27,115,6,148,0.19014084507042253,0.9594594594594594,0.137029651329908,0.9177742624964916
37,97,13,147,0.27611940298507465,0.9115646258503401,0.163237552804334,0.9099380789825743
7,103,3,113,0.06363636363636363,0.9734513274336283,0.1257676153343965,0.926941071509259
46,154,18,218,0.23,0.9174311926605505,0.14620239794309217,0.9484788609369567
2,82,1,85,0.023809523809523808,0.9882352941176471,0.1413392956773925,0.9491210690397099
7,47,1,55,0.12962962962962962,0.9818181818181818,0.15111145851077984,0.9493808092994502
7,27,4,38,0.20588235294117646,0.8947368421052632,0.15988830258174155,0.9466709890635814
12,136,7,155,0.08108108108108109,0.9548387096774194,0.1443083362975499,0.9460108819518613
24,105,1,130,0.18604651162790697,0.9923076923076923,0.1314407803893831,0.9575456057314832
53,78,4,135,0.40458015267175573,0.9703703703703703,0.1801470359658677,0.9571054690081605
31,67,6,104,0.3163265306122449,0.9423076923076923,0.1924793974819027,0.9606592546720379
16,49,2,67,0.24615384615384617,0.9701492537313433,0.2242428721025201,0.9580755346168518
4,117,5,126,0.03305785123966942,0.9603174603174603,0.21044690376109726,0.9550040029738914
20,28,1,49,0.4166666666666667,0.9795918367346939,0.24055894857902446,0.9671261450638101
22,73,1,96,0.23157894736842105,0.9895833333333334,0.26205864376293014,0.9720896627289407
5,25,0,30,0.16666666666666666,1.0,0.259290094482753,0.9731885638278418
11,80,1,92,0.12087912087912088,0.9891304347826086,0.2187613756552337,0.9758685730295902
14,37,1,52,0.27450980392156865,0.9807692307692307,0.21278755755656567,0.9813630785240957
7,53,2,62,0.11666666666666667,0.967741935483871,0.19428938905839716,0.9810191759173138
14,144,21,179,0.08860759493670886,0.88268156424581,0.20222506672940277,0.9699283336213638
20,180,11,211,0.1,0.9478672985781991,0.15698697149130755,0.9653962567418646
58,89,2,149,0.3945578231292517,0.9865771812080537,0.18026966802856909,0.9649668064382532
4,41,19,64,0.08888888888888889,0.703125,0.16915855691745793,0.9225560921525389
22,181,9,212,0.10837438423645321,0.9575471698113207,0.16737216596850543,0.9180441971566405
9,49,7,65,0.15517241379310345,0.8923076923076924,0.1503239673787247,0.905406834519278
2,12,1,15,0.14285714285714285,0.9333333333333333,0.15406546397736415,0.900491319926344
44,35,2,81,0.5569620253164557,0.9753086419753086,0.2209732397458994,0.9137237596019867
14,48,3,65,0.22580645161290322,0.9538461538461539,0.23894558997631418,0.9145778817831232
25,104,6,135,0.1937984496124031,0.9555555555555556,0.2102656794739072,0.9101462209756235
139,437,5,581,0.24131944444444445,0.9913941480206541,0.23204147312470086,0.9513275278357168
5,50,3,58,0.09090909090909091,0.9482758620689655,0.22954643122079196,0.9500030553010947
41,62,3,106,0.39805825242718446,0.9716981132075472,0.2642444081685178,0.9613445440010739
2,0,0,2,1.0,1.0,0.38669338776035456,0.9708683535248834
1,15,1,17,0.0625,0.9411764705882353,0.31605595557228944,0.9659923290410158
17,64,18,99,0.20987654320987653,0.8181818181818182,0.313780254371857,0.9466117096603963
32,107,4,143,0.2302158273381295,0.972027972027972,0.3189827369041037,0.9489649120135988
18,41,4,63,0.3050847457627119,0.9365079365079365,0.3280920656638561,0.941124024654639
6,20,4,30,0.23076923076923078,0.8666666666666667,0.34807208564387615,0.9294655681685964
3,20,0,23,0.13043478260869565,1.0,0.31202499299891906,0.9321348312181726
34,78,4,116,0.30357142857142855,0.9655172413793104,0.21253519708055174,0.9272087228437884
38,62,5,105,0.38,0.9523809523809523,0.25789233993769456,0.9288093630998907
25,80,4,109,0.23809523809523808,0.963302752293578,0.2599731722706277,0.9485322250780301
75,310,18,403,0.19480519480519481,0.9553349875930521,0.25103777993187404,0.9491445160129018
8,87,5,100,0.08421052631578947,0.95,0.22190562751693843,0.9510719536546252
7,24,2,33,0.22580645161290322,0.9393939393939394,0.22241766028703572,0.9608471247201188
2,11,1,14,0.15384615384615385,0.9285714285714286,0.22576214189238689,0.9506430430874656
4,10,2,16,0.2857142857142857,0.875,0.22321112148422365,0.9377120086047069
27,231,8,266,0.10465116279069768,0.9699248120300752,0.18387557331146615,0.9402182742688676
43,93,24,160,0.3161764705882353,0.85,0.19503003509618003,0.9240321667983563
2,20,8,30,0.09090909090909091,0.7333333333333333,0.18018773453959375,0.8923176447612536
9,112,2,123,0.0743801652892562,0.983739837398374,0.17878339725008902,0.8971376215324499
3,46,1,50,0.061224489795918366,0.98,0.15527168841909117,0.9029384873333157
29,152,17,198,0.16022099447513813,0.9141414141414141,0.15618237993751752,0.9008770567004566
26,121,6,153,0.17687074829931973,0.9607843137254902,0.14063330316395092,0.9131319586612409
33,97,19,149,0.25384615384615383,0.87248322147651,0.16194687331473037,0.8992117314393029
6,104,4,114,0.05454545454545454,0.9649122807017544,0.12457101388004742,0.9156277715395537
47,153,18,218,0.235,0.9174311926605505,0.145155429464463,0.9419274657291561
5,97,1,103,0.049019607843137254,0.9902912621359223,0.141532492686446,0.9428633835488058
8,50,1,59,0.13793103448275862,0.9830508474576272,0.15249057049885176,0.9432992188998953
7,28,4,39,0.2,0.8974358974358975,0.15817328557383203,0.9409127165133929
12,137,7,156,0.08053691275167785,0.9551282051282052,0.14441130906702604,0.9401047009994953
23,105,2,130,0.1796875,0.9846153846153847,0.13381721566043264,0.9561235814479058
56,80,4,140,0.4117647058823529,0.9714285714285714,0.18484853727998954,0.9570544801231654
31,67,6,104,0.3163265306122449,0.9423076923076923,0.19646661308173882,0.9606082657870427
18,46,3,67,0.28125,0.9552238805970149,0.22964238338986206,0.9555986398529132
5,117,5,127,0.040983606557377046,0.9606299212598425,0.21579275082909327,0.9523956503960868
19,29,1,49,0.3958333333333333,0.9795918367346939,0.24376894130528376,0.9641322131530577
22,73,1,96,0.23157894736842105,0.9895833333333334,0.26534637482196133,0.9690543743252188
6,24,0,30,0.2,1.0,0.26824816053624706,0.971252176523021
12,80,1,93,0.13043478260869565,0.989247311827957,0.22805817149715318,0.9737977108657905
14,37,1,52,0.27450980392156865,0.9807692307692307,0.22208435339848512,0.979292216360296
6,54,2,62,0.1,0.967741935483871,0.19619149625562798,0.9810805099155611
10,133,33,176,0.06993006993006994,0.8125,0.20032670530886984,0.9599190925927265
21,186,10,217,0.10144927536231885,0.9539170506912442,0.15827183988443919,0.9562512660150908
58,88,2,148,0.3972602739726027,0.9864864864864865,0.1819406008278937,0.9558088593226842
5,39,19,63,0.11363636363636363,0.6984126984126984,0.16960293849023136,0.9127249590959268
26,183,10,219,0.12440191387559808,0.954337899543379,0.16874110009978888,0.9077379001981297
9,48,8,65,0.15789473684210525,0.8769230769230769,0.15208180480272265,0.8929027353629652
1,12,2,15,0.07692307692307693,0.8666666666666667,0.14878510150601937,0.8784634112462216
46,34,2,82,0.575,0.975609756097561,0.2209379486588665,0.9017648049744446
13,49,3,65,0.20967741935483872,0.9538461538461539,0.23639911208636935,0.9017546768537174
22,108,6,136,0.16923076923076924,0.9558823529411765,0.20382346855182173,0.897382657775816
129,447,5,581,0.22395833333333334,0.9913941480206541,0.2195837499371031,0.9392371505769525
6,50,3,59,0.10714285714285714,0.9491525423728814,0.21711817040385442,0.9384963852668814
37,66,3,106,0.3592233009708738,0.9716981132075472,0.2458793938508213,0.9520356761646628
2,0,0,2,1.0,1.0,0.3777475257189532,0.971083295212282
1,15,1,17,0.0625,0.9411764705882353,0.30453324000466747,0.9661642544252353
17,68,18,103,0.2,0.8252427184466019,0.30315075152540477,0.9477923350824422
38,99,6,143,0.2773722627737226,0.958041958041958,0.3185995363172553,0.9481008500968395
16,43,4,63,0.2711864406779661,0.9365079365079365,0.32534640879506,0.9402599627378799
6,21,4,31,0.2222222222222222,0.8709677419354839,0.34178631809211213,0.9290907055325375
3,20,0,23,0.13043478260869565,1.0,0.3118593533173382,0.9331338322171735
34,79,3,116,0.3008849557522124,0.9741379310344828,0.21198577556765422,0.9294392509363855
39,61,5,105,0.39,0.9523809523809523,0.2587714898533685,0.9310398911924878
26,79,4,109,0.24761904761904763,0.963302752293578,0.2655742109418039,0.9507627531706272
74,312,18,404,0.19170984455958548,0.9554455445544554,0.2554222283606394,0.9503918369581269
7,88,5,100,0.07368421052631578,0.95,0.2223650090411542,0.9523192745998502
7,24,2,33,0.22580645161290322,0.9393939393939394,0.2228770418112515,0.9620944456653439
2,11,1,14,0.15384615384615385,0.9285714285714286,0.22622152341660268,0.9518903640326908
4,10,2,16,0.2857142857142857,0.875,0.224054284839756,0.937727802456336
26,233,8,267,0.10038610038610038,0.9700374531835206,0.1826808706091989,0.9402501597138458
45,94,22,161,0.3237410071942446,0.8633540372670807,0.19355543626279845,0.9259717718529178
2,19,9,30,0.09523809523809523,0.7,0.17977375778829985,0.8894795512022812
7,114,2,123,0.05785123966942149,0.983739837398374,0.17751190480874351,0.8942995279734776
3,46,1,50,0.061224489795918366,0.98,0.1540001959777457,0.9001003937743433
26,157,17,200,0.14207650273224043,0.915,0.15231881724718663,0.8981616182641392
26,122,6,154,0.17567567567567569,0.961038961038961,0.13659901581309947,0.9104528984125623
36,95,18,149,0.2748091603053435,0.8791946308724832,0.16151659580156277,0.8974753523681284
4,107,3,114,0.036036036036036036,0.9736842105263158,0.12041588563610442,0.9132368056908762
47,153,18,218,0.235,0.9174311926605505,0.14038187203066224,0.9442984046423833
5,97,1,103,0.049019607843137254,0.9902912621359223,0.13912021034119307,0.9452343224620331
8,50,1,59,0.13793103448275862,0.9830508474576272,0.15007828815359883,0.9456701578131227
6,28,5,39,0.17647058823529413,0.8717948717948718,0.15499172893974936,0.9394979966409617
12,137,7,156,0.08053691275167785,0.9551282051282052,0.14140047709346396,0.938653602939425
25,104,1,130,0.1937984496124031,0.9923076923076923,0.12982751842304388,0.9548126117158835
56,80,4,140,0.4117647058823529,0.9714285714285714,0.18350304268680345,0.9544903775590629
33,65,6,104,0.336734693877551,0.9423076923076923,0.19803657038359643,0.9580441632229402
18,46,3,67,0.28125,0.9552238805970149,0.2312123406917197,0.9530345372888106
4,120,5,129,0.03225806451612903,0.9612403100775194,0.2161162021250583,0.9499187462345094
19,29,1,49,0.3958333333333333,0.9795918367346939,0.2474537371390639,0.9653183126544841
22,73,1,96,0.23157894736842105,0.9895833333333334,0.2690311706557415,0.9702404738266451
6,24,0,30,0.2,1.0,0.26991710642539823,0.9713393749255462
12,80,1,93,0.13043478260869565,0.989247311827957,0.22972711738630433,0.9738849092683157
13,38,1,52,0.2549019607843137,0.9807692307692307,0.21803672694441328,0.9793794147628212
7,53,2,62,0.11666666666666667,0.967741935483871,0.19452482218250852,0.9811677083180863
11,133,33,177,0.0763888888888889,0.8135593220338984,0.20082922566433137,0.9600704243118549
22,185,10,217,0.10628019323671498,0.9539170506912442,0.15946449136481444,0.9564025977342191
58,88,2,148,0.3972602739726027,0.9864864864864865,0.183133252308269,0.9559601910418124
6,39,19,64,0.13333333333333333,0.703125,0.17360944278445947,0.9135494767560982
26,183,11,220,0.12440191387559808,0.95,0.17274760439401696,0.9079427179235328
9,49,7,65,0.15517241379310345,0.8923076923076924,0.15850052625241548,0.8953053552861702
2,12,1,15,0.14285714285714285,0.9333333333333333,0.1622420228510549,0.8903898406932363
46,35,2,83,0.5679012345679012,0.9759036144578314,0.232458072233771,0.9135818824680838
13,49,3,65,0.20967741935483872,0.9538461538461539,0.2472291045363601,0.9135717543473566
22,108,6,136,0.16923076923076924,0.9558823529411765,0.21465346100181246,0.9091997352694552
124,451,5,580,0.21565217391304348,0.9913793103448276,0.22641329537034247,0.9503789224615734
6,50,3,59,0.10714285714285714,0.9491525423728814,0.22394771583709375,0.9502578570862708
37,66,3,106,0.3592233009708738,0.9716981132075472,0.25309784257677526,0.9615993457862501
2,0,0,2,1.0,1.0,0.37554682216861196,0.9711231553100595
1,15,1,17,0.0625,0.9411764705882353,0.30334664580176895,0.9661621347572602
19,66,18,103,0.2235294117647059,0.8252427184466019,0.3053255018603214,0.9477902154144671
35,101,7,143,0.25735294117647056,0.951048951048951,0.31791438356685014,0.9470997294298634
17,42,4,63,0.288135593220339,0.9365079365079365,0.32826915775360666,0.9392609617388789
6,21,4,31,0.2222222222222222,0.8709677419354839,0.3447090670506588,0.9280917045335365
3,20,0,23,0.13043478260869565,1.0,0.3181692872842251,0.9341328332161745
35,78,3,116,0.30973451327433627,0.9741379310344828,0.21955993203770172,0.9304382519353863
42,58,5,105,0.42,0.9523809523809523,0.2706313606091303,0.9320388921914887
26,79,4,109,0.24761904761904763,0.963302752293578,0.27407273715975056,0.9517617541696283
74,311,19,404,0.19220779220779222,0.9529702970297029,0.2663343058188347,0.9500382301688765
7,89,5,101,0.07291666666666667,0.9504950495049505,0.23316743737654252,0.9520363891684499
5,26,2,33,0.16129032258064516,0.9393939393939394,0.2191718749938834,0.9618115602339435
2,11,1,14,0.15384615384615385,0.9285714285714286,0.22251635659923455,0.9516074786012905
4,10,2,16,0.2857142857142857,0.875,0.21908489551922736,0.9374449170249358
27,233,9,269,0.10384615384615385,0.966542750929368,0.17392006035439217,0.9394680311032809
46,97,18,161,0.32167832167832167,0.8881987577639752,0.1844999566485742,0.9287388890276234
1,20,9,30,0.047619047619047616,0.7,0.16384442170732497,0.8926002751662373
8,113,2,123,0.06611570247933884,0.983739837398374,0.16287285539484955,0.8973495305795834
3,46,1,50,0.061224489795918366,0.98,0.14857773642560287,0.9031503963804494
27,155,18,200,0.14835164835164835,0.91,0.14779280706924494,0.9004973351559595
27,123,6,156,0.18,0.9615384615384616,0.1326907662529184,0.912859972518597
41,94,14,149,0.3037037037037037,0.9060402684563759,0.16124184480399695,0.9042167607367408
4,107,3,114,0.036036036036036036,0.9736842105263158,0.12043580399795616,0.916428968274218
46,153,19,218,0.23115577889447236,0.9128440366972477,0.14665533703730255,0.9468352592309677
5,97,1,103,0.049019607843137254,0.9902912621359223,0.14421303780355946,0.9477711770506174
8,50,1,59,0.13793103448275862,0.9830508474576272,0.15517111561596522,0.9482070124017071
6,28,5,39,0.17647058823529413,0.8717948717948718,0.1591881070279146,0.9427491369438316
6,144,6,156,0.04,0.9615384615384616,0.13918810702791462,0.9427491369438317
26,102,2,130,0.203125,0.9846153846153847,0.12481972078452838,0.9539741535379758
58,78,4,140,0.4264705882352941,0.9714285714285714,0.18059608538442237,0.9536519193811551
33,65,6,104,0.336734693877551,0.9423076923076923,0.19567878752486217,0.9578610130397901
19,45,3,67,0.296875,0.9552238805970149,0.2310867006901283,0.9528513871056603
5,120,5,130,0.04,0.9615384615384616,0.21709655290687707,0.9497781891172082
20,28,1,49,0.4166666666666667,0.9795918367346939,0.25141027839707314,0.9651777555371828
22,73,1,96,0.23157894736842105,0.9895833333333334,0.27877869944970474,0.969184165793593
6,24,0,30,0.2,1.0,0.27833227087827617,0.9713819679913952
12,81,1,94,0.12903225806451613,0.9893617021276596,0.23584108085387928,0.9739438438055507
11,40,1,52,0.21568627450980393,0.9807692307692307,0.21854844951562974,0.9794383493000562
6,55,2,63,0.09836065573770492,0.9682539682539683,0.19018925747815899,0.9812997903939067
12,133,33,178,0.08275862068965517,0.8146067415730337,0.19629763186239543,0.9603095446845599
21,188,9,218,0.10047846889952153,0.9587155963302753,0.15112788932423185,0.9573272246267858
56,91,2,149,0.38095238095238093,0.9865771812080537,0.17246695126479755,0.9568977743231744
7,39,18,64,0.15217391304347827,0.71875,0.1656346531281516,0.916719202894603
26,184,11,221,0.12380952380952381,0.9502262443438914,0.16488854823458124,0.9111284232112075
9,49,7,65,0.15517241379310345,0.8923076923076924,0.15624371098933834,0.8984910605738448
2,12,1,15,0.14285714285714285,0.9333333333333333,0.16260035200640086,0.8935023984423255
46,35,2,83,0.5679012345679012,0.9759036144578314,0.2319064397032932,0.9165448088544396
14,47,4,65,0.22950819672131148,0.9384615384615385,0.2503392579635489,0.9136513720160485
26,104,6,136,0.2,0.9558823529411765,0.22448891782749447,0.9092663965493518
129,446,5,580,0.22434782608695653,0.9913793103448276,0.23479947683370564,0.9482134408843272
6,50,3,59,0.10714285714285714,0.9491525423728814,0.23241852445275327,0.9480600548884686
37,66,3,106,0.3592233009708738,0.9716981132075472,0.2615686511924348,0.9594015435884478
2,0,0,2,1.0,1.0,0.3840176307842715,0.9689253531122574
1,15,1,17,0.0625,0.9411764705882353,0.3118174544174285,0.9639643325594579
17,68,18,103,0.2,0.8252427184466019,0.3076019977429554,0.9477902154144671
36,101,6,143,0.26277372262773724,0.958041958041958,0.3165696724040607,0.9480987304288645
18,41,4,63,0.3050847457627119,0.9365079365079365,0.32810351807202576,0.9402599627378799
6,21,4,31,0.2222222222222222,0.8709677419354839,0.3445434273690779,0.9290907055325375
3,19,0,22,0.13636363636363635,1.0,0.30064819370651874,0.9330916209073565
34,78,3,115,0.30357142857142855,0.9739130434782609,0.20115839778815142,0.9293649128328224
41,59,5,105,0.41,0.9523809523809523,0.2508012549310085,0.930965553088925
26,78,4,108,0.25,0.9629629629629629,0.25626343980495814,0.9506398737341194
73,312,19,404,0.18961038961038962,0.9529702970297029,0.25183803327871124,0.9499575620421855
8,87,4,99,0.08421052631578947,0.9595959595959596,0.2227058808637756,0.9532558510547602
5,26,1,32,0.16129032258064516,0.96875,0.21929232906312704,0.9672247450639768
2,11,1,14,0.15384615384615385,0.9285714285714286,0.22178983156062954,0.9570206634313239
4,10,2,16,0.2857142857142857,0.875,0.2192388111524663,0.9428902286487151
25,232,8,265,0.09727626459143969,0.969811320754717,0.17456399180838628,0.9453802812735386
45,85,31,161,0.34615384615384615,0.8074534161490683,0.18830025554465,0.9231646317286964
1,21,8,30,0.045454545454545456,0.7333333333333333,0.1677065635223865,0.891787922629215
8,113,2,123,0.06611570247933884,0.983739837398374,0.16512158868860788,0.8952370480295601
3,46,1,50,0.061224489795918366,0.98,0.15082646971936117,0.8968441908867029
29,153,18,200,0.15934065934065933,0.91,0.1516113990757191,0.894191129662213
24,124,6,154,0.16216216216216217,0.961038961038961,0.13396109571113005,0.9064824098106362
41,94,13,148,0.3037037037037037,0.9121621621621622,0.1634507298700249,0.8982468157259854
7,103,4,114,0.06363636363636363,0.9649122807017544,0.12309108951038453,0.9207409392335121
45,151,22,218,0.22959183673469388,0.8990825688073395,0.14939641683612,0.9444194014440843
5,97,1,103,0.049019607843137254,0.9902912621359223,0.14695411760237695,0.9453553192637341
10,48,1,59,0.1724137931034483,0.9830508474576272,0.16283830378916692,0.9457911546148238
6,28,5,39,0.17647058823529413,0.8717948717948718,0.16528543648840047,0.9403332791569482
8,142,5,155,0.05333333333333334,0.967741935483871,0.14973846094142493,0.9412908469347926
24,102,4,130,0.19047619047619047,0.9692307692307692,0.13356310190892304,0.9494435050874507
55,81,4,140,0.40441176470588236,0.9714285714285714,0.18224530206171144,0.9503744037627102
32,65,6,103,0.32989690721649484,0.941747572815534,0.19657459784482587,0.9564694043353095
18,46,3,67,0.28125,0.9552238805970149,0.2297503681529491,0.9514597784011798
4,121,5,130,0.032,0.9615384615384616,0.20969125485245652,0.9483865804127276
21,27,1,49,0.4375,0.9795918367346939,0.24698117081884302,0.9637861468327021
21,74,1,96,0.22105263157894736,0.9895833333333334,0.2709410705682164,0.9669063465254826
5,25,0,30,0.16666666666666666,1.0,0.2675397100239988,0.971301950921087
12,81,1,94,0.12903225806451613,0.9893617021276596,0.2281997805038036,0.9738638267352424
11,39,1,51,0.22,0.9803921568627451,0.2125002223300186,0.9793844815991297
7,53,2,62,0.11666666666666667,0.967741935483871,0.18898831756811388,0.9811727751543948
12,133,33,178,0.08275862068965517,0.8146067415730337,0.19623954909520744,0.960182529445048
22,184,10,216,0.10679611650485436,0.9537037037037037,0.14899613716732948,0.9564842247263351
55,90,2,147,0.3793103448275862,0.9863945578231292,0.17160438191713506,0.9560286853677346
6,40,18,64,0.13043478260869565,0.71875,0.16642839848028207,0.915850113939163
25,180,11,216,0.12195121951219512,0.9490740740740741,0.1654168215442362,0.9100947385029364
9,49,7,65,0.15517241379310345,0.8923076923076924,0.15615573780039385,0.8975112435665006
2,12,1,15,0.14285714285714285,0.9333333333333333,0.15989723439903328,0.8925957289735665
46,36,2,84,0.5609756097560976,0.9761904761904762,0.2282139471228108,0.9156791196332011
13,47,4,64,0.21666666666666667,0.9375,0.24390974000306967,0.9133643048183863
25,104,6,135,0.1937984496124031,0.9555555555555556,0.21740804068661496,0.9089587330658757
132,443,5,580,0.22956521739130434,0.9913793103448276,0.23156953136984476,0.9479057774008511
4,49,4,57,0.07547169811320754,0.9298245614035088,0.22492959974141796,0.9451558470193419
38,64,3,105,0.37254901960784315,0.9714285714285714,0.25598340057209507,0.956458829750896
2,0,0,2,1.0,1.0,0.3784323801639318,0.9659826392747055
1,15,1,17,0.0625,0.9411764705882353,0.30722157877020356,0.9609806384743855
19,66,18,103,0.2235294117647059,0.8252427184466019,0.3082019709270663,0.9449438839667571
34,104,5,143,0.2463768115942029,0.965034965034965,0.31571316549589484,0.9462980853209585
18,41,4,63,0.3050847457627119,0.9365079365079365,0.3265016695489531,0.9384593176299739
7,20,4,31,0.25925925925925924,0.8709677419354839,0.35275703542696046,0.9300512005631133
3,19,0,22,0.13636363636363635,1.0,0.300040972268497,0.931071407355236
35,77,3,115,0.3125,0.9739130434782609,0.2018266865542113,0.9273446992807017
40,59,6,105,0.40404040404040403,0.9428571428571428,0.2506181728456976,0.9275847953191171
26,77,5,108,0.2524271844660194,0.9537037037037037,0.2535781539018188,0.9466853244196463
72,312,20,404,0.1875,0.9504950495049505,0.252002523649718,0.9456494059384621
7,88,4,99,0.07368421052631578,0.9595959595959596,0.22378791934233938,0.9489476949510368
5,26,1,32,0.16129032258064516,0.96875,0.21825796542528872,0.9641878427342881
2,11,1,14,0.15384615384615385,0.9285714285714286,0.2207554679227912,0.9539837611016351
3,10,2,15,0.23076923076923078,0.8666666666666667,0.20907964374696703,0.93866285012855
25,231,9,265,0.09765625,0.9660377358490566,0.16531047888405218,0.9419743634131094
44,92,23,159,0.3235294117647059,0.8553459119496856,0.17546793992672166,0.9279232503053924
1,19,10,30,0.05,0.6666666666666666,0.1558250827838645,0.8873763384713518
8,113,2,123,0.06611570247933884,0.983739837398374,0.1547438673485821,0.8908254638716968
3,45,2,50,0.0625,0.96,0.14063096412277565,0.8895754638716967
31,152,15,198,0.16939890710382513,0.9242424242424242,0.14285278601672868,0.888957034681839
24,122,9,155,0.1643835616438356,0.9419354838709677,0.1333691189988151,0.8997097228538821
39,95,13,147,0.291044776119403,0.9115646258503401,0.16099605130158695,0.8919278499969224
4,107,2,113,0.036036036036036036,0.9823008849557522,0.11992556905463411,0.9100642747120748
45,151,22,218,0.22959183673469388,0.8990825688073395,0.14558154573101895,0.9432665464464566
5,97,1,103,0.049019607843137254,0.9902912621359223,0.14313924649727586,0.9442024642661064
7,51,1,59,0.1206896551724138,0.9830508474576272,0.15145205437904924,0.9474954424743389
6,28,5,39,0.17647058823529413,0.8717948717948718,0.1524622945406877,0.9400029349818314
6,144,5,155,0.04,0.967741935483871,0.13469321430585404,0.9436895709265318
24,102,4,130,0.19047619047619047,0.9692307692307692,0.12032627349968081,0.9519275914094504
53,82,5,140,0.3925925925925926,0.9642857142857143,0.17126292443633176,0.9493539955994449
30,67,6,103,0.30927835051546393,0.941747572815534,0.18264671211929892,0.9554489961720442
17,47,3,67,0.265625,0.9552238805970149,0.21359033957027926,0.9504393702379145
13,111,5,129,0.10483870967741936,0.9612403100775194,0.2113259187852801,0.9473235791836133
22,26,1,49,0.4583333333333333,0.9795918367346939,0.2515920252278571,0.9627231456035881
20,74,1,95,0.2127659574468085,0.9894736842105263,0.2762728762916869,0.9658276811359673
5,25,0,30,0.16666666666666666,1.0,0.2728715157474692,0.9702232855315717
11,81,1,93,0.11956521739130435,0.989247311827957,0.23386760500442802,0.9737892280376064
10,41,1,52,0.19607843137254902,0.9807692307692307,0.2176961879840116,0.9793637506024202
6,54,2,62,0.1,0.967741935483871,0.19403547369829735,0.9811520441576853
12,131,33,176,0.08391608391608392,0.8125,0.19104652716096374,0.9599034284323255
20,184,10,214,0.09803921568627451,0.9532710280373832,0.13957593892566958,0.9561433129041381
56,89,2,147,0.38620689655172413,0.9863945578231292,0.16435321594065752,0.9557034377059387
7,38,17,62,0.15555555555555556,0.7258064516129032,0.16276591435335594,0.9165329307934963
25,178,13,216,0.12315270935960591,0.9398148148148148,0.16327841320597042,0.9094711455059045
9,49,7,65,0.15517241379310345,0.8923076923076924,0.15743469640890678,0.8968337828685419
2,12,1,15,0.14285714285714285,0.9333333333333333,0.16355714538849866,0.8919182682756078
45,37,2,84,0.5487804878048781,0.9761904761904762,0.22996634594404067,0.9153026220171044
13,47,4,64,0.21666666666666667,0.9375,0.24691312465552523,0.9130496180117641
25,103,7,135,0.1953125,0.9481481481481482,0.2196424965767075,0.9075858452010525
131,441,5,577,0.229020979020979,0.9913344887348353,0.23013755707176803,0.945518421932757
5,48,4,57,0.09433962264150944,0.9298245614035088,0.22602140182632566,0.944091242873999
37,63,3,103,0.37,0.970873786407767,0.2567110569987395,0.9553149706025811
2,0,0,2,1.0,1.0,0.3791600365905762,0.9648387801263907
1,15,1,17,0.0625,0.9411764705882353,0.3096913954755936,0.9598367793260706
18,67,18,103,0.21176470588235294,0.8252427184466019,0.3089911153635488,0.9438000248184422
30,106,6,142,0.22058823529411764,0.9577464788732394,0.31260193469127984,0.9451712149220267
17,42,4,63,0.288135593220339,0.9365079365079365,0.32104687957690276,0.9373388503181841
5,22,4,31,0.18518518518518517,0.8709677419354839,0.3340248170831422,0.9289307332513232
3,19,0,22,0.13636363636363635,1.0,0.28596339014563255,0.9313260042434963
35,76,3,114,0.3153153153153153,0.9736842105263158,0.1881512923335348,0.9275666057472557
38,56,6,100,0.40425531914893614,0.94,0.2369734807833828,0.9273985385203648
25,76,5,106,0.24752475247524752,0.9528301886792453,0.2430742629786419,0.9461196828719968
75,305,18,398,0.19736842105263158,0.9547738693467337,0.24500924749876574,0.9456950243682102
4,88,5,97,0.043478260869565216,0.9484536082474226,0.2149008150321903,0.9474015489024225
5,26,1,32,0.16129032258064516,0.96875,0.21508514682942534,0.9626416966856738
2,11,1,14,0.15384615384615385,0.9285714285714286,0.21758264932692786,0.9524376150530207
3,10,2,15,0.23076923076923078,0.8666666666666667,0.20550463724891577,0.9371493945016421
25,228,9,262,0.09881422924901186,0.9656488549618321,0.16187019583464088,0.9408135166390469
45,89,25,159,0.3358208955223881,0.8427672955974843,0.17448393055566094,0.9250902461987953
1,20,9,30,0.047619047619047616,0.7,0.15309116292229177,0.888693979149262
9,112,2,123,0.0743801652892562,0.983739837398374,0.15750572069653337,0.8937348690279693
2,45,3,50,0.0425531914893617,0.94,0.1405432733977786,0.8896277261708264
28,151,17,196,0.1564245810055866,0.9132653061224489,0.14091162013484043,0.8874411372495435
25,116,10,151,0.1773049645390071,0.9337748344370861,0.13327386781623704,0.8970280183596036
37,97,12,146,0.27611940298507465,0.9178082191780822,0.15860317834996027,0.8901936418190678
4,104,2,110,0.037037037037037035,0.9818181818181818,0.11591976999491016,0.9100580541363102
44,148,26,218,0.22916666666666666,0.8807339449541285,0.14185514414457,0.9358771891297571
5,97,1,103,0.049019607843137254,0.9902912621359223,0.138232207366553,0.9368131069494071
7,48,2,57,0.12727272727272726,0.9649122807017544,0.15033499819274806,0.9403720041925148
6,28,5,39,0.17647058823529413,0.8717948717948718,0.15319871351127776,0.9344476564314323
7,141,6,154,0.0472972972972973,0.961038961038961,0.1346261896196049,0.9383425316602716
26,100,4,130,0.20634920634920634,0.9692307692307692,0.12465901867162373,0.9456886102392269
52,78,6,136,0.4,0.9558823529411765,0.1765108705234756,0.9419834918282263
29,67,6,102,0.3020833333333333,0.9411764705882353,0.18692753719014224,0.9506181383473843
17,47,3,67,0.265625,0.9552238805970149,0.21787116464112263,0.9456085124132546
5,118,5,128,0.04065040650406504,0.9609375,0.2054965473884566,0.9450406865987182
21,27,1,49,0.4375,0.9795918367346939,0.24278646335484316,0.9604402530186927
21,73,1,95,0.22340425531914893,0.9894736842105263,0.2679446002151077,0.9645023563289163
5,25,0,30,0.16666666666666666,1.0,0.26227566597474483,0.9688979607245207
13,79,1,93,0.14130434782608695,0.989247311827957,0.22531914423561444,0.9736643834226323
10,41,1,52,0.19607843137254902,0.9807692307692307,0.21017558681264523,0.9793204920199174
7,52,3,62,0.11864406779661017,0.9516129032258065,0.18917831078358957,0.9788046381097448
12,127,37,176,0.08633093525179857,0.7897727272727273,0.19570410060469431,0.9543525277201345
19,178,7,204,0.09644670050761421,0.9656862745098039,0.14698220067721066,0.9523660188308644
53,89,4,146,0.3732394366197183,0.9726027397260274,0.16838722657729202,0.9499558839045074
6,39,17,62,0.13333333333333333,0.7258064516129032,0.16362532181538722,0.910785376992065
27,172,11,210,0.135678391959799,0.9476190476190476,0.16282161383448895,0.904838482105078
8,48,9,65,0.14285714285714285,0.8615384615384616,0.15521857261800237,0.887805515072111
2,11,2,15,0.15384615384615385,0.8666666666666667,0.16024744205365146,0.8756703384208053
43,38,2,83,0.5308641975308642,0.9759036144578314,0.2237521938078037,0.9022604651615344
13,47,4,64,0.21666666666666667,0.9375,0.2409264746876683,0.8982338545172767
25,103,5,133,0.1953125,0.9624060150375939,0.21550834088485146,0.8967771795617862
127,444,5,576,0.2224168126094571,0.9913194444444444,0.228234552210012,0.9347076071091492
5,48,4,57,0.09433962264150944,0.9298245614035088,0.2223290137359706,0.9321655376497865
39,62,3,104,0.38613861386138615,0.9711538461538461,0.2570835095937197,0.9478248783091272
2,0,0,2,1.0,1.0,0.37796263047284057,0.9668724973567462
1,15,1,17,0.0625,0.9411764705882353,0.31105345939700285,0.9619114768039468
19,63,18,100,0.23170731707317074,0.82,0.3132021237407891,0.9451257625182325
27,109,6,142,0.19852941176470587,0.9577464788732394,0.31366168256431853,0.9444601144947533
16,43,4,63,0.2711864406779661,0.9365079365079365,0.3206287722883912,0.9366298990752522
5,20,4,29,0.2,0.8620689655172413,0.33572311191103266,0.9269505282343568
4,19,0,23,0.17391304347826086,1.0,0.28867360313416895,0.9258874322172794
36,75,3,114,0.32432432432432434,0.9736842105263158,0.19214850660907243,0.9221280337210389
39,56,6,101,0.4105263157894737,0.9405940594059405,0.24186655172185437,0.9220448321235682
24,75,12,111,0.24242424242424243,0.8918918918918919,0.24688186161521306,0.9334749326625796
74,305,19,398,0.19525065963060687,0.9522613065326633,0.24338953160573265,0.9367154814831412
6,87,5,98,0.06451612903225806,0.9489795918367347,0.21870781638273804,0.9384971465301124
5,26,1,32,0.16129032258064516,0.96875,0.2246064338942588,0.9537372943133636
2,11,1,14,0.15384615384615385,0.9285714285714286,0.22173973537538633,0.9435332126807106
3,10,2,15,0.23076923076923078,0.8666666666666667,0.20837472201037296,0.9282449921293321
25,229,9,263,0.0984251968503937,0.9657794676806084,0.1637888478762187,0.9318429075971418
43,92,24,159,0.31851851851851853,0.8490566037735849,0.17465945874682956,0.9257235807230979
1,20,9,30,0.047619047619047616,0.7,0.15356922845946394,0.8896862512184318
7,114,2,123,0.05785123966942149,0.983739837398374,0.15261710140763016,0.8946520005843802
4,44,2,50,0.08333333333333333,0.96,0.14148038865801418,0.8934020005843802
28,151,17,196,0.1564245810055866,0.9132653061224489,0.141848735395076,0.8912154116630975
23,118,11,152,0.16312056737588654,0.9276315789473685,0.13218464062459825,0.8999246848460548
37,97,13,147,0.27611940298507465,0.9115646258503401,0.15756952721526693,0.8921797074417308
4,106,2,112,0.03636363636363636,0.9821428571428571,0.11726168690742667,0.9111920293516268
44,148,26,218,0.22916666666666666,0.8807339449541285,0.14319706105708652,0.9370111643450737
5,97,1,103,0.049019607843137254,0.9902912621359223,0.14193539936761734,0.9379470821647234
8,46,2,56,0.14814814814814814,0.9642857142857143,0.15119465862687662,0.9385593270626826
6,26,6,38,0.1875,0.8421052631578947,0.1556340041975071,0.9283936066391749
6,141,6,153,0.04081632653061224,0.9607843137254902,0.1381619697910393,0.933129711607478
25,101,4,130,0.1984126984126984,0.9692307692307692,0.12706101199498557,0.9413677320903966
52,80,7,139,0.3939393939393939,0.9496402877697842,0.17814326307723663,0.9367245078942432
29,67,7,103,0.3020833333333333,0.9320388349514563,0.18855992974390334,0.9440537778938615
18,46,2,66,0.28125,0.9696969696969697,0.22173570005202659,0.9411117361168683
5,117,5,127,0.040983606557377046,0.9606299212598425,0.20642647982477355,0.9405894799703152
20,28,1,49,0.4166666666666667,0.9795918367346939,0.2391645750628688,0.9602304190527151
19,76,1,96,0.2,0.9895833333333334,0.2619050998442099,0.9643445647109783
5,25,0,30,0.16666666666666666,1.0,0.2573699524519197,0.9687401691065827
12,80,1,93,0.13043478260869565,0.989247311827957,0.21972643654753418,0.9743983154006074
10,41,1,52,0.19607843137254902,0.9807692307692307,0.204582879124565,0.9813598005174323
5,54,3,62,0.0847457627118644,0.9516129032258065,0.1765108452262599,0.9787763624501232
12,128,36,176,0.08571428571428572,0.7954545454545454,0.18290094224867545,0.9551798801922237
19,182,7,208,0.0945273631840796,0.9663461538461539,0.136881041751163,0.9532876397795752
50,95,4,149,0.3448275862068966,0.9731543624161074,0.1575706969235768,0.9509406439342571
5,40,17,62,0.1111111111111111,0.7258064516129032,0.14963418898706887,0.9117701370218148
27,174,12,213,0.13432835820895522,0.9436619718309859,0.15019041407282024,0.905257945593676
9,49,7,65,0.15517241379310345,0.8923076923076924,0.14434669727575658,0.8926205829563134
2,12,1,15,0.14285714285714285,0.9333333333333333,0.15264832301079637,0.8900092158288173
45,36,2,83,0.5555555555555556,0.9759036144578314,0.21976850441669207,0.9157876542578581
13,47,4,64,0.21666666666666667,0.9375,0.23721697634277591,0.9116667751369789
24,103,5,132,0.1889763779527559,0.9621212121212122,0.21495251802075582,0.9100906108091368
125,447,5,577,0.21853146853146854,0.9913344887348353,0.2302982833665212,0.9480231875408415
6,45,4,55,0.11764705882352941,0.9272727272727272,0.22791524059717463,0.9456818668896616
38,63,3,104,0.37623762376237624,0.9711538461538461,0.25949598487849934,0.9569456031533977
2,0,0,2,1.0,1.0,0.38194496447033605,0.9664694126772072
1,15,1,17,0.0625,0.9411764705882353,0.31150845653382814,0.9615083921244079
17,66,18,101,0.20481927710843373,0.8217821782178217,0.30981597231122343,0.9449772747269538
25,111,6,142,0.18382352941176472,0.9577464788732394,0.3090798510910818,0.9443523128343864
15,44,4,63,0.2542372881355932,0.9365079365079365,0.3141806824630996,0.9365199482305437
4,21,4,29,0.16,0.8620689655172413,0.32023110263116683,0.9272051251226171
4,19,0,23,0.17391304347826086,1.0,0.29120374387569176,0.9244730050602782
35,76,3,114,0.3153153153153153,0.9736842105263158,0.19339164606359396,0.9207136065640376
38,60,6,104,0.3877551020408163,0.9423076923076923,0.23985666064085345,0.920875209666817
24,77,12,113,0.2376237623762376,0.8938053097345132,0.2438205490931907,0.9339930827689187
72,305,22,399,0.1909814323607427,0.9448621553884712,0.23755382730922756,0.9361766099974529
7,89,5,101,0.07291666666666667,0.9504950495049505,0.21407218889114848,0.9381747689970262
5,26,1,32,0.16129032258064516,0.96875,0.21997080640266922,0.9534149167802776
2,11,1,14,0.15384615384615385,0.9285714285714286,0.21710410788379678,0.9432108351476245
3,10,2,15,0.23076923076923078,0.8666666666666667,0.20502609580578474,0.9279226145962459
25,232,8,265,0.09727626459143969,0.969811320754717,0.16352911902730233,0.9318517043743924
41,93,26,160,0.30597014925373134,0.8375,0.17329288858123,0.9238080886980333
1,16,13,30,0.058823529411764705,0.5666666666666667,0.15441318815994745,0.8697801617377755
9,112,2,123,0.0743801652892562,0.983739837398374,0.15462225939174595,0.8745294171511218
4,44,2,50,0.08333333333333333,0.96,0.14348554664212995,0.8732794171511217
29,151,17,197,0.16111111111111112,0.9137055837563451,0.14452339767998104,0.8711557250346812
20,120,12,152,0.14285714285714285,0.9210526315789473,0.13196452797825417,0.8789251485935784
37,96,14,147,0.2781954887218045,0.9047619047619048,0.15781013142544914,0.8696323748803196
6,104,3,113,0.05454545454545454,0.9734513274336283,0.12189231789569531,0.8890539930851237
43,148,27,218,0.225130890052356,0.8761467889908257,0.14565051227292264,0.9332654391314321
5,97,1,103,0.049019607843137254,0.9902912621359223,0.14202757549490566,0.9342013569510819
7,47,4,58,0.12962962962962962,0.9310344827586207,0.14864133210866223,0.9300634259165992
6,26,6,38,0.1875,0.8421052631578947,0.15241117337850354,0.919834808688249
7,140,6,153,0.047619047619047616,0.9607843137254902,0.13880573120163278,0.9255107632806122
22,102,6,130,0.1774193548387097,0.9538461538461539,0.12440914064690493,0.9325227988640764
53,80,7,140,0.39849624060150374,0.95,0.17354496722634055,0.9291726092307009
30,66,7,103,0.3125,0.9320388349514563,0.18602626864743255,0.9371571872250769
18,46,3,67,0.28125,0.9552238805970149,0.2192020389555558,0.9321475612909472
6,116,5,127,0.04918032786885246,0.9606299212598425,0.20770928156115906,0.9363754810768359
19,29,1,49,0.3958333333333333,0.9795918367346939,0.23747118632306383,0.9560164201592357
19,76,1,96,0.2,0.9895833333333334,0.259239893806057,0.9601305658174992
4,26,0,30,0.13333333333333333,1.0,0.25294189073386036,0.9667239724109058
11,82,1,94,0.11827956989247312,0.9893617021276596,0.21291093777542744,0.9723470727148571
11,40,1,52,0.21568627450980393,0.9807692307692307,0.1990804055625423,0.979308557831682
5,54,2,61,0.0847457627118644,0.9672131147540983,0.17100837166423719,0.9810213055684083
12,130,33,175,0.08450704225352113,0.8114285714285714,0.17605504514776132,0.9597068270210839
17,187,5,209,0.08333333333333333,0.9760765550239234,0.13141218800490415,0.9592046439195452
48,93,7,148,0.3404255319148936,0.9527027027027027,0.15147297827846037,0.9539359824008837
6,39,17,62,0.13333333333333333,0.7258064516129032,0.15147297827846037,0.9147654754884413
27,175,13,215,0.13366336633663367,0.9395348837209302,0.15367066348476904,0.9076473585731942
9,49,7,65,0.15517241379310345,0.8923076923076924,0.14502582623952612,0.8950099959358315
2,12,1,15,0.14285714285714285,0.9333333333333333,0.1533274519745659,0.8901700271614365
45,35,3,83,0.5625,0.963855421686747,0.22161216022406288,0.911945291484033
14,46,4,64,0.23333333333333334,0.9375,0.24304073165263432,0.906434355052044
22,106,6,134,0.171875,0.9552238805970149,0.21896208423622093,0.9067945233226601
121,445,11,577,0.2137809187279152,0.9809358752166378,0.2304545964354469,0.9432415838374792
7,46,3,56,0.1320754716981132,0.9464285714285714,0.23022775434422968,0.9442263963671422
38,62,3,103,0.38,0.970873786407767,0.26234598094521494,0.9554501240957245
2,0,0,2,1.0,1.0,0.38479496053705164,0.964973933619534
1,15,1,17,0.0625,0.9411764705882353,0.31336638910848025,0.9617340834626036
17,65,19,101,0.2073170731707317,0.8118811881188119,0.30964978051382286,0.9437885389081482
29,103,10,142,0.2196969696969697,0.9295774647887324,0.3164814904705328,0.9401247652212508
14,45,4,63,0.23728813559322035,0.9365079365079365,0.3198396643084336,0.9337779168342933
3,22,4,29,0.12,0.8620689655172413,0.3181145969229888,0.9217265445612463
4,19,0,23,0.17391304347826086,1.0,0.2860816977185396,0.9249854687121106
35,77,2,114,0.3125,0.9824561403508771,0.18786741200425383,0.9224792030479502
39,59,6,104,0.3979591836734694,0.9423076923076923,0.2357901525290352,0.9226408061507297
24,77,12,113,0.2376237623762376,0.8938053097345132,0.2418618398371388,0.9343442520958299
73,306,20,399,0.19261213720316622,0.949874686716792,0.23471399389137265,0.9332197103591946
7,89,5,101,0.07291666666666667,0.9504950495049505,0.2160749704854001,0.9352178693587679
5,26,1,32,0.16129032258064516,0.96875,0.2212593022826351,0.9553841255164034
2,11,1,14,0.15384615384615385,0.9285714285714286,0.21839260376376268,0.9451800438837504
3,10,2,15,0.23076923076923078,0.8666666666666667,0.2067167795879385,0.9286386905002918
24,233,8,265,0.0933852140077821,0.969811320754717,0.16320621249284034,0.9325677802784381
40,94,28,162,0.29850746268656714,0.8271604938271605,0.17190388396574455,0.9230470922916735
1,14,15,30,0.06666666666666667,0.5,0.15391167388910176,0.8587792799035603
7,114,2,123,0.05785123966942149,0.983739837398374,0.15175947003235243,0.8635285353169067
4,44,2,50,0.08333333333333333,0.96,0.14062275728273646,0.8622785353169066
28,149,20,197,0.15819209039548024,0.8984771573604061,0.14124360536121167,0.8579793537153318
19,121,12,152,0.1357142857142857,0.9210526315789473,0.1276643274962195,0.8657487772742292
38,94,15,147,0.2878787878787879,0.8979591836734694,0.15544912376350606,0.8554841862626225
5,105,3,113,0.045454545454545456,0.9734513274336283,0.11929870701607437,0.8763828767778321
44,147,27,218,0.23036649214659685,0.8761467889908257,0.1426843963703501,0.9301181323479499
5,97,1,103,0.049019607843137254,0.9902912621359223,0.14142273468088096,0.9310540501675998
9,48,2,59,0.15789473684210525,0.9661016949152542,0.15207436375356265,0.931925720869779
5,27,6,38,0.15625,0.8421052631578947,0.15179692226849406,0.9238725931265631
6,141,6,153,0.04081632653061224,0.9607843137254902,0.1382400709565407,0.9295485477189264
22,103,5,130,0.176,0.9615384615384616,0.1222573869738567,0.9386313016996394
52,81,7,140,0.39097744360902253,0.95,0.17161780099592486,0.935281112066264
31,65,7,103,0.3229166666666667,0.9320388349514563,0.184839254498792,0.9432656900606399
17,47,3,67,0.265625,0.9552238805970149,0.21578288194977238,0.9382560641265102
5,117,5,127,0.040983606557377046,0.9606299212598425,0.1990812919090969,0.9374743821757371
18,30,1,49,0.375,0.9795918367346939,0.2303312919090969,0.957115321258137
19,76,1,96,0.2,0.9895833333333334,0.25307181669043805,0.9612294669164003
4,26,0,30,0.13333333333333333,1.0,0.2469765785951999,0.9667239724109058
11,82,1,94,0.11827956989247312,0.9893617021276596,0.20801973949283575,0.9723470727148571
11,40,1,52,0.21568627450980393,0.9807692307692307,0.19270111204185533,0.979308557831682
5,53,3,61,0.08620689655172414,0.9508196721311475,0.16706995440638736,0.9786793851937011
12,128,36,176,0.08571428571428572,0.7954545454545454,0.17346005142880289,0.9550829029358014
19,183,8,210,0.09405940594059406,0.9619047619047619,0.13332568084888774,0.9525561779600968
47,97,6,150,0.3263888888888889,0.96,0.1513812364044433,0.9483299874839064
5,38,19,62,0.11627906976744186,0.6935483870967742,0.1489449130378874,0.9045511856405882
27,175,13,215,0.13366336633663367,0.9395348837209302,0.151142598244196,0.8974330687253413
8,48,9,65,0.14285714285714285,0.8615384615384616,0.14073843657953014,0.8804001016923744
1,13,1,15,0.07142857142857142,0.9333333333333333,0.13862724727622264,0.8779020532926866
45,35,3,83,0.5625,0.963855421686747,0.20673949217418183,0.9019593213258582
13,47,4,64,0.21666666666666667,0.9375,0.22425481513504933,0.898472926768035
25,104,6,135,0.1937984496124031,0.9555555555555556,0.20531332380983708,0.8978380061331145
119,447,11,577,0.21024734982332155,0.9809358752166378,0.21873736381781989,0.9388933615788092
7,47,3,57,0.12962962962962962,0.9473684210526315,0.2181611157168193,0.9400124383404809
38,62,3,103,0.38,0.970873786407767,0.25203866673722747,0.9556317704646674
2,0,0,2,1.0,1.0,0.38469172796171724,0.9651555799884769
1,15,1,17,0.0625,0.9411764705882353,0.3132631565331458,0.9619157298315466
17,64,20,101,0.20987654320987653,0.801980198019802,0.3122931388964615,0.9425557581200897
31,101,10,142,0.23484848484848486,0.9295774647887324,0.3181574296444732,0.9388446022962579
14,45,4,63,0.23728813559322035,0.9365079365079365,0.32202039904017304,0.9324977539093006
3,22,4,29,0.12,0.8620689655172413,0.3206447376645117,0.9203121174042448
4,19,0,23,0.17391304347826086,1.0,0.2882583129627158,0.924577077772413
35,77,2,114,0.3125,0.9824561403508771,0.19004402724843011,0.9220708121082526
39,59,6,104,0.3979591836734694,0.9423076923076923,0.2379667677732115,0.9222324152110322
25,70,19,114,0.2631578947368421,0.8333333333333334,0.24734205785025593,0.9267114345415367
82,296,21,399,0.21693121693121692,0.9473684210526315,0.24183588133260914,0.9242228186355746
7,89,5,101,0.07291666666666667,0.9504950495049505,0.22319685792663657,0.926220977635148
5,26,1,32,0.16129032258064516,0.96875,0.2283811897238716,0.9463872337927836
2,11,1,14,0.15384615384615385,0.9285714285714286,0.22551449120499914,0.9361831521601304
3,10,2,15,0.23076923076923078,0.8666666666666667,0.21383866702917498,0.9196417987766718
26,224,15,265,0.104,0.9433962264150944,0.17184449793296505,0.9197973036491579
36,103,22,161,0.2589928057553957,0.8633540372670807,0.17124948522132985,0.9240859756396931
1,15,14,30,0.0625,0.5333333333333333,0.14918788280258458,0.8649381059655077
8,113,2,123,0.06611570247933884,0.983739837398374,0.1482163164901092,0.8696873613788539
4,44,2,50,0.08333333333333333,0.96,0.1370796037404932,0.868437361378854
27,147,23,197,0.15517241379310345,0.883248730964467,0.1372690694472003,0.8619626902921451
20,121,11,152,0.14184397163120568,0.9276315789473685,0.124565460998911,0.8706719634751023
36,96,15,147,0.2727272727272727,0.8979591836734694,0.1486693571028071,0.864180957369156
4,106,3,113,0.03636363636363636,0.9734513274336283,0.1168651900468415,0.8799091416786629
44,147,27,218,0.23036649214659685,0.8761467889908257,0.14084611749635534,0.928882492486876
6,96,1,103,0.058823529411764705,0.9902912621359223,0.13980437848670188,0.9298184103065258
9,48,2,59,0.15789473684210525,0.9661016949152542,0.15045600755938357,0.930690081008705
5,27,6,38,0.15625,0.8421052631578947,0.15060994844608308,0.9248124427506231
6,137,10,153,0.04195804195804196,0.934640522875817,0.1363405299213454,0.9258137204546873
26,100,4,130,0.20634920634920634,0.9692307692307692,0.12685794901019307,0.9359953755343016
53,80,7,140,0.39849624060150374,0.95,0.17859117818703127,0.9326451859009259
31,65,7,103,0.3229166666666667,0.9320388349514563,0.1918126316898984,0.940629763895302
18,46,3,67,0.28125,0.9552238805970149,0.223587841773932,0.9356201379611723
5,117,5,127,0.040983606557377046,0.9606299212598425,0.20688625173325656,0.9348384560103992
18,30,1,49,0.375,0.9795918367346939,0.23813625173325656,0.9544793950927991
20,75,1,96,0.21052631578947367,0.9895833333333334,0.26221743370917533,0.9623283680153014
4,26,0,30,0.13333333333333333,1.0,0.2517865947069078,0.9667239724109058
12,82,1,95,0.1276595744680851,0.9894736842105263,0.2130956424021337,0.9723630701552667
10,40,1,51,0.2,0.9803921568627451,0.19553611859260986,0.9792706875711651
8,50,3,61,0.13793103448275862,0.9508196721311475,0.17506198066157538,0.978641514933184
12,128,36,176,0.08571428571428572,0.7954545454545454,0.18145207768399094,0.9550450326752845
20,180,11,211,0.1,0.9478672985781991,0.14216636339827662,0.9505129557957852
51,94,6,151,0.35172413793103446,0.9602649006622517,0.16233748084707103,0.946324608271345
4,39,19,62,0.09302325581395349,0.6935483870967742,0.15657889834430247,0.9025458064280271
27,174,13,214,0.13432835820895522,0.9392523364485982,0.15753158173585538,0.895371328176323
9,49,7,65,0.15517241379310345,0.8923076923076924,0.15112764084915584,0.8827878332398867
2,11,2,15,0.15384615384615385,0.8666666666666667,0.1534012293296409,0.8707659753163897
45,31,7,83,0.5921052631578947,0.9156626506024096,0.22574279753587076,0.8879385617660844
14,46,4,64,0.23333333333333334,0.9375,0.24479041658348977,0.886457519112056
26,103,6,135,0.20155038759689922,0.9555555555555556,0.22333702367861336,0.8857847555253853
121,452,5,578,0.2111692844677138,0.9913494809688581,0.24021502777200765,0.9283277689356828
7,47,3,57,0.12962962962962962,0.9473684210526315,0.23954378083210398,0.9294872095934019
38,62,3,103,0.38,0.970873786407767,0.2716620074330892,0.940710937321984
2,0,0,2,1.0,1.0,0.3925411283122101,0.959758556369603
1,15,1,17,0.0625,0.9411764705882353,0.316883233575368,0.9634033877961495
16,66,19,101,0.1951219512195122,0.8118811881188119,0.311424464701965,0.9454578432416941
33,103,6,142,0.2426470588235294,0.9577464788732394,0.31729541773434067,0.9457708322870776
12,47,4,63,0.2033898305084746,0.9365079365079365,0.3161840671687351,0.9379363259355173
3,21,5,29,0.125,0.8275862068965517,0.3155226915073594,0.9208245810560773
7,16,0,23,0.30434782608695654,1.0,0.299089426567319,0.9212341421365962
35,77,2,114,0.3125,0.9824561403508771,0.2008751408530333,0.9187278764724357
41,57,6,104,0.41836734693877553,0.9423076923076923,0.25171333327285833,0.9188894795752153
25,69,20,114,0.26595744680851063,0.8245614035087719,0.26470725424550273,0.9235297932306411
83,291,25,399,0.22192513368983957,0.9373433583959899,0.2604320087937867,0.9206578717856913
8,87,6,101,0.08421052631578947,0.9405940594059405,0.24824900892122392,0.9212416036282632
5,25,2,32,0.16666666666666666,0.9375,0.2534249923580769,0.9378232362813245
2,11,1,14,0.15384615384615385,0.9285714285714286,0.23192475346653368,0.9276191546486715
3,10,2,15,0.23076923076923078,0.8666666666666667,0.2202489292907095,0.9110778012652128
27,221,17,265,0.10887096774193548,0.9358490566037736,0.17603516083401807,0.9101551390217958
35,96,29,160,0.26717557251908397,0.81875,0.1762091787926714,0.9093249385205427
2,13,15,30,0.13333333333333333,0.5,0.1635532073131705,0.8468473158925441
8,113,2,123,0.06611570247933884,0.983739837398374,0.16096823247939182,0.8530109984628916
4,44,2,50,0.08333333333333333,0.96,0.14906347057462993,0.8562252841771774
26,146,25,197,0.1511627906976744,0.8730964467005076,0.14868013298199,0.8483002867670459
18,119,11,148,0.13138686131386862,0.9256756756756757,0.134482651631224,0.8567301451969043
37,94,16,147,0.2824427480916031,0.891156462585034,0.15927862025260509,0.8503454889085129
4,105,4,113,0.03669724770642202,0.9646017699115044,0.12635314527936764,0.8711814560387278
43,144,30,217,0.22994652406417113,0.8617511520737328,0.14015502966948734,0.9228601920492611
6,96,1,103,0.058823529411764705,0.9902912621359223,0.13911329065983388,0.9237961098689108
8,49,2,59,0.14035087719298245,0.9661016949152542,0.1472586540683552,0.92466778057109
6,27,5,38,0.18181818181818182,0.868421052631579,0.15163799565699912,0.9239998671326717
6,138,9,153,0.041666666666666664,0.9411764705882353,0.13882082499311313,0.9262142664058944
27,99,4,130,0.21428571428571427,0.9692307692307692,0.12908410587798613,0.9373677387838566
52,82,6,140,0.3880597014925373,0.9571428571428572,0.17927874213314546,0.936302179816907
31,65,7,103,0.3229166666666667,0.9320388349514563,0.1925601910763591,0.9463432773708674
15,49,3,67,0.234375,0.9552238805970149,0.21763897258896417,0.9413336514367379
5,116,6,127,0.04132231404958678,0.952755905511811,0.2034920349970505,0.9394271100933889
16,32,1,49,0.3333333333333333,0.9795918367346939,0.22513705664207215,0.9553086506795482
16,77,3,96,0.17204301075268819,0.96875,0.24376224865436094,0.9592477263098003
5,25,0,30,0.16666666666666666,1.0,0.23695952756592556,0.9636433307054046
11,83,1,95,0.11702127659574468,0.9894736842105263,0.19823975258066948,0.9682620202865001
10,40,1,51,0.2,0.9803921568627451,0.18068022877114567,0.9751696377023986
7,52,2,61,0.11864406779661017,0.9672131147540983,0.16414723845637572,0.9768823854391249
10,128,38,176,0.07246376811594203,0.7840909090909091,0.16859601760871215,0.9527873859504246
21,177,14,212,0.10606060606060606,0.9339622641509434,0.13612848514117967,0.9462688755813173
49,92,7,148,0.3475177304964539,0.9527027027027027,0.16119630224743192,0.9439764045388462
6,36,20,62,0.14285714285714285,0.6774193548387096,0.15779494170321426,0.8978934552300906
24,173,17,214,0.1218274111675127,0.9205607476635514,0.15848153235632395,0.8880487500090942
12,46,7,65,0.20689655172413793,0.8923076923076924,0.15946675403120084,0.875465255072658
2,12,1,15,0.14285714285714285,0.9333333333333333,0.16292576475413403,0.870625286298263
45,31,6,82,0.5921052631578947,0.926829268292683,0.23716026404584153,0.8910164804699451
14,46,4,64,0.23333333333333334,0.9375,0.25534208222765975,0.8915218713055245
22,107,6,135,0.17054263565891473,0.9555555555555556,0.230059925822297,0.891929421713075
127,446,5,578,0.22164048865619546,0.9913494809688581,0.24131468950787593,0.9367765825888104
6,47,3,56,0.11320754716981132,0.9464285714285714,0.24008328036534718,0.9404719859838133
38,61,3,102,0.3838383838383838,0.9705882352941176,0.2653606849530966,0.9516549206961598
2,0,0,2,1.0,1.0,0.3878096645449333,0.9611787302199692
1,15,1,17,0.0625,0.9411764705882353,0.31215176980809123,0.9632283305479054
16,65,20,101,0.19753086419753085,0.801980198019802,0.30703713136011945,0.9438683588364485
35,102,5,142,0.25547445255474455,0.9647887323943662,0.31917024805952376,0.9451873840991356
12,47,4,63,0.2033898305084746,0.9365079365079365,0.31656301118127794,0.9373528777475755
3,21,5,29,0.125,0.8275862068965517,0.3182476472998763,0.920375397100144
5,18,0,23,0.21739130434782608,1.0,0.2897705035655315,0.9213024909891395
35,76,2,113,0.3153153153153153,0.9823008849557522,0.19195840575343373,0.9187740459828184
38,59,5,102,0.3917525773195876,0.9509803921568627,0.2389944882276605,0.920174606206908
24,67,22,113,0.26373626373626374,0.8053097345132744,0.24809966876141248,0.9220646814344055
82,286,30,398,0.22282608695652173,0.9246231155778895,0.24526810135183993,0.9163624112180757
8,86,7,101,0.0851063829787234,0.9306930693069307,0.23321308100255347,0.9155317159036462
5,25,2,32,0.16666666666666666,0.9375,0.23754208533155777,0.9330581709301012
2,11,1,14,0.15384615384615385,0.9285714285714286,0.22846420668846176,0.9228540892974483
3,10,2,15,0.23076923076923078,0.8666666666666667,0.2163861946104497,0.9063349152561502
27,221,17,265,0.10887096774193548,0.9358490566037736,0.1759745360993565,0.9041732958914233
33,97,29,159,0.25384615384615383,0.8176100628930818,0.17456166325791228,0.9059304856599671
2,15,13,30,0.11764705882352941,0.5666666666666667,0.15953608781034193,0.854793850101221
6,115,2,123,0.049586776859504134,0.983739837398374,0.15446185836473916,0.8623719598285701
4,44,2,50,0.08333333333333333,0.96,0.14255709645997727,0.8655862455428558
25,141,28,194,0.15060240963855423,0.8556701030927835,0.14209370443032018,0.8551717704744778
18,118,12,148,0.1323529411764706,0.918918918918919,0.1280342344884973,0.8626363779390854
33,95,18,146,0.2578125,0.8767123287671232,0.14931159623964937,0.8541882739624211
6,103,4,113,0.05504587155963303,0.9646017699115044,0.12091155591300352,0.8751870892507672
43,144,30,217,0.22994652406417113,0.8617511520737328,0.13695433666166662,0.917342015737491
6,96,1,103,0.058823529411764705,0.9902912621359223,0.138273872740561,0.9182779335571406
8,48,3,59,0.14285714285714285,0.9491525423728814,0.14677727410110522,0.9167282967532665
4,27,7,38,0.12903225806451613,0.8157894736842105,0.14369582387624263,0.9110310639806133
6,136,9,151,0.04225352112676056,0.9403973509933775,0.13082447815485548,0.9140994114198217
27,101,2,130,0.2109375,0.9846153846153847,0.12412804958342691,0.9295141336838589
50,84,6,140,0.373134328358209,0.9571428571428572,0.1695692576975092,0.9284485747169093
30,64,8,102,0.3191489361702128,0.9215686274509803,0.18231245942694368,0.9369939283422305
17,47,2,66,0.265625,0.9696969696969697,0.21185552665383448,0.9340518865652372
15,104,7,126,0.12605042016806722,0.9444444444444444,0.20945456626968081,0.933379301146889
17,30,1,48,0.3617021276595745,0.9791666666666666,0.2426931190689749,0.9567189001443829
16,78,2,96,0.1702127659574468,0.9791666666666666,0.2609730111876443,0.9622573738119955
6,24,0,30,0.2,1.0,0.2594105111876443,0.9644551760097977
11,83,1,95,0.11702127659574468,0.9894736842105263,0.22282293236443512,0.9690738655908933
12,38,1,51,0.24,0.9803921568627451,0.21151594148297614,0.9774772269354312
6,52,3,61,0.10344827586206896,0.9508196721311475,0.18834783803470032,0.9747804701403137
9,121,45,175,0.06923076923076923,0.7428571428571429,0.18023074504365777,0.9459822841992706
17,174,20,211,0.08900523560209424,0.9052132701421801,0.14127404617830341,0.9354175132672012
48,92,7,147,0.34285714285714286,0.9523809523809523,0.16593752859254574,0.9315909826549562
6,36,21,63,0.14285714285714285,0.6666666666666666,0.15777426328642324,0.8839719350359087
23,168,20,211,0.12041884816753927,0.9052132701421801,0.15825963065382248,0.871934733026145
12,45,8,65,0.21052631578947367,0.8769230769230769,0.154049104338033,0.8571534358919066
2,12,1,15,0.14285714285714285,0.9333333333333333,0.1596789424801864,0.8546553874922188
45,31,6,82,0.5921052631578947,0.926829268292683,0.23437529875549007,0.8809371196972959
15,45,4,64,0.25,0.9375,0.25737455081233374,0.8855495096769845
25,102,5,132,0.1968503937007874,0.9621212121212122,0.23651644378999728,0.8869409753541645
126,445,6,577,0.22066549912434325,0.9896013864818024,0.24763192325674013,0.9330745067563267
6,47,3,56,0.11320754716981132,0.9464285714285714,0.2466017373999219,0.9389624069400969
36,60,3,99,0.375,0.9696969696969697,0.2700979780014256,0.9522158201935103
2,0,0,2,1.0,1.0,0.39254695759326236,0.9617396297173197
1,15,1,17,0.0625,0.9411764705882353,0.31688906285642027,0.9637892300452557
14,66,21,101,0.175,0.7920792079207921,0.30617477714213454,0.9430148311767975
34,101,6,141,0.2518518518518518,0.9574468085106383,0.3140321283065723,0.9423470592324298
10,49,4,63,0.1694915254237288,0.9365079365079365,0.306721560635056,0.9347622806647348
3,20,5,28,0.13043478260869565,0.8214285714285714,0.3091825942691823,0.9169051378075919
4,18,1,23,0.18181818181818182,0.9565217391304348,0.2852031567634758,0.9150913108649158
34,76,3,113,0.3090909090909091,0.9734513274336283,0.18650185806217712,0.9112986433554342
39,57,5,101,0.40625,0.9504950495049505,0.23560900091931997,0.912629868914965
23,68,22,113,0.25274725274725274,0.8053097345132744,0.23778717988321318,0.9145199441424624
83,284,31,398,0.22615803814713897,0.9221105527638191,0.2354316055008717,0.9084587363812654
7,86,7,100,0.07526881720430108,0.93,0.22681383362448856,0.9075290311658459
5,25,2,32,0.16666666666666666,0.9375,0.2311428379534929,0.9250554861923009
2,11,1,14,0.15384615384615385,0.9285714285714286,0.2271468339574889,0.9210625846838714
3,10,2,15,0.23076923076923078,0.8666666666666667,0.2159580227686777,0.9058076331457341
27,219,17,263,0.10975609756097561,0.935361216730038,0.17360175099167424,0.9036456570350323
33,95,31,159,0.2578125,0.8050314465408805,0.1743253577420667,0.9036059016104045
2,14,14,30,0.125,0.5333333333333333,0.15987420943533256,0.8480662988346209
5,116,2,123,0.04132231404958678,0.983739837398374,0.1550247089846591,0.8557434184629601
4,44,2,50,0.08333333333333333,0.96,0.1431199470798972,0.8589577041772458
24,139,30,193,0.147239263803681,0.844559585492228,0.1421761056452582,0.8469560123087886
16,120,12,148,0.11764705882352941,0.918918918918919,0.12601579536730087,0.854420619773396
35,94,19,148,0.2713178294573643,0.8716216216216216,0.14909604278107066,0.8453149633293365
7,102,4,113,0.06422018348623854,0.9646017699115044,0.12143999756481905,0.8681107238108543
43,144,30,217,0.22994652406417113,0.8617511520737328,0.1364323581454149,0.9150275550594827
6,95,1,102,0.0594059405940594,0.9901960784313726,0.13901573336605386,0.9159498752070538
8,48,3,59,0.14285714285714285,0.9491525423728814,0.14751913472659808,0.9144002384031797
4,27,7,38,0.12903225806451613,0.8157894736842105,0.1449181339067174,0.910290222430606
6,137,9,152,0.04195804195804196,0.9407894736842105,0.13410541721164776,0.9134145873970761
26,101,3,130,0.2047244094488189,0.9769230769230769,0.12459207149614127,0.9284576524401411
47,85,7,139,0.3560606060606061,0.9496402877697842,0.16628356043533662,0.9263202978484669
30,64,8,102,0.3191489361702128,0.9215686274509803,0.17902676216477115,0.934865651473788
18,45,3,66,0.2857142857142857,0.9545454545454546,0.2113565257533749,0.9297727052043712
5,114,8,127,0.04201680672268908,0.937007874015748,0.19695076344845294,0.9280377525819234
17,30,1,48,0.3617021276595745,0.9791666666666666,0.230189316247747,0.9513773515794172
16,78,2,96,0.1702127659574468,0.9791666666666666,0.2485114196762334,0.9568598077197681
6,24,0,30,0.2,1.0,0.24783650404068783,0.9601565110164714
11,81,1,93,0.11956521739130435,0.989247311827957,0.2140514485165019,0.9658146573104961
12,38,1,51,0.24,0.9803921568627451,0.20274445763504295,0.9742180186550339
7,52,2,61,0.11864406779661017,0.9672131147540983,0.17887728364680355,0.9760276843991259
9,120,45,174,0.06976744186046512,0.7413793103448276,0.18284166009505728,0.9480807467318515
15,169,27,211,0.08152173913043478,0.8720379146919431,0.1428158903051802,0.9327766393068909
48,91,7,146,0.34532374100719426,0.952054794520548,0.16783174388371552,0.9289035147145883
6,35,21,62,0.14634146341463414,0.6612903225806451,0.1601662386572347,0.8805164179403947
23,170,19,212,0.11917098445595854,0.910377358490566,0.160109919666471,0.8692492817493388
9,49,7,65,0.15517241379310345,0.8923076923076924,0.1479916930654858,0.856665786812903
2,12,1,15,0.14285714285714285,0.9333333333333333,0.15145070378841902,0.8518258180385079
45,31,6,82,0.5921052631578947,0.926829268292683,0.2260703925451947,0.8783186691739158
13,46,4,63,0.22033898305084745,0.9365079365079365,0.2459014273909679,0.8875286722904863
25,102,6,133,0.1968503937007874,0.9548872180451128,0.22469094920433835,0.8879333042225668
119,446,12,577,0.21061946902654868,0.9792027729636048,0.23387352143461188,0.9333493685629897
6,47,3,56,0.11320754716981132,0.9464285714285714,0.2330216018223051,0.9384995418398476
31,59,9,99,0.34444444444444444,0.9090909090909091,0.2600604633439253,0.94089714423745
2,0,0,2,1.0,1.0,0.382509442935762,0.9504209537612596
1,15,1,17,0.0625,0.9411764705882353,0.3068515481989199,0.9524705540891956
16,64,21,101,0.2,0.7920792079207921,0.303945979191656,0.9318378785767464
33,103,5,141,0.2426470588235294,0.9645390070921985,0.3104883599234763,0.933216705583473
10,49,4,63,0.1694915254237288,0.9365079365079365,0.30461293940878775,0.9271174432326631
3,19,5,27,0.13636363636363635,0.8148148148148148,0.30792095215076276,0.9083154780021265
3,19,1,23,0.13636363636363635,0.9565217391304348,0.2780697463790361,0.9082998536036883
36,75,2,113,0.32432432432432434,0.9823008849557522,0.18154464985393953,0.9057714085973672
38,57,6,101,0.4,0.9405940594059405,0.22975893556822527,0.9056882069998965
23,67,16,106,0.25555555555555554,0.8490566037735849,0.23696284277213245,0.9155534361104086
82,285,30,397,0.22343324250681199,0.924433249370277,0.23507598864824192,0.91488989827982
8,85,7,100,0.08602150537634409,0.93,0.2231517000700441,0.9139601930644005
5,25,2,32,0.16666666666666666,0.9375,0.2274807043990484,0.9314866480908555
2,11,1,14,0.15384615384615385,0.9285714285714286,0.22997820689655094,0.9274937465824261
3,10,2,15,0.23076923076923078,0.8666666666666667,0.21661319353153757,0.9109745725411281
27,219,17,263,0.10975609756097561,0.935361216730038,0.17514977889739122,0.9102270235874279
32,74,54,160,0.3018867924528302,0.6625,0.1817685270255733,0.8835760801912015
3,11,16,30,0.21428571428571427,0.4666666666666667,0.18046173727970222,0.8181808540906855
5,116,2,123,0.04132231404958678,0.983739837398374,0.17407613851873685,0.8258579737190247
3,45,2,50,0.0625,0.96,0.1591951861377845,0.8290722594333104
24,139,30,193,0.147239263803681,0.844559585492228,0.15825134470314553,0.8170705675648532
16,120,13,149,0.11764705882352941,0.912751677852349,0.14209103442518817,0.8236541405913792
35,94,18,147,0.2713178294573643,0.8775510204081632,0.165171281838958,0.8153955411168258
7,102,4,113,0.06422018348623854,0.9646017699115044,0.13121890912944492,0.8585529368184692
44,143,30,217,0.23529411764705882,0.8617511520737328,0.13422010960963698,0.9149935775909073
5,96,1,102,0.04950495049504951,0.9901960784313726,0.1353890576732745,0.9159158977384784
9,47,3,59,0.16071428571428573,0.9491525423728814,0.1494196699181725,0.9143662609346043
4,27,7,38,0.12903225806451613,0.8157894736842105,0.14681866909829178,0.9102562449620304
6,136,9,151,0.04225352112676056,0.9403973509933775,0.1360481637130391,0.9142056268393202
26,99,5,130,0.208,0.9615384615384616,0.1270027595048442,0.9262038327150771
51,82,6,139,0.38345864661654133,0.9568345323741008,0.17260825423774456,0.9250942273525908
30,64,8,102,0.3191489361702128,0.9215686274509803,0.18458751402676657,0.9336395809779121
17,47,3,67,0.265625,0.9552238805970149,0.21546180681318808,0.9286435527158609
9,110,8,127,0.07563025210084033,0.937007874015748,0.20330694486841017,0.9269086000934132
15,32,1,48,0.3191489361702128,0.9791666666666666,0.23046647031208112,0.950248199090907
15,74,4,93,0.16853932584269662,0.956989247311828,0.24850729955721484,0.9526184699935428
5,25,0,30,0.16666666666666666,1.0,0.24260253765245293,0.9581129754880483
11,83,1,95,0.11702127659574468,0.9894736842105263,0.20454005622091057,0.9627757114646806
13,37,1,51,0.26,0.9803921568627451,0.19609020819659445,0.9711790728092182
6,52,2,60,0.10344827586206896,0.9666666666666667,0.17292210474831857,0.9728137565334543
8,121,46,175,0.06201550387596899,0.7371428571428571,0.17097714071619413,0.9442616112658985
13,165,33,211,0.07303370786516854,0.8436018957345972,0.13581782238690204,0.92489521541846
45,95,7,147,0.32142857142857145,0.9523809523809523,0.15765914318488417,0.9242368875711919
3,38,21,62,0.07317073170731707,0.6612903225806451,0.14430258104783425,0.8758497907969984
21,171,19,211,0.109375,0.909952606635071,0.1432102558198707,0.8644896368576477
9,48,8,65,0.15789473684210525,0.8769230769230769,0.12862378965445717,0.8497083397234094
2,10,2,14,0.16666666666666666,0.8571428571428571,0.1376549883408283,0.834062081220008
45,31,6,82,0.5921052631578947,0.926829268292683,0.21338209680967482,0.8611601399556974
14,45,4,63,0.23728813559322035,0.9365079365079365,0.23684701505653935,0.8744324314947459
25,103,6,134,0.1953125,0.9552238805970149,0.21883043342388628,0.8748385640970406
126,443,6,575,0.22144112478031636,0.9895652173913043,0.24001191814860046,0.9217349776414204
4,49,3,56,0.07547169811320754,0.9464285714285714,0.2351685893076301,0.9269458297547776
22,57,20,99,0.27848101265822783,0.797979797979798,0.2523952001385048,0.9156682184771664
2,0,0,2,1.0,1.0,0.3714428191861238,0.9360763817424724
1,15,1,17,0.0625,0.9411764705882353,0.2957849244492817,0.9381259820704085
19,61,21,101,0.2375,0.7920792079207921,0.29581519079310736,0.9174933065579592
33,103,5,141,0.2426470588235294,0.9645390070921985,0.30257727062504014,0.9188240389144141
8,51,4,63,0.13559322033898305,0.9365079365079365,0.2903132842762783,0.9112444273596473
3,19,5,27,0.13636363636363635,0.8148148148148148,0.2990121325977681,0.8924424621291107
3,18,2,23,0.14285714285714285,0.9130434782608695,0.27409308789694803,0.9065567585858476
34,76,3,113,0.3090909090909091,0.9734513274336283,0.17539178919564932,0.902764091076366
38,58,6,102,0.3958333333333333,0.9411764705882353,0.22301083681469697,0.902764091076366
21,67,18,106,0.23863636363636365,0.8301886792452831,0.22816865368137457,0.9085053309685492
85,283,30,398,0.23097826086956522,0.9246231155778895,0.22705040949856192,0.9048294032040937
8,85,7,100,0.08602150537634409,0.93,0.21996873593247065,0.9038996979886742
5,25,2,32,0.16666666666666666,0.9375,0.22429774026147498,0.9214261530151292
2,11,1,14,0.15384615384615385,0.9285714285714286,0.22586759897419087,0.9236444316309235
3,9,2,14,0.25,0.8571428571428571,0.21742604053263243,0.9070289358750989
24,222,16,262,0.0975609756097561,0.9389312977099237,0.1748157037149785,0.906708196892483
32,76,52,160,0.2962962962962963,0.675,0.18305283695211175,0.8845383855717284
2,11,17,30,0.15384615384615385,0.43333333333333335,0.17203396452019584,0.814354130965363
6,115,2,123,0.049586776859504134,0.983739837398374,0.16682900330350442,0.8220312505937023
3,45,2,50,0.0625,0.96,0.15194805092255206,0.825245536307988
22,139,34,195,0.13664596273291926,0.8256410256410256,0.14949088076351852,0.8105411930322161
17,119,13,149,0.125,0.912751677852349,0.13163373790637564,0.8184853102764293
34,95,19,148,0.26356589147286824,0.8716216216216216,0.15534872588682025,0.8088696422638147
5,104,4,113,0.045871559633027525,0.9646017699115044,0.11957376350635328,0.8502413236797438
44,143,30,217,0.23529411764705882,0.8617511520737328,0.13120918690648256,0.9114438692140867
5,96,1,102,0.04950495049504951,0.9901960784313726,0.13119749742584622,0.9123661893616578
8,48,3,59,0.14285714285714285,0.9491525423728814,0.14267708926258088,0.9108165525577838
4,26,7,37,0.13333333333333333,0.8108108108108109,0.14220385649121145,0.9086979504391817
7,136,9,152,0.04895104895104895,0.9407894736842105,0.1313397206270756,0.9127033498437334
26,100,4,130,0.20634920634920634,0.9692307692307692,0.12316590846655248,0.9266475137878973
51,80,8,139,0.3893129770992366,0.9424460431654677,0.17222896810458233,0.923482409967035
30,63,8,101,0.3225806451612903,0.9207920792079208,0.18469847203518683,0.9319168281290617
15,49,3,67,0.234375,0.9552238805970149,0.2111084791073226,0.9269207998670106
7,112,9,128,0.058823529411764705,0.9296875,0.19910367718655433,0.9241400795280276
18,29,1,48,0.3829787234042553,0.9791666666666666,0.2347673043395432,0.9481909160788641
11,76,3,90,0.12643678160919541,0.9666666666666667,0.2458366947192784,0.9518876579335007
6,24,0,30,0.2,1.0,0.24492966524082035,0.9562832623291051
11,83,1,95,0.11702127659574468,0.9894736842105263,0.20603085088317866,0.9630014967641135
13,37,1,51,0.26,0.9803921568627451,0.19709075871728005,0.9715157935719455
6,52,2,60,0.10344827586206896,0.9666666666666667,0.1783869409832899,0.9731504772961815
8,121,46,175,0.06201550387596899,0.7371428571428571,0.17884293733531906,0.9456440997451612
8,92,111,211,0.08,0.47393364928909953,0.13556026256328257,0.8734679544055087
45,94,7,146,0.3237410071942446,0.952054794520548,0.1637465805040039,0.8713805440989202
4,37,21,62,0.0975609756097561,0.6612903225806451,0.1491124341625405,0.8229934473247267
20,172,20,212,0.10416666666666667,0.9056603773584906,0.1472760613155293,0.811020117774436
8,47,10,65,0.14545454545454545,0.8461538461538461,0.13091242495189295,0.7918432162445932
2,11,1,14,0.15384615384615385,0.9285714285714286,0.13811212180676222,0.786401039373845
44,32,6,82,0.5789473684210527,0.926829268292683,0.21195953102748846,0.8134990981095342
13,46,4,63,0.22033898305084745,0.9365079365079365,0.23200795717760955,0.8795811391407967
23,105,6,134,0.1796875,0.9552238805970149,0.2114288847212889,0.8800338657231492
114,438,12,564,0.20652173913043478,0.9787234042553191,0.22699470808138583,0.9253814488195312
4,48,3,55,0.07692307692307693,0.9454545454545454,0.22310276668944445,0.9310663299761105
22,57,20,99,0.27848101265822783,0.797979797979798,0.24210654771854195,0.9241843230941036
2,0,0,2,1.0,1.0,0.3629856685976628,0.9343884047267565
1,15,1,17,0.0625,0.9411764705882353,0.289207473108941,0.9364380050546927
16,62,22,100,0.20512820512820512,0.78,0.2870345048342778,0.9140797284107016
31,100,10,141,0.2366412213740458,0.9290780141843972,0.29517075074485577,0.9103446046374707
10,49,4,63,0.1694915254237288,0.9365079365079365,0.28988072021532635,0.9043138235307017
3,19,5,27,0.13636363636363635,0.8148148148148148,0.29837222870683483,0.8856510048678831
3,18,2,23,0.14285714285714285,0.9130434782608695,0.27661440973919904,0.9054535276953828
35,75,3,113,0.3181818181818182,0.9734513274336283,0.1792118123366016,0.901660860185901
38,58,6,102,0.3958333333333333,0.9411764705882353,0.22683085995564925,0.9016608601859011
21,67,18,106,0.23863636363636365,0.8301886792452831,0.2337969950863413,0.9074021000780844
84,284,30,398,0.22826086956521738,0.9246231155778895,0.2336014579342824,0.9027130010876915
6,86,8,100,0.06521739130434782,0.92,0.21628384555403188,0.9003547244437008
5,25,2,32,0.16666666666666666,0.9375,0.22223622650641284,0.9199975815865579
2,11,1,14,0.15384615384615385,0.9285714285714286,0.22380608521912868,0.9222158602023519
3,9,2,14,0.25,0.8571428571428571,0.21406582547886896,0.9056003644465276
24,222,16,262,0.0975609756097561,0.9389312977099237,0.1714554886612151,0.9052796254639116
31,71,58,160,0.30392156862745096,0.6375,0.18078194651708465,0.8777526712860141
3,6,21,30,0.3333333333333333,0.3,0.1957922984839584,0.7885207976320299
6,115,2,123,0.049586776859504134,0.983739837398374,0.19355935356326645,0.7976264886889404
3,45,2,50,0.0625,0.96,0.178678401182314,0.8008407744032261
24,139,33,196,0.147239263803681,0.8316326530612245,0.17773455974767507,0.7869923779017683
17,119,13,149,0.125,0.912751677852349,0.1598774168905322,0.7949364951459816
36,94,18,148,0.27692307692307694,0.8783783783783784,0.1855005742210066,0.7862860780986178
4,105,4,113,0.03669724770642202,0.9646017699115044,0.1473256712322882,0.83301490237169
44,143,30,217,0.23529411764705882,0.8617511520737328,0.13332006899139184,0.9132650669536517
5,96,1,102,0.04950495049504951,0.9901960784313726,0.13330837951075547,0.914187387101223
7,49,3,59,0.125,0.9491525423728814,0.1422369509393269,0.912637750297349
5,25,7,37,0.16666666666666666,0.8108108108108109,0.1450122942054677,0.9096632014044327
7,134,11,152,0.04964539007092199,0.9276315789473685,0.13424734992988513,0.911788901560864
26,100,4,130,0.20634920634920634,0.9692307692307692,0.12416536841933219,0.924767814539777
52,79,8,139,0.3969465648854962,0.9424460431654677,0.17562955658777138,0.9216027107189146
30,64,8,102,0.3191489361702128,0.9215686274509803,0.18760881637679333,0.9301480643442357
14,50,3,67,0.21875,0.9552238805970149,0.21178668059178626,0.9251520360821847
8,111,9,128,0.06722689075630252,0.9296875,0.20353337927125806,0.9223713157432015
19,28,1,48,0.40425531914893614,0.9791666666666666,0.2374746153401537,0.946422152294038
12,76,4,92,0.13636363636363635,0.9565217391304348,0.2498629362391129,0.9505493180344761
6,24,0,30,0.2,1.0,0.24895590676065485,0.9549449224300804
10,84,1,95,0.10638297872340426,0.9894736842105263,0.20744682302321313,0.961663156865089
13,37,1,51,0.26,0.9803921568627451,0.19899697499889704,0.9700665182096266
6,52,2,60,0.10344827586206896,0.9666666666666667,0.18252530012204973,0.9717012019338627
8,121,46,175,0.06201550387596899,0.7371428571428571,0.1817808162820021,0.9441948243828423
8,92,111,211,0.08,0.47393364928909953,0.13545862783215407,0.8720186790431897
46,94,6,146,0.32857142857142857,0.958904109589041,0.16291688386183867,0.8723590176801335
5,36,21,62,0.12195121951219512,0.6612903225806451,0.15176705807786656,0.82397192090594
20,174,20,214,0.10309278350515463,0.9065420560747663,0.15129703018954516,0.8121245454579744
9,48,8,65,0.15789473684210525,0.8769230769230769,0.13671056402413165,0.797343248323736
2,12,1,15,0.14285714285714285,0.9333333333333333,0.14234040216628505,0.7925813435618313
44,32,6,82,0.5789473684210527,0.926829268292683,0.2161878113870113,0.8196794022975206
12,47,4,63,0.2033898305084746,0.9365079365079365,0.23381493003107906,0.885761443328783
20,108,7,135,0.15625,0.9481481481481482,0.2091975830923036,0.8842248774086555
115,436,13,564,0.20871143375680581,0.9769503546099291,0.22159189941296223,0.9293191676985533
5,47,3,55,0.09615384615384616,0.9454545454545454,0.22060062264848962,0.9348780947528074
22,57,20,99,0.27848101265822783,0.797979797979798,0.23782723347936427,0.9236004834751962
2,0,0,2,1.0,1.0,0.360276213071201,0.9331242929990057
1,15,1,17,0.0625,0.9411764705882353,0.2864980175824792,0.9351738933269417
16,63,21,100,0.20253164556962025,0.79,0.2863754197340715,0.9142441881115221
32,102,7,141,0.23880597014925373,0.950354609929078,0.2981691297553934,0.9145593969373694
8,51,4,63,0.13559322033898305,0.9365079365079365,0.2877236706957044,0.9087819086370846
3,19,5,27,0.13636363636363635,0.8148148148148148,0.29346792643996017,0.8901190899742659
3,18,2,23,0.14285714285714285,0.9130434782608695,0.2757602129030114,0.9064666989213198
36,75,2,113,0.32432432432432434,0.9823008849557522,0.1792351163779149,0.9039382539149987
40,56,6,102,0.4166666666666667,0.9411764705882353,0.229830354473153,0.9039382539149988
21,66,19,106,0.2413793103448276,0.8207547169811321,0.2353800208696112,0.9083317849123035
86,282,30,398,0.23369565217391305,0.9246231155778895,0.236202088827229,0.9026295146959734
7,86,7,100,0.07526881720430108,0.93,0.22274170193873935,0.9016998094805542
5,25,2,32,0.16666666666666666,0.9375,0.22869408289112028,0.9213426666234111
2,11,1,14,0.15384615384615385,0.9285714285714286,0.23026394160383615,0.9235609452392053
3,9,2,14,0.25,0.8571428571428571,0.21964618098607552,0.9056812269802202
23,222,17,262,0.09387755102040816,0.9351145038167938,0.17353345017946717,0.9048152317271573
32,67,61,160,0.32323232323232326,0.61875,0.1852267377348237,0.875957415015567
3,13,14,30,0.1875,0.5333333333333333,0.17862735885283612,0.820058874694916
6,115,2,123,0.049586776859504134,0.983739837398374,0.17495849594643656,0.8277359943232552
3,45,2,50,0.0625,0.96,0.16007754356548418,0.830950280037541
26,139,31,196,0.15757575757575756,0.8418367346938775,0.1606103440982847,0.8185596094836051
17,120,13,150,0.12408759124087591,0.9133333333333333,0.14262285713269554,0.8265868203679588
36,94,18,148,0.27692307692307694,0.8783783783783784,0.16877221797593395,0.8184816595910424
6,103,4,113,0.05504587155963303,0.9646017699115044,0.13045986773697818,0.8678890552926858
43,144,30,217,0.22994652406417113,0.8617511520737328,0.13652365688900264,0.9148058865413142
4,97,1,102,0.039603960396039604,0.9901960784313726,0.13509754025136483,0.9157282066888854
8,48,3,59,0.14285714285714285,0.9491525423728814,0.14657713208809955,0.9141785698850114
5,25,7,37,0.16666666666666666,0.8108108108108109,0.14787583338680085,0.9097462950445733
7,137,9,153,0.04861111111111111,0.9411764705882353,0.13709347908254874,0.9137238860809879
28,100,2,130,0.21875,0.9846153846153847,0.12878303952210918,0.928900601257703
53,80,6,139,0.39849624060150374,0.9568345323741008,0.1778473779566621,0.9277909958952169
31,64,7,102,0.3263157894736842,0.9313725490196079,0.19161441587230682,0.9377369097446275
14,50,3,67,0.21875,0.9552238805970149,0.21720670724430116,0.9327408814825765
15,105,8,128,0.125,0.9375,0.21465568683613792,0.9310762325721649
18,29,1,48,0.3829787234042553,0.9791666666666666,0.245557409227222,0.9551270691230014
12,77,3,92,0.1348314606741573,0.967391304347826,0.25787460202194296,0.9588720453743714
6,24,0,30,0.2,1.0,0.2551960305933715,0.9610698475721736
11,83,1,95,0.11702127659574468,0.9894736842105263,0.2149853214496916,0.9657325835488059
13,37,1,51,0.26,0.9803921568627451,0.20551163723916527,0.972735384669254
5,53,2,60,0.08620689655172414,0.9666666666666667,0.1865769081751259,0.97437006839349
8,121,46,175,0.06201550387596899,0.7371428571428571,0.17757912301455006,0.9457476194138982
12,106,93,211,0.1016949152542373,0.5592417061611374,0.13739572185026175,0.8857583393416798
46,97,6,149,0.32167832167832167,0.959731543624161,0.16408813056514235,0.8846640878097275
6,35,21,62,0.14634146341463414,0.6612903225806451,0.15642262533866155,0.836276991035534
20,174,20,214,0.10309278350515463,0.9065420560747663,0.15443284061143436,0.8244296155875682
9,48,8,65,0.15789473684210525,0.8769230769230769,0.13984637444602083,0.80964831845333
2,12,1,15,0.14285714285714285,0.9333333333333333,0.14793926677536637,0.8048864136914252
44,32,6,82,0.5789473684210527,0.926829268292683,0.22178667599609264,0.8319844724271147
11,48,4,63,0.1864406779661017,0.9365079365079365,0.23389321352635897,0.8858796481909431
23,103,9,135,0.18253968253968253,0.9333333333333333,0.21401626507798197,0.8821084752922533
124,433,7,564,0.22262118491921004,0.9875886524822695,0.22491336815006419,0.9287225224210569
4,48,3,55,0.07692307692307693,0.9454545454545454,0.2211748386383388,0.934281449475311
22,57,20,99,0.27848101265822783,0.797979797979798,0.2384014494692135,0.9230038381976998
2,0,0,2,1.0,1.0,0.36085042906105025,0.9325276477215094
1,15,1,17,0.0625,0.9411764705882353,0.2870722335723284,0.9345772480494455
15,64,21,100,0.189873417721519,0.79,0.28756262496595947,0.9136475428340258
31,104,6,141,0.22962962962962963,0.9574468085106383,0.29428976026452336,0.9170923250022123
11,48,4,63,0.1864406779661017,0.9365079365079365,0.2891211164140793,0.9097950798630219
3,21,6,30,0.125,0.8,0.2959892482822112,0.8890158590838011
4,17,2,23,0.19047619047619047,0.9130434782608695,0.27611855077513564,0.9043896979081486
35,75,3,113,0.3181818181818182,0.9734513274336283,0.17871595337253823,0.900597030398667
39,56,7,102,0.4105263157894737,0.9313725490196079,0.22843399848532023,0.8991964701745774
22,64,17,103,0.2558139534883721,0.8349514563106796,0.23785407502344208,0.9056181067903887
91,279,30,400,0.24594594594594596,0.925,0.2450622499007899,0.9020466782189602
7,86,7,100,0.07526881720430108,0.93,0.2316018630123002,0.9011169730035408
5,25,2,32,0.16666666666666666,0.9375,0.23755424396468117,0.920759830146398
2,11,1,14,0.15384615384615385,0.9285714285714286,0.23232138158896162,0.922978108762192
3,9,2,14,0.25,0.8571428571428571,0.2225811218487019,0.9063626130063674
23,222,16,261,0.09387755102040816,0.9386973180076629,0.1773455840245497,0.9074090085760897
30,63,67,160,0.3225806451612903,0.58125,0.18688368283496656,0.8711659433888498
3,13,14,30,0.1875,0.5333333333333333,0.17853426198554573,0.8152135624364688
5,116,2,123,0.04132231404958678,0.983739837398374,0.17368476153487225,0.822890682064808
3,45,2,50,0.0625,0.96,0.1588038091539199,0.8261049677790936
26,138,32,196,0.15853658536585366,0.8367346938775511,0.15947387079959127,0.8129854342513969
17,120,13,150,0.12408759124087591,0.9133333333333333,0.1414863838340021,0.8210126451357507
36,94,17,147,0.27692307692307694,0.8843537414965986,0.16763574467724052,0.8132492770627414
6,103,4,113,0.05504587155963303,0.9646017699115044,0.12941649130557517,0.8680138156215278
43,144,30,217,0.22994652406417113,0.8617511520737328,0.13548028045759963,0.9149306468701563
5,96,1,102,0.04950495049504951,0.9901960784313726,0.13664922852123718,0.9158529670177274
8,48,2,58,0.14285714285714285,0.9655172413793104,0.14812882035797187,0.916641144357629
5,25,7,37,0.16666666666666666,0.8108108108108109,0.1492902605438023,0.9129377324909518
7,122,23,152,0.05426356589147287,0.8486842105263158,0.13931539977960186,0.9037021435185207
26,99,5,130,0.208,0.9615384615384616,0.12946924593344802,0.9147285320959296
51,82,6,139,0.38345864661654133,0.9568345323741008,0.17638535665586347,0.9136189267334435
32,62,7,101,0.3404255319148936,0.9306930693069307,0.19216807206310954,0.9234677720524719
12,51,4,67,0.19047619047619047,0.9402985074626866,0.21230682063184397,0.9163395476283738
6,114,8,128,0.05,0.9375,0.19904151450939497,0.9123370845741866
17,30,1,48,0.3617021276595745,0.9791666666666666,0.22690372322266755,0.9363879211250231
13,76,3,92,0.14606741573033707,0.967391304347826,0.24001855891393384,0.9533460773852388
6,24,0,30,0.2,1.0,0.23887570177107673,0.9588405828797443
12,81,1,94,0.12903225806451613,0.9893617021276596,0.20252907483507313,0.963487321415967
12,37,2,51,0.24489795918367346,0.9607843137254902,0.18888227873061308,0.9677860706186184
7,51,2,60,0.1206896551724138,0.9666666666666667,0.17891277368721642,0.9715529505049013
8,121,46,175,0.06201550387596899,0.7371428571428571,0.18062927424092629,0.9429305015253096
12,109,90,211,0.09917355371900827,0.5734597156398105,0.1431251922494168,0.88497236566433
48,92,7,147,0.34285714285714286,0.9523809523809523,0.17123801041038905,0.8828280296690624
6,35,21,62,0.14634146341463414,0.6612903225806451,0.16357250518390826,0.8344409328948688
20,173,20,213,0.10362694300518134,0.9061032863849765,0.15994317446114611,0.8225468735030568
9,49,7,65,0.15517241379310345,0.8923076923076924,0.1471252394053504,0.8127644990148
2,12,1,15,0.14285714285714285,0.9333333333333333,0.1502920233603117,0.8080025942528953
44,32,6,82,0.5789473684210527,0.926829268292683,0.22413943258103794,0.8351006529885847
11,48,4,63,0.1864406779661017,0.9365079365079365,0.23660616461633702,0.8869646845411742
22,105,7,134,0.1732283464566929,0.9477611940298507,0.2123734794162727,0.8863047190624452
120,437,7,564,0.21543985637342908,0.9875886524822695,0.22224467841038628,0.9329187661912488
4,48,3,55,0.07692307692307693,0.9454545454545454,0.2184298403986571,0.9385403746297586
22,56,20,98,0.28205128205128205,0.7959183673469388,0.23655539300696832,0.9247704710639367
2,0,0,2,1.0,1.0,0.3590043725988051,0.9342942805877462
1,15,1,17,0.0625,0.9411764705882353,0.2852261771100832,0.9363438809156823
16,63,21,100,0.20253164556962025,0.79,0.28752488676772875,0.9154141757002627
31,105,5,141,0.22794117647058823,0.9645390070921985,0.2953410053411423,0.917811006137741
10,49,4,63,0.1694915254237288,0.9365079365079365,0.2887769580626137,0.9105137609985505
3,21,6,30,0.125,0.8,0.29564508993074556,0.8897345402193297
4,17,2,23,0.19047619047619047,0.9130434782608695,0.27151651735891214,0.905410106071414
36,74,3,113,0.32727272727272727,0.9734513274336283,0.175412621255016,0.9016174385619323
39,55,8,102,0.4148936170212766,0.9215686274509803,0.22575456654376977,0.8988163181137531
23,58,18,99,0.2839506172839506,0.8181818181818182,0.24281080300928898,0.9028422921397271
91,279,30,400,0.24594594594594596,0.925,0.25342568228088463,0.8982504554050331
7,86,7,100,0.07526881720430108,0.93,0.23754398788634168,0.8973207501896138
5,25,2,32,0.16666666666666666,0.9375,0.24349636883872264,0.9169636073324708
2,11,1,14,0.15384615384615385,0.9285714285714286,0.23826350646300312,0.919181885948265
3,9,2,14,0.25,0.8571428571428571,0.22722454542404208,0.9025663901924406
27,216,17,260,0.1111111111111111,0.9346153846153846,0.18382704457973276,0.9044302126444982
29,61,70,160,0.32222222222222224,0.5625,0.18929441671377153,0.8679042386185242
3,10,17,30,0.23076923076923078,0.43333333333333335,0.1871263145456694,0.797666143380429
7,114,2,123,0.05785123966942149,0.983739837398374,0.18463808918354374,0.8053432630087682
4,44,3,51,0.08333333333333333,0.9411764705882353,0.17273332727878182,0.8058684730928017
25,139,32,196,0.1524390243902439,0.8367346938775511,0.17253230878508044,0.7927489395651051
17,120,13,150,0.12408759124087591,0.9133333333333333,0.15454482181949122,0.8007761504494588
35,95,17,147,0.2692307692307692,0.8843537414965986,0.17713334440801384,0.7935959157182035
5,104,4,113,0.045871559633027525,0.9646017699115044,0.13765467832384318,0.8510390257055613
43,144,30,217,0.22994652406417113,0.8617511520737328,0.13753714879454892,0.9122415712399041
5,96,1,102,0.04950495049504951,0.9901960784313726,0.13634482176963864,0.9131638913874754
7,48,1,56,0.12727272727272726,0.9821428571428571,0.14262187804669493,0.9190162323238499
4,26,7,37,0.13333333333333333,0.8108108108108109,0.13989249360999342,0.9153128204571728
7,135,11,153,0.04929577464788732,0.9281045751633987,0.1292079483824236,0.9174229978614677
28,97,5,130,0.224,0.9615384615384616,0.12274640992088516,0.9284493864388768
51,82,6,139,0.38345864661654133,0.9568345323741008,0.17097313663281571,0.9273397810763905
33,61,7,101,0.35106382978723405,0.9306930693069307,0.18827560887896752,0.9371886263954189
12,52,3,67,0.1875,0.9552238805970149,0.20798918737967473,0.9321925981333677
14,106,8,128,0.11666666666666667,0.9375,0.20647403586452323,0.9258150471129596
18,29,1,48,0.3829787234042553,0.9791666666666666,0.2421376630175121,0.9498658836637962
11,76,4,91,0.12643678160919541,0.9560439560439561,0.25315780686912753,0.95385722378959
6,24,0,30,0.2,1.0,0.24972923544055609,0.9593517292840955
11,82,1,94,0.11827956989247312,0.9893617021276596,0.21184651019426065,0.9639984678203181
13,36,2,51,0.2653061224489796,0.9607843137254902,0.1995954091459386,0.9682972170229694
6,50,4,60,0.10714285714285714,0.9333333333333333,0.1881158173092039,0.9651699959853008
8,121,45,174,0.06201550387596899,0.7413793103448276,0.18030850833910422,0.9371527546059905
12,105,94,211,0.10256410256410256,0.5545023696682464,0.14024927679051097,0.876486426463359
48,92,7,147,0.34285714285714286,0.9523809523809523,0.1711664712545035,0.875963140225787
5,36,21,62,0.12195121951219512,0.6612903225806451,0.16001664547053135,0.8275760434515934
19,175,20,214,0.0979381443298969,0.9065420560747663,0.1571107275330205,0.8157446654440372
9,47,9,65,0.16071428571428573,0.8615384615384616,0.14216903657092134,0.801566686560176
2,12,1,15,0.14285714285714285,0.9333333333333333,0.14727107738724785,0.8015666865601762
45,31,6,82,0.5921052631578947,0.926829268292683,0.22299818585609438,0.8280595376955839
11,48,4,63,0.1864406779661017,0.9365079365079365,0.23498055377066568,0.8826317615298253
21,106,6,133,0.16535433070866143,0.9548872180451128,0.2096230091780255,0.8829897994818483
122,435,7,564,0.21903052064631956,0.9875886524822695,0.22349148076861466,0.9296038466106518
5,47,3,55,0.09615384615384616,0.9454545454545454,0.2232365810291789,0.9351627736649059
22,58,20,100,0.275,0.8,0.23956311164142377,0.9263715648736971
2,0,0,2,1.0,1.0,0.3620120912332605,0.9358953743975066
1,15,1,17,0.0625,0.9411764705882353,0.2863541964964184,0.9379449747254427
15,64,21,100,0.189873417721519,0.79,0.28684458789004946,0.9170152695100232
26,107,7,140,0.19548872180451127,0.95,0.29114950090374225,0.9163170955035785
10,49,4,63,0.1694915254237288,0.9365079365079365,0.2840725015862293,0.9090198503643881
3,21,6,30,0.125,0.8,0.2881933807071085,0.8882406295851674
4,17,2,23,0.19047619047619047,0.9130434782608695,0.2612868286125864,0.9064305142346792
37,74,2,113,0.3333333333333333,0.9823008849557522,0.16604873337449116,0.903902069228358
36,56,8,100,0.391304347826087,0.92,0.21302078306393218,0.9008768591443247
23,56,18,97,0.2911392405063291,0.8144329896907216,0.2274873291760479,0.9043672862429991
91,278,30,399,0.24661246612466126,0.924812030075188,0.24367006243195188,0.8987281884986382
7,86,7,100,0.07526881720430108,0.93,0.2302096755434622,0.8977984832832187
5,25,2,32,0.16666666666666666,0.9375,0.2421144374482241,0.9174413404260758
2,11,1,14,0.15384615384615385,0.9285714285714286,0.23688157507250462,0.9196596190418701
3,9,2,14,0.25,0.8571428571428571,0.2249768131677427,0.901779900782885
28,215,17,260,0.11522633744855967,0.9346153846153846,0.18553709739952454,0.9038678128707971
29,62,70,161,0.31868131868131866,0.5652173913043478,0.18947167999595163,0.8682655845298866
3,14,13,30,0.17647058823529413,0.5666666666666667,0.179451411726042,0.8171019611858121
6,115,2,123,0.049586776859504134,0.983739837398374,0.17578254881964248,0.8247790808141512
4,43,3,50,0.0851063829787234,0.94,0.16413107972136484,0.8251362236712941
25,134,35,194,0.15723270440251572,0.8195876288659794,0.16461487265798797,0.8095671094276584
17,120,13,150,0.12408759124087591,0.9133333333333333,0.1466273856923988,0.8175943203120122
33,98,15,146,0.25190839694656486,0.8972602739726028,0.16615339419211383,0.812257875934472
5,104,4,113,0.045871559633027525,0.9646017699115044,0.12718057147092937,0.8693127871640657
43,144,30,217,0.22994652406417113,0.8617511520737328,0.13481999087505467,0.9114677136507894
5,96,1,102,0.04950495049504951,0.9901960784313726,0.1348083013944183,0.9123900337983607
6,49,2,57,0.10909090909090909,0.9649122807017544,0.13823466226758768,0.9159489310414684
4,27,7,38,0.12903225806451613,0.8157894736842105,0.13420602707644488,0.9154063374440728
7,122,24,153,0.05426356589147287,0.8431372549019608,0.12423116631224444,0.9053783262395912
27,88,15,130,0.23478260869565218,0.8846153846153846,0.12178462513354263,0.9035719134742742
48,68,23,139,0.41379310344827586,0.8345323741007195,0.1743448456785781,0.8849905712155907
33,61,7,101,0.35106382978723405,0.9306930693069307,0.19164731792472997,0.8948394165346188
12,52,3,67,0.1875,0.9552238805970149,0.21136089642543718,0.8898433882725678
6,113,8,127,0.05042016806722689,0.937007874015748,0.20297936199348257,0.8858570444602812
18,26,4,48,0.4090909090909091,0.9166666666666666,0.2429877407115387,0.9002680720292036
12,76,3,91,0.13636363636363635,0.967032967032967,0.2547163222075621,0.9179674594764903
6,24,0,30,0.2,1.0,0.24974737810818318,0.9344509759600067
11,81,1,93,0.11956521739130435,0.989247311827957,0.20771482295718727,0.9565531099210405
13,36,2,51,0.2653061224489796,0.9607843137254902,0.19546372190886516,0.9608518591236919
5,53,2,60,0.08620689655172414,0.9666666666666667,0.1809932785591115,0.9624865428479278
8,121,45,174,0.06201550387596899,0.7413793103448276,0.18264975510321751,0.9345396051806534
13,108,90,211,0.10743801652892562,0.5734597156398105,0.13955648473721988,0.8855100407482456
47,92,7,146,0.3381294964028777,0.952054794520548,0.1683801790285401,0.8833703018178999
4,38,21,63,0.09523809523809523,0.6666666666666666,0.15341419263398226,0.8357512541988523
20,174,21,215,0.10309278350515463,0.9023255813953488,0.15106098779310373,0.8233338641370512
10,48,8,66,0.1724137931034483,0.8787878787878788,0.13779065502945637,0.8116200877173922
2,12,1,15,0.14285714285714285,0.9333333333333333,0.14588354735880188,0.8068581829554875
45,31,6,82,0.5921052631578947,0.926829268292683,0.22161065582764847,0.8333510340908955
10,42,11,63,0.19230769230769232,0.8253968253968254,0.23373489522461513,0.8693420497704691
23,104,6,133,0.18110236220472442,0.9548872180451128,0.21130244748202176,0.8697466817025497
116,436,13,565,0.21014492753623187,0.9769911504424779,0.22771770923889845,0.91407875081338
6,46,3,55,0.11538461538461539,0.9454545454545454,0.22947368522167855,0.9202400313932652
22,58,20,100,0.275,0.8,0.24412885763547165,0.908984620137854
2,0,0,2,1.0,1.0,0.3665778372273084,0.9185084296616635
1,15,1,17,0.0625,0.9411764705882353,0.2909199424904663,0.9205580299895993
13,66,21,100,0.16455696202531644,0.79,0.2869555524501269,0.9155013406471958
23,111,6,140,0.17164179104477612,0.9571428571428572,0.28560404228442,0.9158235748040164
11,48,4,63,0.1864406779661017,0.9365079365079365,0.2822177209172585,0.9100402585276534
3,21,6,30,0.125,0.8,0.28359134729088487,0.8892610377484326
4,17,2,23,0.19047619047619047,0.9130434782608695,0.2521026592455164,0.9038080428038627
36,76,2,114,0.32142857142857145,0.9824561403508771,0.15516388373531229,0.9013017771397024
36,55,8,99,0.3956043956043956,0.9191919191919192,0.20275022596451167,0.8981611269402288
24,55,25,104,0.3037974683544304,0.7596153846153846,0.2193641500151446,0.8935234378965989
92,276,31,399,0.25,0.9223057644110275,0.24209142274241732,0.8905875266900111
7,85,7,99,0.07608695652173914,0.9292929292929293,0.23153241653123718,0.8894150880175724
5,25,2,32,0.16666666666666666,0.9375,0.24343717843599907,0.9090579451604296
2,11,1,14,0.15384615384615385,0.9285714285714286,0.2382043160602796,0.9112762237762236
3,9,2,14,0.25,0.8571428571428571,0.22800023442762654,0.893374326175078
23,220,17,260,0.09465020576131687,0.9346153846153846,0.18500677873575813,0.8955776783784302
31,62,69,162,0.3333333333333333,0.5740740740740741,0.18922618801845856,0.8690717768725287
2,11,17,30,0.15384615384615385,0.43333333333333335,0.17548992428219481,0.7992185724328582
6,115,2,123,0.049586776859504134,0.983739837398374,0.17170418433044696,0.8069967021622073
4,43,3,50,0.0851063829787234,0.94,0.16005271523216935,0.8073538450193501
23,135,36,194,0.14556962025316456,0.8144329896907216,0.15887035329031374,0.7910483537506777
17,121,13,151,0.12318840579710146,0.9139072847682119,0.14075441126132823,0.799157557697157
32,98,15,145,0.24615384615384617,0.896551724137931,0.16239778846026098,0.7937198919146635
4,105,4,113,0.03669724770642202,0.9646017699115044,0.12002120479927367,0.8495095627485822
43,144,30,217,0.22994652406417113,0.8617511520737328,0.1308926862589904,0.910712108282925
5,96,1,102,0.04950495049504951,0.9901960784313726,0.13088099677835402,0.9116344284304964
7,48,2,57,0.12727272727272726,0.9649122807017544,0.136904760248926,0.915193325673604
4,27,7,38,0.12903225806451613,0.8157894736842105,0.13454227993626194,0.9153871091012453
7,121,26,154,0.0546875,0.8311688311688312,0.12475643625096174,0.9035673300156196
27,89,14,130,0.23275862068965517,0.8923076923076924,0.12284283261322017,0.9029610397541568
50,66,23,139,0.43103448275862066,0.8345323741007195,0.17917672333496285,0.8843796974954732
33,62,7,102,0.3473684210526316,0.9313725490196079,0.19595128004760004,0.8943256113448841
12,52,3,67,0.1875,0.9552238805970149,0.21566485854830728,0.8893295830828329
18,93,16,127,0.16216216216216217,0.8740157480314961,0.22064906353251224,0.8763443641299389
17,27,4,48,0.38636363636363635,0.9166666666666666,0.25741068900381514,0.8907553916988612
12,76,4,92,0.13636363636363635,0.9565217391304348,0.2690787084843346,0.9086629499790904
6,24,0,30,0.2,1.0,0.2643989055286696,0.9240475653637057
12,82,1,95,0.1276595744680851,0.9894736842105263,0.22105963291573597,0.9461820382365351
14,35,2,51,0.2857142857142857,0.9607843137254902,0.21225189929597224,0.9503837189088041
5,54,2,61,0.0847457627118644,0.9672131147540983,0.1975727225405243,0.9520964666455303
8,122,45,175,0.06153846153846154,0.7428571428571429,0.18319790816570994,0.9333595230491941
12,108,89,209,0.1,0.5741626794258373,0.142288817256619,0.8844303820147899
45,89,8,142,0.3358208955223881,0.9436619718309859,0.17078271142215495,0.8825932724005829
3,39,20,62,0.07142857142857142,0.6774193548387096,0.15241536448337947,0.836510323091827
21,173,20,214,0.10824742268041238,0.9065420560747663,0.14964219994228337,0.8246629476438614
10,48,8,66,0.1724137931034483,0.8787878787878788,0.1334564152835923,0.8129491712242027
2,11,1,14,0.15384615384615385,0.9285714285714286,0.14332789973134794,0.8074289303409641
46,30,6,82,0.6052631578947368,0.926829268292683,0.22100285635367298,0.8337106625460413
11,41,11,63,0.21153846153846154,0.8253968253968254,0.2369369222877389,0.869601254827611
24,100,8,132,0.1935483870967742,0.9393939393939394,0.21661227822693693,0.868991535908033
116,436,13,565,0.21014492753623187,0.9769911504424779,0.23642890052803128,0.9117875067085713
5,47,3,55,0.09615384615384616,0.9454545454545454,0.23470124673852183,0.9173464337628255
22,60,20,102,0.2682926829268293,0.803921568627451,0.24839823099900485,0.9066512465970501
2,0,0,2,1.0,1.0,0.36927735187812566,0.9168553282297031
1,15,1,17,0.0625,0.9411764705882353,0.29173975789316337,0.9189049285576392
15,64,21,100,0.189873417721519,0.79,0.28864475163360004,0.9138482392152356
18,117,5,140,0.13333333333333333,0.9642857142857143,0.2800426010959657,0.9174042070569177
10,49,4,63,0.1694915254237288,0.9365079365079365,0.27423497222275095,0.9116208907805545
2,22,6,30,0.08333333333333333,0.8,0.2724034703912491,0.8908416700013339
4,17,2,23,0.19047619047619047,0.9130434782608695,0.26083974377374014,0.9054548401366572
34,75,4,113,0.3119266055045872,0.9646017699115044,0.16254354456010975,0.900397950124015
36,57,8,101,0.3870967741935484,0.9207920792079208,0.20891451230204522,0.8974858942125415
23,57,25,105,0.2875,0.7619047619047619,0.22105284864924232,0.8945896862243957
98,272,29,399,0.2648648648648649,0.9273182957393483,0.24407587167226535,0.8893086264320578
6,86,7,99,0.06521739130434782,0.9292929292929293,0.2272021656681246,0.8881361877596191
5,25,2,32,0.16666666666666666,0.9375,0.23910692757288649,0.9077790449024763
2,11,1,14,0.15384615384615385,0.9285714285714286,0.23387406519716697,0.9099973235182703
3,9,2,14,0.25,0.8571428571428571,0.2250274072679402,0.8946460502656065
24,220,16,260,0.09836065573770492,0.9384615384615385,0.1837793903456769,0.897170258730409
41,86,24,151,0.3228346456692913,0.8410596026490066,0.18882719686986135,0.9084780931224439
2,8,20,30,0.2,0.3333333333333333,0.1795607876034521,0.8236230984930133
6,115,2,123,0.049586776859504134,0.983739837398374,0.1773278426827601,0.8314012282223625
4,43,3,50,0.0851063829787234,0.94,0.16567637358448248,0.8317583710795055
26,135,33,194,0.16149068322981366,0.8298969072164949,0.16676844921071962,0.8176620108859434
17,121,13,151,0.12318840579710146,0.9139072847682119,0.14865250718173414,0.8257712148324227
31,98,15,144,0.24031007751937986,0.8958333333333334,0.16893099600768768,0.8196814712426791
5,104,4,113,0.045871559633027525,0.9646017699115044,0.12936484085965,0.8373303522801788
44,143,30,217,0.23529411764705882,0.8617511520737328,0.1344068576663727,0.9128186121002358
5,96,1,102,0.04950495049504951,0.9901960784313726,0.13439516818573632,0.913740932247807
7,48,2,57,0.12727272727272726,0.9649122807017544,0.14041893165630828,0.9172998294909149
3,28,7,38,0.0967741935483871,0.8157894736842105,0.13117371884467594,0.9152844818434456
7,118,27,152,0.056,0.8223684210526315,0.12157537515937573,0.9022075013126484
23,91,16,130,0.20175438596491227,0.8769230769230769,0.1160674192230232,0.8995060361111832
50,66,23,139,0.43103448275862066,0.8345323741007195,0.1710906939552508,0.8809246938524996
32,62,7,101,0.3404255319148936,0.9306930693069307,0.1861094674220843,0.8907735391715279
11,54,2,67,0.16923076923076924,0.9701492537313433,0.20321315581290142,0.8879097070715237
6,113,8,127,0.05042016806722689,0.937007874015748,0.19223421878354424,0.8839233632592371
17,27,4,48,0.38636363636363635,0.9166666666666666,0.2336041391857227,0.8983343908281595
12,77,4,93,0.1348314606741573,0.956989247311828,0.24486577642488805,0.9175659374366162
6,24,0,30,0.2,1.0,0.24461514985847202,0.9351483550190337
12,82,1,95,0.1276595744680851,0.9894736842105263,0.20127587724553836,0.9572828278918631
13,36,2,51,0.2653061224489796,0.9607843137254902,0.1905445330361221,0.9615815770945145
6,53,2,61,0.1016949152542373,0.9672131147540983,0.1808965538966175,0.9611621286691937
8,122,45,175,0.06153846153846154,0.7428571428571429,0.1824848815353653,0.9334263099322503
12,87,108,207,0.12121212121212122,0.4782608695652174,0.14460609365657745,0.870796910346329
42,90,7,139,0.3181818181818182,0.9496402877697842,0.17079900187195757,0.8697470589831798
3,38,21,62,0.07317073170731707,0.6612903225806451,0.15268053497300288,0.8213599622089863
21,175,18,214,0.10714285714285714,0.9158878504672897,0.14974957535511316,0.8108477002456667
10,48,8,66,0.1724137931034483,0.8787878787878788,0.13647924259146582,0.799133923826008
2,11,1,14,0.15384615384615385,0.9285714285714286,0.14392941953316818,0.7936136829427695
45,31,6,82,0.5921052631578947,0.926829268292683,0.21972467690737293,0.8198954151478466
11,41,11,63,0.21153846153846154,0.8253968253968254,0.23262843981113582,0.8694862659809335
23,99,8,130,0.1885245901639344,0.9384615384615385,0.21410597866572384,0.8678893017940412
117,435,12,564,0.21195652173913043,0.9787234042553191,0.23393252009884005,0.9132368848904233
5,47,3,55,0.09615384615384616,0.9454545454545454,0.23236266138612421,0.9174606984600312
21,60,21,102,0.25925925925925924,0.7941176470588235,0.24476915655124004,0.9053649510701661
2,0,0,2,1.0,1.0,0.36564827743036094,0.9155690327028191
1,15,1,17,0.0625,0.9411764705882353,0.2899903826935188,0.9176186330307552
15,65,21,101,0.1875,0.7920792079207921,0.28655631675945287,0.9128589733913219
12,120,8,140,0.09090909090909091,0.9428571428571428,0.2726112454373324,0.9134869168764083
9,51,4,64,0.15,0.9375,0.2637603137603138,0.9075978591256485
2,22,6,30,0.08333333333333333,0.8,0.26192881192881196,0.8868186383464277
3,18,4,25,0.14285714285714285,0.84,0.24936895810955959,0.8943936683584324
35,75,4,114,0.3181818181818182,0.9649122807017544,0.1519663607069622,0.8893811370301116
36,58,8,102,0.3829787234042553,0.9215686274509803,0.19774903547899866,0.8865800165819324
24,57,24,105,0.2962962962962963,0.7714285714285715,0.21150564923561244,0.8836299256544722
92,276,31,399,0.25,0.9223057644110275,0.23433056867707322,0.8796736062846191
6,86,7,99,0.06521739130434782,0.9292929292929293,0.21983781505388483,0.8785011676121803
5,25,2,32,0.16666666666666666,0.9375,0.23174257695864675,0.8981440247550374
2,11,1,14,0.15384615384615385,0.9285714285714286,0.2333124356713626,0.9107970859795272
3,9,2,14,0.25,0.8571428571428571,0.22357217593110285,0.8954014540425419
23,221,16,260,0.0942622950819672,0.9384615384615385,0.1823269718850617,0.8978147270440503
42,86,24,152,0.328125,0.8421052631578947,0.18687392955701937,0.9079113972910965
2,10,18,30,0.16666666666666666,0.4,0.17496916765225748,0.8332962880895212
7,114,2,123,0.05785123966942149,0.983739837398374,0.1739168602758394,0.8410744178188703
4,43,3,50,0.0851063829787234,0.94,0.16226539117756178,0.8414315606760131
24,137,33,194,0.14906832298136646,0.8298969072164949,0.1615828439111636,0.8273352004824511
17,121,13,151,0.12318840579710146,0.9139072847682119,0.14346690188217812,0.8354444044289304
32,97,15,144,0.24806201550387597,0.8958333333333334,0.16543829051387934,0.829354660839187
5,104,4,113,0.045871559633027525,0.9646017699115044,0.1251163704614547,0.8468541618039883
44,143,30,217,0.23529411764705882,0.8617511520737328,0.13492029203008216,0.9128186121002358
5,96,1,102,0.04950495049504951,0.9901960784313726,0.1337279650051719,0.913740932247807
7,48,2,57,0.12727272727272726,0.9649122807017544,0.13975172847574385,0.9172998294909148
3,28,7,38,0.0967741935483871,0.8157894736842105,0.1322811385567468,0.9152844818434457
6,120,27,153,0.047619047619047616,0.8235294117647058,0.12148551595988197,0.902373357128659
22,90,18,130,0.19642857142857142,0.8615384615384616,0.11410930966340989,0.8974740897293917
50,66,23,139,0.43103448275862066,0.8345323741007195,0.1691325843956375,0.8788927474707081
33,62,7,102,0.3473684210526316,0.9313725490196079,0.18514319916786218,0.8888386613201187
10,55,2,67,0.15384615384615385,0.9701492537313433,0.2000490853608771,0.8859748292201146
6,111,10,127,0.05128205128205128,0.9212598425196851,0.1891932745050662,0.8797387666226761
17,26,5,48,0.3953488372093023,0.8958333333333334,0.2318467950280541,0.8911736037154079
13,77,5,95,0.14444444444444443,0.9473684210526315,0.24567899457453937,0.9088648907565402
6,24,0,30,0.2,1.0,0.24618919865617203,0.9286451105367599
12,82,1,95,0.1276595744680851,0.9894736842105263,0.20284992604323837,0.9507795834095896
13,36,2,51,0.2653061224489796,0.9607843137254902,0.19112674052843096,0.9549812640818585
5,54,2,61,0.0847457627118644,0.9672131147540983,0.1812552560806753,0.9545618156565377
8,122,45,175,0.06153846153846154,0.7428571428571429,0.18272045754587676,0.929075715704746
12,85,110,207,0.12371134020618557,0.46859903381642515,0.14391510083114584,0.8680422443451877
43,89,7,139,0.32575757575757575,0.9496402877697842,0.16981697673302174,0.8683667967333523
4,37,21,62,0.0975609756097561,0.6612903225806451,0.1551828303915583,0.8199796999591588
21,175,19,215,0.10714285714285714,0.9116279069767442,0.1522518707736686,0.8088588746400471
10,48,8,66,0.1724137931034483,0.8787878787878788,0.13898153801002125,0.7971450982203884
2,12,1,15,0.14285714285714285,0.9333333333333333,0.14728316374506104,0.7923051294459934
45,31,6,82,0.5921052631578947,0.926829268292683,0.22307842111926576,0.8185868616510704
11,41,11,63,0.21153846153846154,0.8253968253968254,0.2356251527381623,0.8695579747339848
21,103,6,130,0.1693548387096774,0.9538461538461539,0.21328190458846258,0.8701588127448947
115,436,13,564,0.20871143375680581,0.9769503546099291,0.22916054146661252,0.9152531030347925
5,47,3,55,0.09615384615384616,0.9454545454545454,0.22759068275389666,0.9200854799601927
21,60,21,102,0.25925925925925924,0.7941176470588235,0.2399971779190125,0.9079897325703277
2,0,0,2,1.0,1.0,0.36244615751084924,0.9175135420941372
1,15,1,17,0.0625,0.9411764705882353,0.28678826277400715,0.9195631424220733
16,63,22,101,0.20253164556962025,0.7821782178217822,0.28550157477845844,0.9133890556256384
14,121,5,140,0.1037037037037037,0.9642857142857143,0.2761228412061764,0.9148804214027185
11,49,4,64,0.18333333333333332,0.9375,0.27249739828853753,0.909244656458443
2,22,6,30,0.08333333333333333,0.8,0.2706658964570357,0.8884654356792222
3,18,4,25,0.14285714285714285,0.84,0.2496016827783745,0.8943936683584325
35,75,4,114,0.3181818181818182,0.9649122807017544,0.1521990853757771,0.8893811370301117
40,54,8,102,0.425531914893617,0.9215686274509803,0.20406078750343665,0.8865800165819324
24,58,24,106,0.2926829268292683,0.7735849056603774,0.21730120562190355,0.8839379734018732
91,278,31,400,0.24661246612466126,0.9225,0.24179041936473913,0.8800094019733017
6,88,7,101,0.06382978723404255,0.9306930693069307,0.22471848420769763,0.8790369833028632
5,25,2,32,0.16666666666666666,0.9375,0.23662324611245952,0.8986798404457204
2,11,1,14,0.15384615384615385,0.9285714285714286,0.2381931048251754,0.9113329016702102
3,9,2,14,0.25,0.8571428571428571,0.22845284508491565,0.895937269733225
24,218,18,260,0.09917355371900827,0.9307692307692308,0.1818302220599715,0.897251641635832
43,84,25,152,0.33858267716535434,0.8355263157894737,0.18838732925084095,0.9061004145114173
2,8,20,30,0.2,0.3333333333333333,0.1817284055187465,0.8219337478447505
6,115,2,123,0.049586776859504134,0.983739837398374,0.1796936897509553,0.8295118575720996
4,43,3,50,0.0851063829787234,0.94,0.1680422206526777,0.8298690004292425
22,137,35,194,0.13836477987421383,0.8195876288659794,0.1658305957995434,0.8142998861856068
17,121,13,151,0.12318840579710146,0.9139072847682119,0.1477146537705579,0.8224090901320861
32,98,15,145,0.24615384615384617,0.896551724137931,0.1687118384041062,0.8175208748990432
5,104,4,113,0.045871559633027525,0.9646017699115044,0.12689596447091664,0.8359602254879048
44,143,30,217,0.23529411764705882,0.8617511520737328,0.1319379812776393,0.9114484853079619
6,95,1,102,0.0594059405940594,0.9901960784313726,0.13334071895400434,0.912370805455533
7,48,2,57,0.12727272727272726,0.9649122807017544,0.13936448242457633,0.9159297026986408
3,28,7,38,0.0967741935483871,0.8157894736842105,0.13342297009231538,0.9153871091012452
7,122,24,153,0.05426356589147287,0.8431372549019608,0.1235765643915113,0.905277104834638
26,90,14,130,0.22413793103448276,0.8923076923076924,0.12043143366017366,0.9046708145731753
48,68,23,139,0.41379310344827586,0.8345323741007195,0.17299165420520915,0.8860894723144918
35,60,7,102,0.3684210526315789,0.9313725490196079,0.1920097877744263,0.8960353861639024
10,55,2,67,0.15384615384615385,0.9701492537313433,0.20550124681043977,0.8931715540638984
18,95,14,127,0.1592920353982301,0.889763779527559,0.2100754336855116,0.8824360538961561
16,28,4,48,0.36363636363636365,0.9166666666666666,0.24819860084093687,0.8968470814650784
13,78,4,95,0.14285714285714285,0.9578947368421052,0.2608548261217468,0.9132410074565277
6,24,0,30,0.2,1.0,0.2574065502596779,0.928625622841143
12,82,1,95,0.1276595744680851,0.9894736842105263,0.21653033183393636,0.9507600957139726
14,35,2,51,0.2857142857142857,0.9607843137254902,0.20471507941718015,0.9549617763862414
4,55,2,61,0.06779661016949153,0.9672131147540983,0.19242228746337126,0.9545423279609208
8,122,45,175,0.06153846153846154,0.7428571428571429,0.17845749119769003,0.9335556655794327
14,104,91,209,0.11864406779661017,0.5645933014354066,0.14345859179201098,0.8832594705463956
42,91,6,139,0.3157894736842105,0.9568345323741008,0.16816321048159205,0.883108012765252
4,38,20,62,0.09523809523809523,0.6774193548387096,0.15319722408703423,0.8370250634564963
22,175,19,216,0.1116751269035533,0.9120370370370371,0.15091373157781543,0.825962685288855
9,49,8,66,0.15517241379310345,0.8787878787878788,0.13226489273193223,0.8142489088691962
2,12,1,15,0.14285714285714285,0.9333333333333333,0.14298782597302528,0.8094089400948012
45,31,6,82,0.5921052631578947,0.926829268292683,0.21878308334722998,0.8356906722998785
11,41,11,63,0.21153846153846154,0.8253968253968254,0.23205371102463737,0.8729483185800812
24,99,7,130,0.1951219512195122,0.9461538461538461,0.21481549352968043,0.8714225062629019
112,439,13,564,0.20326678765880218,0.9769503546099291,0.2302481638754957,0.9142126490873617
5,48,3,56,0.09433962264150944,0.9464285714285714,0.2277716632666323,0.9191257254290095
22,59,20,101,0.2716049382716049,0.801980198019802,0.24440488104927538,0.9081531996049986
2,0,0,2,1.0,1.0,0.36685386064111214,0.9176770091288081
1,15,1,17,0.0625,0.9411764705882353,0.29119596590427005,0.9197266094567442
16,64,21,101,0.2,0.7920792079207921,0.2895476142559184,0.9149669498173107
12,121,7,140,0.09022556390977443,0.95,0.274562416068813,0.9155164003667614
10,50,4,64,0.16666666666666666,0.9375,0.26933382735565076,0.9098806354224858
2,22,6,30,0.08333333333333333,0.8,0.2677615003116256,0.888962268075547
3,18,4,25,0.14285714285714285,0.84,0.24383889919604204,0.8943422808969731
35,72,7,114,0.32710280373831774,0.9385964912280702,0.147710728301516,0.8855703510724116
38,56,8,102,0.40425531914893614,0.9215686274509803,0.19653291675136403,0.8827692306242324
24,57,25,106,0.2962962962962963,0.7641509433962265,0.21028953050797775,0.8787794785492944
91,278,31,400,0.24661246612466126,0.9225,0.23577962307124103,0.8749022945821824
7,87,7,101,0.07446808510638298,0.9306930693069307,0.22498934951501007,0.8739298759117439
5,25,2,32,0.16666666666666666,0.9375,0.23689411141977196,0.893572733054601
2,11,1,14,0.15384615384615385,0.9285714285714286,0.23846397013248782,0.9062257942790909
3,9,2,14,0.25,0.8571428571428571,0.2274492838841567,0.8945895608383462
24,210,26,260,0.10256410256410256,0.9,0.18435053865775192,0.891508328345349
43,85,24,152,0.3359375,0.8421052631578947,0.19001356775828102,0.902644659739873
2,14,14,30,0.125,0.5333333333333333,0.1726403583119008,0.8470494216446349
8,113,2,123,0.06611570247933884,0.983739837398374,0.1714471607937517,0.8546275313719839
4,43,3,50,0.0851063829787234,0.94,0.15979569169547406,0.8549846742291267
19,138,37,194,0.12101910828025478,0.8092783505154639,0.15510611375748848,0.8379428059354176
17,121,13,151,0.12318840579710146,0.9139072847682119,0.13699017172850297,0.8460520098818967
31,99,15,145,0.23846153846153847,0.896551724137931,0.1564040911424224,0.8455593990444584
6,102,5,113,0.05555555555555555,0.9557522123893806,0.1163495276503589,0.8617946775060992
44,143,30,217,0.23529411764705882,0.8617511520737328,0.1321058301713673,0.9087115087547277
5,87,1,93,0.05434782608695652,0.989247311827957,0.13042470497245554,0.9094982908160967
8,46,2,56,0.14814814814814814,0.9642857142857143,0.1394306714252305,0.9129676785711988
3,28,7,38,0.0967741935483871,0.8157894736842105,0.13596711217782084,0.9138978390238768
6,123,24,153,0.046511627906976744,0.8431372549019608,0.12501328676494589,0.9037878347572695
26,84,20,130,0.23636363636363636,0.8461538461538461,0.12471358646524557,0.8965881379024002
50,64,25,139,0.43859649122807015,0.8201438848920863,0.17943372013274766,0.877215519688501
34,61,7,102,0.35789473684210527,0.9313725490196079,0.19694809430346855,0.8871614335379119
9,55,3,67,0.140625,0.9552238805970149,0.20927340486247475,0.882300943362063
7,33,87,127,0.175,0.31496062992125984,0.21310938369845364,0.7895402170242837
15,29,4,48,0.3409090909090909,0.9166666666666666,0.24798579760712558,0.803951244593206
15,75,4,94,0.16666666666666666,0.9574468085106383,0.2651508031442241,0.8202811808230172
6,24,0,30,0.2,1.0,0.2599559979494189,0.842259202801039
10,68,1,79,0.1282051282051282,0.9873417721518988,0.21561437466042724,0.8661446152667265
14,35,2,51,0.2857142857142857,0.9607843137254902,0.20530288164216734,0.8703462959389955
6,52,3,61,0.10344827586206896,0.9508196721311475,0.1999919210510343,0.8697171233010145
8,122,45,175,0.06153846153846154,0.7428571428571429,0.18378312984224313,0.9308451965775691
13,104,92,209,0.1111111111111111,0.5598086124401914,0.15095484701396028,0.8798654745452156
42,91,6,139,0.3157894736842105,0.9568345323741008,0.1722581051593237,0.87977800652571
5,37,21,63,0.11904761904761904,0.6666666666666666,0.16069347930898356,0.8321589589066625
21,176,19,216,0.1065989847715736,0.9120370370370371,0.15760688738990433,0.8214011396045394
9,48,8,65,0.15789473684210525,0.8769230769230769,0.13934695183673568,0.8094209629184803
2,12,1,15,0.14285714285714285,0.9333333333333333,0.1449767899788891,0.8069229145187926
45,31,6,82,0.5921052631578947,0.926829268292683,0.22077204735309383,0.8332046467238697
11,41,11,63,0.21153846153846154,0.8253968253968254,0.23511881169985815,0.8711458200033889
23,100,6,129,0.18699186991869918,0.9534883720930233,0.21671915401907085,0.8706677971060922
113,438,13,564,0.20508166969147004,0.9769503546099291,0.22900973268247812,0.9149940382408438
5,48,3,56,0.09433962264150944,0.9464285714285714,0.22725839523532612,0.9199071145824919
22,56,23,101,0.28205128205128205,0.7722772277227723,0.2449950445509228,0.9049577075538767
2,0,0,2,1.0,1.0,0.36744402414275956,0.9144815170776862
1,15,1,17,0.0625,0.9411764705882353,0.29178612940591747,0.9165311174056223
16,64,21,101,0.2,0.7920792079207921,0.29013777775756583,0.9117714577661891
10,123,7,140,0.07518796992481203,0.95,0.2741657920441533,0.911273118895757
11,49,4,64,0.18333333333333332,0.9375,0.2710588868501338,0.9056373539514814
2,22,6,30,0.08333333333333333,0.8,0.26948655980610864,0.8847189866045427
3,17,4,24,0.15,0.8333333333333334,0.2520221162971646,0.8932907041428942
37,72,5,114,0.3394495412844037,0.956140350877193,0.1576577650520794,0.8870250399824933
39,54,9,102,0.41935483870967744,0.9117647058823529,0.20863702772489048,0.8828233593102244
24,58,24,106,0.2926829268292683,0.7735849056603774,0.2200917315576431,0.8801813161301651
91,278,30,399,0.24661246612466126,0.924812030075188,0.24350683144440996,0.8756066729446061
6,87,7,100,0.06451612903225806,0.93,0.2285103462456284,0.8746769677291866
5,25,2,32,0.16666666666666666,0.9375,0.23989750980670502,0.8953050465469207
2,11,1,14,0.15384615384615385,0.9285714285714286,0.2404469603561556,0.9089104887237914
3,9,2,14,0.25,0.8571428571428571,0.2276684544583836,0.8947679896188863
23,210,27,260,0.09871244635193133,0.8961538461538462,0.18186239840727705,0.8925378668005282
43,85,24,152,0.3359375,0.8421052631578947,0.188041623145953,0.9023264893001735
3,14,13,30,0.17647058823529413,0.5666666666666667,0.1780213548760434,0.851162865956099
8,113,2,123,0.06611570247933884,0.983739837398374,0.1782498653684835,0.8588399855844381
4,43,3,50,0.0851063829787234,0.94,0.16659839627020592,0.859197128441581
21,135,36,192,0.1346153846153846,0.8125,0.16385114352295313,0.8426154957885198
17,121,13,151,0.12318840579710146,0.9139072847682119,0.14573520149396765,0.8507246997349991
30,98,16,144,0.234375,0.8888888888888888,0.1651155663008346,0.8496868486971481
4,104,5,113,0.037037037037037035,0.9557522123893806,0.12241550016326845,0.8659221271587888
45,142,30,217,0.24064171122994651,0.8617511520737328,0.1315828034482188,0.9080770536455126
6,80,1,87,0.06976744186046512,0.9885057471264368,0.1321044805026654,0.9087578978923786
7,47,1,55,0.12962962962962962,0.9818181818181818,0.13846494430993772,0.9147319238664047
3,28,7,38,0.0967741935483871,0.8157894736842105,0.13305905987179523,0.9152018486784347
6,121,26,153,0.047244094488188976,0.8300653594771242,0.12220987254195059,0.9032244307797078
23,88,19,130,0.2072072072072072,0.8538461538461538,0.11832875928583733,0.8982183257736028
50,64,25,139,0.43859649122807015,0.8201438848920863,0.1756943955988421,0.8788457075597037
34,61,7,102,0.35789473684210527,0.9313725490196079,0.19244482782915046,0.8887916214091145
10,54,3,67,0.15625,0.9552238805970149,0.20479947899194118,0.8840370690477685
15,98,14,127,0.13274336283185842,0.889763779527559,0.20524429802083097,0.870886440149108
16,28,4,48,0.36363636363636365,0.9166666666666666,0.24336746517625624,0.8852974677180303
15,75,4,94,0.16666666666666666,0.9574468085106383,0.2604278326303245,0.903494817579961
6,24,0,30,0.2,1.0,0.2593982316007234,0.9243739384590819
9,69,1,79,0.11538461538461539,0.9873417721518988,0.21322510648022988,0.9482593509247694
15,34,2,51,0.30612244897959184,0.9607843137254902,0.20582906535701367,0.9524610315970382
7,50,3,60,0.12280701754385964,0.95,0.2010514964347079,0.9517147629403218
8,122,45,175,0.06153846153846154,0.7428571428571429,0.19087936767850835,0.9307281005588337
13,101,95,209,0.11403508771929824,0.5454545454545454,0.15522204254749902,0.8776977975285308
41,92,6,139,0.3082706766917293,0.9568345323741008,0.17545118683679367,0.8776103295090254
6,36,21,63,0.14285714285714285,0.6666666666666666,0.16728792153067124,0.8299912818899777
21,176,19,216,0.1065989847715736,0.9120370370370371,0.16603283144309383,0.8192334625878547
9,48,8,65,0.15789473684210525,0.8769230769230769,0.14485744399488146,0.8072532859017956
2,12,1,15,0.14285714285714285,0.9333333333333333,0.14772174761106477,0.8048723335208433
45,31,6,82,0.5921052631578947,0.926829268292683,0.2235170049852695,0.8311540657259203
11,39,13,63,0.22,0.7936507936507936,0.23865484959679834,0.8666106726110987
23,99,7,129,0.1885245901639344,0.9457364341085271,0.22154826580711334,0.865025230001731
119,431,13,563,0.21636363636363637,0.9769094138543517,0.23204919345089814,0.9093456224571147
5,48,3,56,0.09433962264150944,0.9464285714285714,0.2302978560037461,0.9142586987987624
21,55,24,100,0.27631578947368424,0.76,0.24721514923682883,0.8975554020954657
2,0,0,2,1.0,1.0,0.36966412882866556,0.9070792116192753
1,15,1,17,0.0625,0.9411764705882353,0.2940062340918234,0.9091288119472113
16,64,21,101,0.2,0.7920792079207921,0.29114909123468063,0.9089042997000681
9,123,7,139,0.06818181818181818,0.9496402877697842,0.2739572666658069,0.9094619930802478
9,51,4,64,0.15,0.9375,0.2644767471852874,0.9038320768153404
2,22,6,30,0.08333333333333333,0.8,0.2629044201412622,0.8829137094684016
3,17,4,24,0.15,0.8333333333333334,0.2444010454050984,0.8922629549137061
34,71,8,113,0.3238095238095238,0.9292035398230089,0.14780240594931612,0.8821491748884217
39,54,9,102,0.41935483870967744,0.9117647058823529,0.19878166862212718,0.8779474942161529
23,57,26,106,0.2875,0.7547169811320755,0.2112816686221272,0.8726100332463361
91,278,29,398,0.24661246612466126,0.9271356783919598,0.23568951010313938,0.869395089049504
7,87,7,101,0.07446808510638298,0.9306930693069307,0.22695734792705366,0.8685643937350748
5,25,2,32,0.16666666666666666,0.9375,0.23834451148813027,0.8891924725528088
2,11,1,14,0.15384615384615385,0.9285714285714286,0.23889396203758081,0.9027979147296794
3,9,2,14,0.25,0.8571428571428571,0.228349744350506,0.8925035314896578
24,209,27,260,0.10300429184549356,0.8961538461538462,0.183156809084194,0.8902734086712997
41,84,25,150,0.328,0.8333333333333334,0.1889425233699083,0.9015043161286221
3,13,14,30,0.1875,0.5333333333333333,0.18049788535209954,0.8452468382631041
8,113,2,123,0.06611570247933884,0.983739837398374,0.1793046878339504,0.8528249479904532
4,43,3,50,0.0851063829787234,0.94,0.16765321873567277,0.8531820908475961
21,135,36,192,0.1346153846153846,0.8125,0.16490596598842,0.8366004581945348
16,123,13,152,0.11510791366906475,0.9144736842105263,0.14563566794114355,0.8447905763470589
32,97,16,145,0.24806201550387597,0.8896551724137931,0.16635819989234105,0.8438621943841943
4,104,5,113,0.037037037037037035,0.9557522123893806,0.12479206232620348,0.8613506056779153
44,142,31,217,0.23655913978494625,0.8571428571428571,0.13180051086691008,0.9076091090792759
6,80,1,87,0.06976744186046512,0.9885057471264368,0.1323221879213567,0.9082899533261418
7,47,2,56,0.12962962962962962,0.9642857142857143,0.138682651728629,0.911759341081244
3,28,7,38,0.0967741935483871,0.8157894736842105,0.13327676729048651,0.9122292658932741
7,119,27,153,0.05555555555555555,0.8235294117647058,0.12476928755998519,0.8992372269724426
22,88,20,130,0.2,0.8461538461538461,0.11790328534514576,0.8930227517924502
49,65,25,139,0.4298245614035088,0.8201438848920863,0.1740157888260703,0.8736501335785508
34,61,7,102,0.35789473684210527,0.9313725490196079,0.1913494455485216,0.8842543752752297
10,54,3,67,0.15625,0.9552238805970149,0.20370409671131232,0.8794998229138836
6,30,91,127,0.16666666666666666,0.28346456692913385,0.20899510200231758,0.7822396590058006
17,27,4,48,0.38636363636363635,0.9166666666666666,0.25036502240449604,0.796650686574723
15,75,4,94,0.16666666666666666,0.9574468085106383,0.2662380382775119,0.8157817432527132
6,24,0,30,0.2,1.0,0.2662380382775119,0.8377597652307353
9,69,1,79,0.11538461538461539,0.9873417721518988,0.2213180459890986,0.8616451776964229
13,36,2,51,0.2653061224489796,0.9607843137254902,0.20809110107579493,0.8658468583686919
5,49,6,60,0.09259259259259259,0.9,0.19899718573187958,0.8579577325691182
8,122,45,175,0.06153846153846154,0.7428571428571429,0.18397887071356456,0.9235852434159766
13,104,93,210,0.1111111111111111,0.5571428571428572,0.14465708139177522,0.8722246991982896
41,92,6,139,0.3082706766917293,0.9568345323741008,0.16488622568106992,0.8721372311787842
4,38,21,63,0.09523809523809523,0.6666666666666666,0.14992023928651207,0.8245181835597366
21,175,19,215,0.10714285714285714,0.9116279069767442,0.14874284525197518,0.813701917106143
10,47,8,65,0.17543859649122806,0.8769230769230769,0.13590462725801067,0.801721740420084
2,12,1,15,0.14285714285714285,0.9333333333333333,0.1430852772958036,0.8064836451819889
44,32,6,82,0.5789473684210527,0.926829268292683,0.217000835421888,0.8327653773870659
8,39,14,61,0.1702127659574468,0.7704918032786885,0.22544392897136453,0.8632437982636133
25,98,6,129,0.2032520325203252,0.9534883720930233,0.2104412655183068,0.8627657753663165
118,431,14,563,0.21493624772313297,0.9751332149200711,0.2275410015875979,0.9068324251168028
5,48,3,56,0.09433962264150944,0.9464285714285714,0.22571196808740537,0.911803948609921
21,55,24,100,0.27631578947368424,0.76,0.24012299565632772,0.8951006519066244
2,0,0,2,1.0,1.0,0.3625719752481644,0.9046244614304338
1,15,1,17,0.0625,0.9411764705882353,0.2887937797594426,0.9066740617583698
17,63,21,101,0.2125,0.7920792079207921,0.2948348131940931,0.9097579767072419
11,122,6,139,0.08270676691729323,0.9568345323741008,0.2776140609650885,0.9102359996045386
10,49,4,63,0.1694915254237288,0.9365079365079365,0.27112195777945935,0.9047181026885193
2,21,6,29,0.08695652173913043,0.7931034482758621,0.2700672290791195,0.8828145136667037
4,14,6,24,0.2222222222222222,0.75,0.25410591856417003,0.8804619855053574
37,72,5,114,0.3394495412844037,0.956140350877193,0.1597415673190849,0.8741963213449563
40,53,9,102,0.43010752688172044,0.9117647058823529,0.2122569283021878,0.8699946406726874
23,58,25,106,0.2839506172839506,0.7641509433962265,0.22603558791418074,0.8648733468721482
89,278,31,398,0.24250681198910082,0.9221105527638191,0.24868378024850157,0.86196827681477
7,87,7,101,0.07446808510638298,0.9306930693069307,0.23995161807241586,0.8611375815003406
5,24,2,31,0.1724137931034483,0.9354838709677419,0.2521597996958898,0.8814776418848947
2,11,1,14,0.15384615384615385,0.9285714285714286,0.24239178992788007,0.9069878459665274
3,9,2,14,0.25,0.8571428571428571,0.22961328403010814,0.8928453468616224
25,208,27,260,0.1072961373390558,0.8961538461538462,0.18349737123829887,0.8906152240432642
38,86,25,149,0.3064516129032258,0.8322147651006712,0.1867117991839096,0.9003386271438991
3,13,14,30,0.1875,0.5333333333333333,0.17885368318546663,0.8447990243681155
6,115,2,123,0.049586776859504134,0.983739837398374,0.17529921057876965,0.8523771340954646
4,43,3,50,0.0851063829787234,0.94,0.16282672341809468,0.8530222953857871
20,136,38,194,0.1282051282051282,0.8041237113402062,0.15916371975509103,0.8352440500670409
16,123,13,152,0.11510791366906475,0.9144736842105263,0.13989342170781455,0.8434341682195653
31,98,16,145,0.24031007751937986,0.8896551724137931,0.15889541316214656,0.8425057862567005
5,103,5,113,0.046296296296296294,0.9557522123893806,0.1217303679325852,0.8601539930122304
44,143,30,217,0.23529411764705882,0.8617511520737328,0.1285580990250222,0.9070708242608588
6,80,1,87,0.06976744186046512,0.9885057471264368,0.1314410511680166,0.907751668507725
7,46,2,55,0.1320754716981132,0.9636363636363636,0.13815092098507228,0.9111282918843484
4,27,7,38,0.12903225806451613,0.8157894736842105,0.1382690823935563,0.9127948293620634
6,122,25,153,0.046875,0.8366013071895425,0.1285215232979756,0.9016702040733513
22,79,29,130,0.21782178217821782,0.7769230769230769,0.12530890967780958,0.885565619003249
46,67,26,139,0.40707964601769914,0.8129496402877698,0.17684938820943857,0.8651652515601619
34,60,7,101,0.3617021276595745,0.9306930693069307,0.19490767535408368,0.8750140968791901
10,53,4,67,0.15873015873015872,0.9402985074626866,0.20761663490689705,0.8681273483557971
16,103,8,127,0.13445378151260504,0.937007874015748,0.20795639345182446,0.864323278409995
17,27,4,48,0.38636363636363635,0.9166666666666666,0.24471801892312733,0.8787343059789173
16,72,5,93,0.18181818181818182,0.946236559139785,0.26399561632572477,0.8943964848289518
5,25,0,30,0.16666666666666666,1.0,0.2566877426812174,0.9262646166970837
11,81,1,93,0.11956521739130435,0.989247311827957,0.21561425287744673,0.951449998345682
13,36,2,51,0.2653061224489796,0.9607843137254902,0.20184339499021892,0.9557487475483334
5,51,4,60,0.08928571428571429,0.9333333333333333,0.191922760069584,0.9547537226727113
8,122,46,176,0.06153846153846154,0.7386363636363636,0.1815062857875635,0.9264149354756565
13,107,91,211,0.10833333333333334,0.5687203791469194,0.14178767106894877,0.8767083229728355
43,88,6,137,0.3282442748091603,0.9562043795620438,0.16270568435337426,0.8781322973188724
3,38,22,63,0.07317073170731707,0.6507936507936508,0.14934912221632432,0.8282456760036797
22,174,18,214,0.11224489795918367,0.9158878504672897,0.14830336229744995,0.8177657529521559
11,46,8,65,0.19298245614035087,0.8769230769230769,0.13797140996764584,0.8057855762660967
2,12,1,15,0.14285714285714285,0.9333333333333333,0.14562447119213565,0.8057855762660967
43,33,6,82,0.5657894736842105,0.926829268292683,0.2176603300700998,0.8326702769312853
8,39,14,61,0.1702127659574468,0.7704918032786885,0.22650024901640167,0.8614947660929665
24,99,6,129,0.1951219512195122,0.9534883720930233,0.20748277421788056,0.8611067650259636
116,426,15,557,0.2140221402214022,0.9730700179533214,0.22760440400560697,0.9071462460487737
5,47,3,55,0.09615384615384616,0.9454545454545454,0.22530568231913017,0.9113700596183817
20,56,24,100,0.2631578947368421,0.76,0.2353307449757718,0.8946667629150848
2,0,0,2,1.0,1.0,0.35777972456760854,0.9041905724388944
1,15,1,17,0.0625,0.9411764705882353,0.285881228327007,0.9062401727668306
16,64,21,101,0.2,0.7920792079207921,0.2901365474759432,0.9093240877157024
10,122,7,139,0.07575757575757576,0.9496402877697842,0.2730844938385237,0.9087743613838112
8,51,4,63,0.13559322033898305,0.9365079365079365,0.26188036242674956,0.9035512068916134
2,21,6,29,0.08695652173913043,0.7931034482758621,0.26056645893893304,0.8817867644375158
4,13,7,24,0.23529411764705882,0.7083333333333334,0.2615111489532162,0.8745096045529764
34,76,4,114,0.3090909090909091,0.9649122807017544,0.1628098502519175,0.8694970732246555
37,56,9,102,0.3978494623655914,0.9117647058823529,0.21071691630414482,0.8652953925523867
23,54,29,106,0.2987012987012987,0.7264150943396226,0.22481710183290177,0.8547832631723328
89,276,31,396,0.24383561643835616,0.9217171717171717,0.24874563591515328,0.8518219958225762
7,85,8,100,0.07608695652173914,0.92,0.2354021260720119,0.8494637191785852
5,24,2,31,0.1724137931034483,0.9354838709677419,0.2476103076954859,0.8698037795631395
2,11,1,14,0.15384615384615385,0.9285714285714286,0.23597488429535662,0.9012663645971531
3,9,2,14,0.25,0.8571428571428571,0.22753332585379818,0.8858707326601678
26,206,26,258,0.11206896551724138,0.8992248062015504,0.1867075405897482,0.8840793184200532
37,85,25,147,0.30327868852459017,0.8299319727891157,0.18736145342164698,0.8988674439128379
2,9,19,30,0.18181818181818182,0.36666666666666664,0.17850181990447922,0.8195745146199087
6,115,2,123,0.049586776859504134,0.983739837398374,0.17471607995273133,0.8286802056768191
4,43,3,50,0.0851063829787234,0.94,0.16224359279205638,0.8293253669671417
20,137,38,195,0.12738853503184713,0.8051282051282052,0.1584639329614411,0.811690620760967
17,122,12,151,0.1223021582733813,0.9205298013245033,0.14022138414335272,0.820745898501202
32,95,18,145,0.25196850393700787,0.8758620689655172,0.16020703248903365,0.8174083646103403
4,103,5,112,0.037383177570093455,0.9553571428571429,0.12222195949553413,0.8353262460486299
44,143,30,217,0.23529411764705882,0.8617511520737328,0.12986137889965943,0.9060526011067821
6,80,1,87,0.06976744186046512,0.9885057471264368,0.13274433104265385,0.9067334453536483
7,46,2,55,0.1320754716981132,0.9636363636363636,0.13945420085970953,0.9101100687302717
3,28,7,38,0.0967741935483871,0.8157894736842105,0.13508072350492953,0.9116331070954153
6,122,25,153,0.046875,0.8366013071895425,0.12430541518016076,0.8996433222189922
22,78,30,130,0.22,0.7692307692307693,0.11973848604630251,0.8844102793997426
43,66,30,139,0.3944954128440367,0.7841726618705036,0.1707545196568658,0.8599553535445084
34,61,7,102,0.35789473684210527,0.9313725490196079,0.18826889382758674,0.869901267393919
8,54,5,67,0.12903225806451613,0.9253731343283582,0.19673529614245117,0.8608823227084794
6,30,91,127,0.16666666666666666,0.28346456692913385,0.20167689542367312,0.763714923178875
15,29,4,48,0.3409090909090909,0.9166666666666666,0.23655330933234506,0.7781259507477973
15,73,6,94,0.17045454545454544,0.9361702127659575,0.2542075301115658,0.7923500801158567
6,24,0,30,0.2,1.0,0.251350387254423,0.8253171130828897
10,82,1,93,0.10869565217391304,0.989247311827957,0.21052185001583387,0.8546134916482401
13,36,2,51,0.2653061224489796,0.9607843137254902,0.19729490510253025,0.858815172320509
6,50,5,61,0.10714285714285714,0.9180327868852459,0.19416784782800753,0.8577665512572074
8,120,46,174,0.0625,0.735632183908046,0.17928689544705514,0.9223619251113375
12,90,108,210,0.11764705882352941,0.4857142857142857,0.14739231943483208,0.8607972992609975
41,90,6,137,0.31297709923664124,0.9562043795620438,0.16775268426084575,0.8636593230890098
3,38,22,63,0.07317073170731707,0.6507936507936508,0.14963421736189103,0.8137727017738171
22,172,19,213,0.1134020618556701,0.9107981220657277,0.15030656160214204,0.8025656746649271
10,47,8,65,0.17543859649122806,0.8769230769230769,0.13746834360817756,0.7905854979788681
2,11,1,14,0.15384615384615385,0.9285714285714286,0.14414024313721993,0.7920910182197514
44,32,6,82,0.5789473684210527,0.926829268292683,0.21791843862594176,0.8194048874175567
8,39,14,61,0.1702127659574468,0.7704918032786885,0.2254278253593585,0.860087389926757
22,102,6,130,0.1774193548387097,0.9538461538461539,0.20606243330251117,0.8597505005387728
112,433,14,559,0.20550458715596331,0.9749552772808586,0.22496726979517492,0.9060593043226596
4,48,3,55,0.07692307692307693,0.9454545454545454,0.21975598623337586,0.9110102219496335
19,57,24,100,0.25,0.76,0.2304076153060576,0.8943069252463368
2,0,0,2,1.0,1.0,0.35128673618517847,0.9045110068789899
1,15,1,17,0.0625,0.9411764705882353,0.27750854069645664,0.906560607206926
15,65,20,100,0.1875,0.8,0.27997814555967854,0.910776063881399
11,120,8,139,0.08396946564885496,0.9424460431654677,0.2666281613896993,0.9091474766413009
8,51,4,63,0.13559322033898305,0.9365079365079365,0.2566408232729878,0.9036549993880263
2,21,6,29,0.08695652173913043,0.7931034482758621,0.25807417253242404,0.8818905569339287
3,14,7,24,0.17647058823529413,0.7083333333333334,0.25182342571442135,0.8712142816276431
35,75,4,114,0.3181818181818182,0.9649122807017544,0.15442082831182397,0.8662017502993223
37,56,9,102,0.3978494623655914,0.9117647058823529,0.20232789436405132,0.8620000696270534
23,61,22,106,0.27380952380952384,0.7924528301886793,0.2146578263368404,0.8609219025111505
91,275,29,395,0.24863387978142076,0.9265822784810127,0.23918794103088953,0.8596833996425592
6,86,8,100,0.06521739130434782,0.92,0.22387416934530374,0.8595926966947135
5,25,2,32,0.16666666666666666,0.9375,0.23526133290638038,0.8802207755124475
2,11,1,14,0.15384615384615385,0.9285714285714286,0.2320292708507889,0.911683360546461
3,9,2,14,0.25,0.8571428571428571,0.22228901111052915,0.8962877286094757
28,206,26,260,0.11965811965811966,0.9,0.18254739072374745,0.8946070563405683
36,87,26,149,0.2926829268292683,0.825503355704698,0.18524359115513955,0.8993285599857137
2,11,17,30,0.15384615384615385,0.43333333333333335,0.17170248745010142,0.8288644249646168
6,115,2,123,0.049586776859504134,0.983739837398374,0.16946954252940946,0.8379701160215272
4,43,3,50,0.0851063829787234,0.94,0.15781807343113186,0.8383272588786701
21,137,37,195,0.13291139240506328,0.8102564102564103,0.15482739322526176,0.8214251134050962
16,123,12,151,0.11510791366906475,0.9205298013245033,0.1355570951779853,0.8304803911453311
33,93,19,145,0.2619047619047619,0.8689655172413793,0.1558780440703628,0.8260468936083855
4,103,5,112,0.037383177570093455,0.9553571428571429,0.11940665131905207,0.8445974346301633
45,142,30,217,0.24064171122994651,0.8617511520737328,0.13180601665959388,0.905799980164506
6,80,1,87,0.06976744186046512,0.9885057471264368,0.13468896880258832,0.9064808244113721
7,46,2,55,0.1320754716981132,0.9636363636363636,0.141398838619644,0.9098574477879956
3,28,6,37,0.0967741935483871,0.8378378378378378,0.13623638164011884,0.9137976517281995
5,123,25,153,0.0390625,0.8366013071895425,0.12537275111596674,0.9018078668517765
22,77,31,130,0.2222222222222222,0.7615384615384615,0.11970381687560393,0.8864611446085026
43,66,30,139,0.3944954128440367,0.7841726618705036,0.17071985048616725,0.8620062187532683
33,62,7,102,0.3473684210526316,0.9313725490196079,0.1859665233179794,0.871952132602679
10,54,3,67,0.15625,0.9552238805970149,0.19832117448077008,0.8671975802413331
6,31,90,127,0.16216216216216217,0.29133858267716534,0.2026192731184914,0.7711550401043048
15,29,4,48,0.3409090909090909,0.9166666666666666,0.23749568702716334,0.782416301365566
13,78,4,95,0.14285714285714285,0.9578947368421052,0.2523234931496123,0.7997439341730751
6,24,0,30,0.2,1.0,0.24914888997500917,0.8338098682390092
10,82,1,93,0.10869565217391304,0.989247311827957,0.20832035273642005,0.8631062468043595
13,35,2,50,0.2708333333333333,0.96,0.1973867687765203,0.8671958826587013
7,51,3,61,0.1206896551724138,0.9508196721311475,0.19230671951543657,0.8665667100207203
8,119,47,174,0.06299212598425197,0.7298850574712644,0.17813957149002077,0.9292162064198772
12,89,109,210,0.1188118811881188,0.48095238095238096,0.14641139867273908,0.8669713084606936
41,90,6,137,0.31297709923664124,0.9562043795620438,0.170714249584096,0.8667298288492562
2,39,22,63,0.04878048780487805,0.6507936507936508,0.14911146212765,0.8168432075340635
23,171,19,213,0.11855670103092783,0.9107981220657277,0.1505201833929378,0.8056361804251735
10,47,8,65,0.17543859649122806,0.8769230769230769,0.13689236384406564,0.7937680485570417
2,11,1,14,0.15384615384615385,0.9285714285714286,0.1416290065117428,0.7905897280485105
44,32,6,82,0.5789473684210527,0.926829268292683,0.21533689828842859,0.8187246153087131
8,39,14,61,0.1702127659574468,0.7704918032786885,0.22267988182690404,0.860087389926757
23,99,8,130,0.1885245901639344,0.9384615384615385,0.2049009519593745,0.8575526983409706
113,432,15,560,0.20733944954128442,0.9732142857142857,0.22755223220743254,0.9036127890439183
4,50,3,57,0.07407407407407407,0.9473684210526315,0.22119757121359632,0.9088371174706189
20,56,24,100,0.2631578947368421,0.76,0.2337288995343983,0.8921338207673222
2,0,0,2,1.0,1.0,0.3546080204135192,0.9023379023999752
1,15,1,17,0.0625,0.9411764705882353,0.2808298249247974,0.9043875027279114
16,64,20,100,0.2,0.8,0.28508514407373353,0.9086029594023843
10,121,8,139,0.07633587786259542,0.9424460431654677,0.26905818517354224,0.9091721743600887
10,49,4,63,0.1694915254237288,0.9365079365079365,0.2636513388710343,0.9039284101877529
2,21,6,29,0.08695652173913043,0.7931034482758621,0.2654916885374709,0.8818905569339288
4,14,6,24,0.2222222222222222,0.75,0.25798122542760715,0.8753372689520694
35,73,6,114,0.32407407407407407,0.9473684210526315,0.1614203788667606,0.8678184719595882
40,53,9,102,0.43010752688172044,0.9117647058823529,0.21393573984986353,0.8636167912873193
23,60,23,106,0.27710843373493976,0.7830188679245284,0.22238712781932382,0.8640480581336804
90,277,29,396,0.2452316076294278,0.9267676767676768,0.248696114296374,0.8618082915054247
6,86,10,102,0.06521739130434782,0.9019607843137255,0.23584539679798033,0.8591405577452538
5,25,2,32,0.16666666666666666,0.9375,0.24723256035905697,0.8797686365629878
2,10,2,14,0.16666666666666666,0.8571428571428571,0.23929605242254898,0.8950747590119674
3,9,2,14,0.25,0.8571428571428571,0.22871404184053842,0.8821853927391424
27,203,30,260,0.11739130434782609,0.8846153846153846,0.1840402957642678,0.8783069182724328
38,87,25,150,0.304,0.8333333333333334,0.1878819480878478,0.8854946990451191
3,8,19,30,0.2727272727272727,0.36666666666666664,0.19180990024468283,0.8054802690306891
6,115,2,123,0.049586776859504134,0.983739837398374,0.18957695532399085,0.8171629908999246
4,43,2,49,0.0851063829787234,0.9591836734693877,0.17792548622571322,0.8202606585384086
21,137,37,195,0.13291139240506328,0.8102564102564103,0.17310330418834136,0.8135625946974877
18,121,13,152,0.12949640287769784,0.9144736842105263,0.155888504599441,0.8217527128500118
33,91,22,146,0.2661290322580645,0.8493150684931506,0.17713675144376081,0.8167098105468354
4,103,5,112,0.037383177570093455,0.9553571428571429,0.13904863395377415,0.8341417833359512
45,142,30,217,0.24064171122994651,0.8617511520737328,0.134464982311299,0.9048681383941035
6,80,1,87,0.06976744186046512,0.9885057471264368,0.1373479344542934,0.9055489826409696
7,45,2,54,0.1346153846153846,0.9629629629629629,0.14442064897381646,0.9060888811400517
3,28,6,37,0.0967741935483871,0.8378378378378378,0.13925819199429126,0.9100290850802557
6,122,25,153,0.046875,0.8366013071895425,0.12745513444033443,0.8989044597915438
23,80,27,130,0.22330097087378642,0.7923076923076923,0.12133683995686614,0.8907605489079068
45,62,32,139,0.4205607476635514,0.7697841726618705,0.17607649282736013,0.8642501245942965
33,62,7,102,0.3473684210526316,0.9313725490196079,0.1913231656591723,0.8741960384437072
10,54,3,67,0.15625,0.9552238805970149,0.20367781682196298,0.8694414860823612
15,97,15,127,0.13392857142857142,0.8818897637795275,0.20357970065241823,0.8578596004847275
15,29,4,48,0.3409090909090909,0.9166666666666666,0.23845611456109023,0.8691208617459888
14,76,5,95,0.15555555555555556,0.9473684210526315,0.2539819082118839,0.8849447351550016
6,24,0,30,0.2,1.0,0.2506531980870572,0.9146150648253313
10,82,1,93,0.10869565217391304,0.989247311827957,0.20610104158853745,0.9459669418490578
13,35,2,50,0.2708333333333333,0.96,0.1951674576286377,0.9500565777033997
6,52,3,61,0.10344827586206896,0.9508196721311475,0.18762435418036186,0.9494274050654186
8,119,47,174,0.06299212598425197,0.7298850574712644,0.1774905762597448,0.927712447021381
12,106,93,211,0.1016949152542373,0.5592417061611374,0.14331712259476573,0.8766517383777339
41,90,6,137,0.31297709923664124,0.9562043795620438,0.1658059145492065,0.8779140181647929
4,38,21,63,0.09523809523809523,0.6666666666666666,0.1508399281546487,0.8302949705457453
23,175,18,216,0.11616161616161616,0.9166666666666666,0.1519064944386063,0.8199263069512751
10,47,8,65,0.17543859649122806,0.8769230769230769,0.1382786748897341,0.8080581750831434
2,11,1,14,0.15384615384615385,0.9285714285714286,0.14547837174460335,0.8048798545746122
43,32,7,82,0.5733333333333334,0.9146341463414634,0.21838425850875787,0.8312725815560691
8,39,14,61,0.1702127659574468,0.7704918032786885,0.22817252289493065,0.8614511668585764
22,101,7,130,0.17886178861788618,0.9461538461538461,0.20901319280653707,0.860015376371691
115,430,15,560,0.21100917431192662,0.9732142857142857,0.225551918388513,0.9038078933784937
5,49,3,57,0.09259259259259259,0.9473684210526315,0.2221849150215096,0.9081938582907743
20,56,24,100,0.2631578947368421,0.76,0.23471624334231161,0.8914905615874777
2,0,0,2,1.0,1.0,0.3555953642214325,0.9016946432201307
1,15,1,17,0.0625,0.9411764705882353,0.28261917374524204,0.9054864038268126
15,65,20,100,0.1875,0.8,0.2850887786084639,0.9097018605012855
10,120,9,139,0.07692307692307693,0.935251798561151,0.2705261055092054,0.9081444251309004
10,48,5,63,0.1724137931034483,0.9206349206349206,0.26501247962228,0.9006330872624198
2,21,6,29,0.08695652173913043,0.7931034482758621,0.26420732664321395,0.8785952340085955
4,14,6,24,0.2222222222222222,0.75,0.19093233229175752,0.8793837151167422
34,74,6,114,0.3148148148148148,0.9473684210526315,0.16447730583673104,0.8718649181242608
40,53,9,102,0.43010752688172044,0.9117647058823529,0.21699266681983395,0.867663237451992
23,61,22,106,0.27380952380952384,0.7924528301886793,0.22680428377430806,0.8694422131932319
89,277,29,395,0.24316939890710382,0.9265822784810127,0.25281866900531197,0.8671759610954526
7,85,10,102,0.07608695652173914,0.9019607843137255,0.24152074653797423,0.864508227335282
5,25,2,32,0.16666666666666666,0.9375,0.24669672997482725,0.8810898599883431
2,11,1,14,0.15384615384615385,0.9285714285714286,0.23692872020681746,0.9066000640699757
3,9,2,14,0.25,0.8571428571428571,0.22766946094755822,0.893710697797151
28,202,30,260,0.12173913043478261,0.8846153846153846,0.18361683288370997,0.8898322233304411
38,87,25,150,0.304,0.8333333333333334,0.18792975805377798,0.8956722952082489
3,12,15,30,0.2,0.5,0.18176270106704887,0.8347319697109613
6,115,2,123,0.049586776859504134,0.983739837398374,0.177976961115301,0.8464146915801968
4,43,3,50,0.0851063829787234,0.94,0.1663254920170234,0.8467718344373397
20,137,38,195,0.12738853503184713,0.8051282051282052,0.16254583218640814,0.8291370882311648
18,121,13,152,0.12949640287769784,0.9144736842105263,0.14533103259750785,0.837327206383689
32,94,19,145,0.25396825396825395,0.8689655172413793,0.1642209073880037,0.8350915110445454
4,103,5,112,0.037383177570093455,0.9553571428571429,0.1261327898980171,0.852523483833661
46,141,30,217,0.24598930481283424,0.8617511520737328,0.13270269058556486,0.9042022198441942
7,79,1,87,0.08139534883720931,0.9885057471264368,0.13724677229666557,0.9048830640910605
7,45,2,54,0.1346153846153846,0.9629629629629629,0.1443194868161886,0.9081634873714837
3,28,6,37,0.0967741935483871,0.8378378378378378,0.13994600946140862,0.9128362920442884
6,122,25,153,0.046875,0.8366013071895425,0.12814295190745179,0.9017116667555763
20,79,31,130,0.20202020202020202,0.7615384615384615,0.12072180162915865,0.8863649445123024
44,63,32,139,0.411214953271028,0.7697841726618705,0.17412634101500643,0.8598545201986921
34,61,7,102,0.35789473684210527,0.9313725490196079,0.1901128313049023,0.8698004340481028
10,53,3,66,0.15873015873015872,0.9545454545454546,0.20116066128960933,0.8649489636793911
6,33,88,127,0.15384615384615385,0.30708661417322836,0.2039079140368621,0.7712523424237148
15,29,4,48,0.3409090909090909,0.9166666666666666,0.2387843279455341,0.7825136036849759
14,76,4,94,0.15555555555555556,0.9574468085106383,0.25431012159632777,0.7997772467308468
6,24,0,30,0.2,1.0,0.2540215213077274,0.8338431807967809
11,81,1,93,0.11956521739130435,0.989247311827957,0.21235727332490978,0.8651950578205075
13,35,2,50,0.2708333333333333,0.96,0.19991992996651378,0.8692846936748493
6,52,4,62,0.10344827586206896,0.9354838709677419,0.19202251812821527,0.8665616103066046
8,119,47,174,0.06299212598425197,0.7298850574712644,0.1790433712908007,0.9269613879206098
12,94,105,211,0.11320754716981132,0.5023696682464455,0.14651457932804648,0.8677761024320066
41,90,6,137,0.31297709923664124,0.9562043795620438,0.16900337128248727,0.8675986125822075
4,38,21,63,0.09523809523809523,0.6666666666666666,0.15403738488792948,0.8199795649631598
23,174,19,216,0.116751269035533,0.9120370370370371,0.1536353922656764,0.8089495257073142
10,47,8,65,0.17543859649122806,0.8769230769230769,0.14000757271680422,0.7970813938391823
2,10,2,14,0.16666666666666666,0.8571428571428571,0.14903877140317534,0.7858898204356273
44,32,6,82,0.5789473684210527,0.926829268292683,0.22274666317986114,0.8140247076958299
8,40,13,61,0.16666666666666666,0.7868852459016393,0.2303836802508405,0.8546697902180005
24,100,6,130,0.1935483870967742,0.9538461538461539,0.21332243565943085,0.8543329008300162
193,348,19,560,0.3567467652495379,0.9660714285714286,0.25068081708963696,0.8971050096735537
4,50,3,57,0.07407407407407407,0.9473684210526315,0.2445840749522857,0.9021523502472101
20,56,24,100,0.2631578947368421,0.76,0.2571154032730877,0.8854490535439133
2,0,0,2,1.0,1.0,0.37616302232070675,0.9058572168092195
1,15,1,17,0.0625,0.9411764705882353,0.302384826831985,0.9079068171371556
17,61,22,100,0.21794871794871795,0.78,0.3097108341579923,0.9069232105797784
8,123,8,139,0.061068702290076333,0.9424460431654677,0.2907851648998926,0.9052946233396805
9,49,5,63,0.15517241379310345,0.9206349206349206,0.26198882897754483,0.8988036936344651
2,21,6,29,0.08695652173913043,0.7931034482758621,0.2638291786439814,0.8767658403806408
4,14,6,24,0.2222222222222222,0.75,0.18975669747683546,0.8753372689520693
35,73,6,114,0.32407407407407407,0.9473684210526315,0.16462442234456032,0.8678184719595882
40,53,9,102,0.43010752688172044,0.9117647058823529,0.21713978332766323,0.8636167912873193
23,61,22,106,0.27380952380952384,0.7924528301886793,0.22328839661913366,0.8653957670285591
92,272,30,394,0.25274725274725274,0.9238578680203046,0.25176155922533877,0.862740313436393
6,85,10,101,0.06593406593406594,0.900990099009901,0.23655016962971276,0.8599339103471044
0,6,26,32,0.0,0.1875,0.22412780938126553,0.7734191320219813
2,11,1,14,0.15384615384615385,0.9285714285714286,0.2143597996132558,0.7989293361036138
3,9,2,14,0.25,0.8571428571428571,0.2037777890312452,0.786039969830789
27,203,30,260,0.11739130434782609,0.8846153846153846,0.1591040429549746,0.7821614953640792
38,88,24,150,0.30158730158730157,0.84,0.16307229692322853,0.7889539481942679
3,13,14,30,0.1875,0.5333333333333333,0.15375126081647814,0.733164728953272
6,115,2,123,0.049586776859504134,0.983739837398374,0.15141593380582646,0.7449861201516254
4,43,3,50,0.0851063829787234,0.94,0.16357398851707267,0.8524861201516253
20,136,38,194,0.1282051282051282,0.8041237113402062,0.15991098485406902,0.8347078748328792
17,121,13,151,0.12318840579710146,0.9139072847682119,0.1417950428250835,0.8428170787793585
32,94,20,146,0.25396825396825395,0.863013698630137,0.16130603562800178,0.8397311236386089
5,102,5,112,0.04672897196261682,0.9553571428571429,0.12489770282447536,0.8562107154753436
46,141,30,217,0.24598930481283424,0.8617511520737328,0.13325331779773741,0.9031275467239721
7,79,1,87,0.08139534883720931,0.9885057471264368,0.13779739950883815,0.9038083909708382
7,45,2,54,0.1346153846153846,0.9629629629629629,0.1448701140283612,0.9070888142512613
3,28,6,37,0.0967741935483871,0.8378378378378378,0.1403799805059696,0.9119051180366374
6,122,25,153,0.046875,0.8366013071895425,0.12947806539209794,0.9008614069539703
17,81,32,130,0.17346938775510204,0.7538461538461538,0.11797822736164768,0.8852660434134013
45,62,32,139,0.4205607476635514,0.7697841726618705,0.17138276674749547,0.858755619099791
35,61,7,103,0.3645833333333333,0.9320388349514563,0.18832477082185248,0.8687967166537515
8,54,4,66,0.12903225806451613,0.9393939393939394,0.1951300435686106,0.8617807441205375
15,96,16,127,0.13513513513513514,0.8740157480314961,0.19520429364286068,0.8490739991303281
16,28,4,48,0.36363636363636365,0.9166666666666666,0.23332746079828587,0.8603352603915893
13,77,4,94,0.14444444444444443,0.9574468085106383,0.24726595286177797,0.8775989034374602
5,25,0,30,0.16666666666666666,1.0,0.24629413556343005,0.9127637386022954
10,68,1,79,0.1282051282051282,0.9873417721518988,0.20452904706936956,0.9438433956722994
14,33,2,49,0.2978723404255319,0.9591836734693877,0.19499890522539795,0.9477212297462895
5,52,5,62,0.08771929824561403,0.9193548387096774,0.18909705382269767,0.9448585010771093
7,120,47,174,0.05511811023622047,0.7298850574712644,0.17766605026570986,0.9242684024256475
12,106,92,210,0.1016949152542373,0.5619047619047619,0.14024584335397752,0.873588130316804
42,88,6,136,0.3230769230769231,0.9558823529411765,0.16576476887290306,0.8733646366640239
3,39,21,63,0.07142857142857142,0.6666666666666666,0.1521593266960323,0.8257455890449761
23,174,19,216,0.116751269035533,0.9120370370370371,0.15052306110037583,0.814987769742853
9,48,8,65,0.15789473684210525,0.8769230769230769,0.13052626058845776,0.803236255950523
2,10,2,14,0.16666666666666666,0.8571428571428571,0.14180445607717954,0.7943488300124057
44,32,6,82,0.5789473684210527,0.926829268292683,0.2166372072464413,0.8224837172726084
8,40,13,61,0.16666666666666666,0.7868852459016393,0.2259188860196455,0.8546237864150195
22,102,6,130,0.1774193548387097,0.9538461538461539,0.20511066198561498,0.8543329008300162
194,342,20,556,0.3619402985074627,0.9640287769784173,0.24661233728259946,0.8968132023031234
4,50,3,57,0.07407407407407407,0.9473684210526315,0.2405155951452482,0.9018605428767799
20,55,25,100,0.26666666666666666,0.75,0.2560544422630427,0.8837286747449117
1,1,0,2,0.5,1.0,0.3036734898820903,0.9041368380102178
1,15,1,17,0.0625,0.9411764705882353,0.2298952943933685,0.9061864383381538
16,62,22,100,0.20512820512820512,0.78,0.23538979988787398,0.9052028317807769
8,123,8,139,0.061068702290076333,0.9424460431654677,0.2187682780952121,0.9035742445406789
9,49,5,63,0.15517241379310345,0.9206349206349206,0.1892300088503036,0.8973751222058935
3,20,5,28,0.13043478260869565,0.8214285714285714,0.19728153864096384,0.8793837151167422
3,15,6,24,0.16666666666666666,0.75,0.1748374192223903,0.875888861291643
35,72,7,114,0.32710280373831774,0.9385964912280702,0.15013781975643573,0.8671169314670816
39,54,9,102,0.41935483870967744,0.9117647058823529,0.20111708242924675,0.8629152507948127
23,60,23,106,0.27710843373493976,0.7830188679245284,0.21101940042106562,0.8636639779586341
93,273,29,395,0.2540983606557377,0.9265822784810127,0.23845980853246115,0.860528673203821
7,85,9,101,0.07608695652173914,0.9108910891089109,0.22962494025231553,0.8591366972715339
0,6,26,32,0.0,0.1875,0.21720258000386833,0.7726219189464106
2,11,1,14,0.15384615384615385,0.9285714285714286,0.21537107817236648,0.7981321230280434
3,9,2,14,0.25,0.8571428571428571,0.20435639192403537,0.7864958895872985
31,200,29,260,0.1341991341991342,0.8884615384615384,0.16361986270824347,0.7831668656700393
39,89,23,151,0.3046875,0.847682119205298,0.1675597293175378,0.7924044729958636
2,14,14,30,0.125,0.5333333333333333,0.1491171063667181,0.7362260522604809
6,115,2,123,0.049586776859504134,0.983739837398374,0.14533136641497027,0.7466330163018328
3,44,3,50,0.06382978723404255,0.94,0.15444990744840492,0.8541330163018328
21,136,37,194,0.1337579617834395,0.8092783505154639,0.15158016572516,0.8370911480081235
16,122,13,151,0.11594202898550725,0.9139072847682119,0.1324290270088039,0.8452003519546027
32,95,19,146,0.25196850393700787,0.8698630136986302,0.14925322268564298,0.8425434198456159
4,104,5,113,0.037037037037037035,0.9557522123893806,0.11101744226236257,0.857982004586199
45,143,30,218,0.2393617021276596,0.8623853211009175,0.12735482828059966,0.9049894314101398
7,79,1,87,0.08139534883720931,0.9885057471264368,0.13189890999170037,0.9056702756570058
7,45,2,54,0.1346153846153846,0.9629629629629629,0.14201113818903496,0.9089506989374291
3,27,6,36,0.1,0.8333333333333334,0.1371885722199722,0.9123871250542676
7,121,25,153,0.0546875,0.8366013071895425,0.1284379252220426,0.9013434139716004
18,77,35,130,0.18947368421052632,0.7307692307692307,0.11951009383254521,0.8814728735531149
44,63,32,139,0.411214953271028,0.7697841726618705,0.1729640818659725,0.8549060107348991
35,60,7,102,0.3684210526315789,0.9313725490196079,0.19140113193796096,0.8647613290089977
12,50,3,65,0.1935483870967742,0.9538461538461539,0.20742299454647026,0.8598099585403859
6,30,91,127,0.16666666666666666,0.28346456692913385,0.21200174912522485,0.7627387591069817
15,29,4,48,0.3409090909090909,0.9166666666666666,0.24641733354080925,0.7746435210117436
14,74,7,95,0.1590909090909091,0.9263157894736842,0.26133210626808195,0.7874598756237638
5,25,0,30,0.16666666666666666,1.0,0.25807396090467344,0.8259214140853024
9,69,1,79,0.11538461538461539,0.9873417721518988,0.21581248406375736,0.8570010711553063
14,33,2,49,0.2978723404255319,0.9591836734693877,0.20573409660575062,0.8609740889338464
7,50,4,61,0.12280701754385964,0.9344262295081968,0.19562818666961995,0.858199814028424
7,120,47,174,0.05511811023622047,0.7298850574712644,0.17969267860812768,0.9219741698201569
13,93,105,211,0.12264150943396226,0.5023696682464455,0.14851159554025214,0.8627888843315539
44,87,6,137,0.33587786259541985,0.9562043795620438,0.17376687461232512,0.8670586829156053
3,39,21,63,0.07142857142857142,0.6666666666666666,0.16016143243545436,0.8194396352965576
23,174,18,215,0.116751269035533,0.9162790697674419,0.16035666867129975,0.8092878206702065
9,48,8,65,0.15789473684210525,0.8769230769230769,0.14035986815938165,0.7975363068778766
2,11,2,15,0.15384615384615385,0.8666666666666667,0.14479403048828082,0.7878563693290864
44,32,6,82,0.5789473684210527,0.926829268292683,0.21962678165754257,0.8159912565892891
9,39,13,61,0.1875,0.7868852459016393,0.22889228030983366,0.8566363391114596
22,101,7,130,0.17886178861788618,0.9461538461538461,0.20646141259875744,0.8552005486245743
198,338,20,556,0.3694029850746269,0.9640287769784173,0.24902918597676535,0.8976808500976815
5,49,3,57,0.09259259259259259,0.9473684210526315,0.24557794648491674,0.9021221859955658
21,54,25,100,0.28,0.75,0.26302155550747314,0.8839903178636977
1,1,0,2,0.5,1.0,0.3124721049580225,0.9030379369113167
1,15,1,17,0.0625,0.9411764705882353,0.23869390946930075,0.9050875372392527
18,60,22,100,0.23076923076923078,0.78,0.24487522815061943,0.9041039306818757
7,124,8,139,0.05343511450381679,0.9424460431654677,0.22695713184860952,0.9035742445406788
10,48,5,63,0.1724137931034483,0.9206349206349206,0.1988158187098697,0.8973751222058935
2,21,6,29,0.08695652173913043,0.7931034482758621,0.1980106657308037,0.8753372689520693
3,15,6,24,0.16666666666666666,0.75,0.17758452858858162,0.8776635711755966
34,74,6,114,0.3148148148148148,0.9473684210526315,0.15112950213355517,0.8701447741831154
40,53,9,102,0.43010752688172044,0.9117647058823529,0.20364486311665808,0.8659430935108465
23,58,25,106,0.2839506172839506,0.7641509433962265,0.21124220404733232,0.8636789425674503
93,273,29,395,0.2540983606557377,0.9265822784810127,0.23888396119728622,0.8613539619422889
7,85,9,101,0.07608695652173914,0.9108910891089109,0.23038306636625136,0.8576944123138566
0,5,26,31,0.0,0.16129032258064516,0.21796070611780416,0.767435394357397
2,11,1,14,0.15384615384615385,0.9285714285714286,0.2161292042863023,0.7929455984390297
3,9,2,14,0.25,0.8571428571428571,0.2068699450270431,0.7800562321662047
29,202,29,260,0.12554112554112554,0.8884615384615384,0.1633604591212438,0.7767272082489456
39,88,22,149,0.30708661417322836,0.8523489932885906,0.1666656015339978,0.7893269296621404
3,13,14,30,0.1875,0.5333333333333333,0.15715155001174952,0.7331485089267576
6,115,2,123,0.049586776859504134,0.983739837398374,0.1533658100600017,0.7435554729681095
3,44,3,50,0.06382978723404255,0.94,0.1624843510934363,0.8547997125994459
21,136,37,194,0.1337579617834395,0.8092783505154639,0.1596146093701914,0.8377578443057369
17,120,13,150,0.12408759124087591,0.9133333333333333,0.14162712240460223,0.8457850551900904
32,94,20,146,0.25396825396825395,0.863013698630137,0.15997385503704917,0.8421496494998902
4,103,5,112,0.037383177570093455,0.9553571428571429,0.12144479266517275,0.8568650994382548
43,145,30,218,0.22872340425531915,0.8623853211009175,0.12733385041593265,0.9038725262621954
7,79,1,87,0.08139534883720931,0.9885057471264368,0.13187793212703336,0.9045533705090616
7,45,3,55,0.1346153846153846,0.9454545454545454,0.14199016032436795,0.9053325912882823
5,28,3,36,0.15151515151515152,0.9166666666666666,0.14452690171461252,0.9206737793098828
6,122,25,153,0.046875,0.8366013071895425,0.13349653153734456,0.9097120612893412
18,77,35,130,0.18947368421052632,0.7307692307692307,0.1242830215719549,0.8908199944520688
41,66,32,139,0.38317757009345793,0.7697841726618705,0.1736822205038641,0.8643095701384585
34,62,7,103,0.3541666666666667,0.9320388349514563,0.191602686562628,0.8742600721171069
11,52,6,69,0.1746031746031746,0.9130434782608695,0.2049180902434802,0.8634797479934545
18,94,15,127,0.16071428571428573,0.8818897637795275,0.20864650468618037,0.8543990648970233
14,30,4,48,0.3181818181818182,0.9166666666666666,0.23245602849570418,0.8543990648970234
11,75,8,94,0.12790697674418605,0.9148936170212766,0.24403202517344505,0.865583680587271
5,25,0,30,0.16666666666666666,1.0,0.24077387981003653,0.9040452190488095
9,69,1,79,0.11538461538461539,0.9873417721518988,0.202517743423059,0.9351248761188135
14,33,2,49,0.2978723404255319,0.9591836734693877,0.1944756968171826,0.9390027101928038
7,49,5,61,0.125,0.9180327868852459,0.18738952901672912,0.9397154685677147
7,120,47,174,0.05511811023622047,0.7298850574712644,0.17230436109129119,0.9180005105236771
14,98,97,209,0.125,0.5358851674641149,0.14470695849388862,0.8636031534947411
42,89,6,137,0.32061068702290074,0.9562043795620438,0.17223605996227645,0.869504691000565
3,39,21,63,0.07142857142857142,0.6666666666666666,0.1586306177854057,0.8218856433815173
23,174,18,215,0.116751269035533,0.9162790697674419,0.15882585402125105,0.8117338287551663
9,48,8,65,0.15789473684210525,0.8769230769230769,0.13882905350933297,0.7999823149628363
2,11,2,15,0.15384615384615385,0.8666666666666667,0.14294993263021208,0.7926442977887536
44,32,6,82,0.5789473684210527,0.926829268292683,0.21778268379947383,0.8207791850489562
8,39,14,61,0.1702127659574468,0.7704918032786885,0.22424165036482333,0.8542944187367524
23,100,7,130,0.18699186991869918,0.9461538461538461,0.205153247921366,0.852858628249867
203,329,23,555,0.3815789473684211,0.9585585585585585,0.24946044448420165,0.8945574699487088
5,47,3,55,0.09615384615384616,0.9454545454545454,0.2465179555011035,0.8987253950468663
21,54,26,101,0.28,0.7425742574257426,0.26396156452365993,0.8795327065472472
1,1,0,2,0.5,1.0,0.3134121139742093,0.8985803255948662
1,15,1,17,0.0625,0.9411764705882353,0.23963391848548757,0.9006299259228022
16,61,22,99,0.2077922077922078,0.7777777777777778,0.2450024101761677,0.9016707794226722
8,121,7,136,0.06201550387596899,0.9485294117647058,0.2271486435986348,0.9020101459385094
8,50,5,63,0.13793103448275862,0.9206349206349206,0.19234179890068304,0.8965924833779895
2,21,6,29,0.08695652173913043,0.7931034482758621,0.1910278954128665,0.8748280409238919
3,14,7,24,0.17647058823529413,0.7083333333333334,0.17669436852442552,0.8741601698150524
32,76,6,114,0.2962962962962963,0.9473684210526315,0.1475938394238964,0.8666413728225711
35,59,9,103,0.3723404255319149,0.912621359223301,0.1918567573570271,0.8625620711990091
23,56,28,107,0.2911392405063291,0.7383177570093458,0.2027066669411139,0.8551788936289156
96,272,28,396,0.2608695652173913,0.9292929292929293,0.23138083683790556,0.8522207406707627
7,83,9,99,0.07777777777777778,0.9090909090909091,0.22312148790059053,0.8483040224683301
0,5,26,31,0.0,0.16129032258064516,0.2106991276521433,0.7580450045118706
2,11,1,14,0.15384615384615385,0.9285714285714286,0.20746706559655187,0.7895075895458843
2,9,3,14,0.18181818181818182,0.7857142857142857,0.19111304924253547,0.7664141416404062
29,203,28,260,0.125,0.8923076923076924,0.15577870273797625,0.7635121892238909
38,87,24,149,0.304,0.8389261744966443,0.15761595409421494,0.7778848202935047
2,10,18,30,0.16666666666666666,0.4,0.14415839715839712,0.7022715446802292
6,115,2,123,0.049586776859504134,0.983739837398374,0.14013111131292946,0.7129356772955813
3,44,3,50,0.06382978723404255,0.94,0.1492496523463641,0.8241799169269177
20,135,38,193,0.12903225806451613,0.8031088082901554,0.14570481009184447,0.8062566854581644
17,118,11,146,0.1259259259259259,0.9246575342465754,0.13772020210723646,0.8261057209627772
30,97,19,146,0.23622047244094488,0.8698630136986302,0.15360884102737143,0.8228993383043398
5,100,6,111,0.047619047619047616,0.9459459459459459,0.11698299068723537,0.8381878770828115
45,143,30,218,0.2393617021276596,0.8623853211009175,0.12736799575309152,0.904242922954371
7,78,1,86,0.08235294117647059,0.9883720930232558,0.132048876369801,0.9049046737579257
6,45,4,55,0.11764705882352941,0.9272727272727272,0.13973705802544198,0.9030864919397439
5,28,3,36,0.15151515151515152,0.9166666666666666,0.14294889994696133,0.9193090431363883
4,124,25,153,0.03125,0.8366013071895425,0.12942376767182906,0.9067295821282408
17,76,36,129,0.1827956989247312,0.7209302325581395,0.1217916571695128,0.8854534705367421
42,65,32,139,0.3925233644859813,0.7697841726618705,0.17106370243621763,0.8602875029247313
36,58,7,101,0.3829787234042553,0.9306930693069307,0.1915804197614456,0.8700457526684475
12,51,6,69,0.19047619047619047,0.9130434782608695,0.20702659823283415,0.8592845219881066
7,33,87,127,0.175,0.31496062992125984,0.21521987554375852,0.7718113652236112
14,30,4,48,0.3181818181818182,0.9166666666666666,0.23902939935328232,0.7718113652236112
11,76,7,94,0.12643678160919541,0.925531914893617,0.2526275110117388,0.7845157377527647
5,25,0,30,0.16666666666666666,1.0,0.250323363546301,0.8243828473873162
10,68,1,79,0.1282051282051282,0.9873417721518988,0.21256361550617917,0.8554625044573203
13,34,2,49,0.2765957446808511,0.9591836734693877,0.1973660471171214,0.8595325907662428
7,50,5,62,0.12280701754385964,0.9193548387096774,0.18769902241250272,0.860434213687501
8,120,46,174,0.0625,0.735632183908046,0.17162759384107412,0.9205301499713275
14,79,116,209,0.15053763440860216,0.4449760765550239,0.14767842473061468,0.8531457799553787
46,85,6,137,0.3511450381679389,0.9562043795620438,0.1797796042390066,0.8575275606222966
2,38,22,62,0.05,0.6451612903225806,0.16311293757233994,0.8068363163826654
23,171,18,212,0.11855670103092783,0.9150943396226415,0.16173459083316846,0.7965152545927714
9,48,8,65,0.15789473684210525,0.8769230769230769,0.1447773039990619,0.7847637408004414
2,11,2,15,0.15384615384615385,0.8666666666666667,0.14921146632796112,0.7772368590800112
44,32,6,82,0.5789473684210527,0.926829268292683,0.22298966181668292,0.8045507282778165
8,39,14,61,0.1702127659574468,0.7704918032786885,0.2258003948950893,0.8510529749526258
20,101,9,130,0.1652892561983471,0.9307692307692308,0.19924956889943332,0.8474193822679382
198,336,22,556,0.3707865168539326,0.960431654676259,0.24507621416428085,0.8924580057470352
4,48,2,54,0.07692307692307693,0.9629629629629629,0.239128553577445,0.8992963805099381
20,54,27,101,0.2702702702702703,0.7326732673267327,0.25518220121004004,0.8786892648533176
1,1,0,2,0.5,1.0,0.3046327506605895,0.8977368839009365
1,15,1,17,0.0625,0.9411764705882353,0.23085455517186765,0.8997864842288726
18,60,22,100,0.23076923076923078,0.78,0.2395054787164082,0.9011447980462028
8,124,8,140,0.06060606060606061,0.9428571428571428,0.22455073648893872,0.9028716426301904
8,51,4,63,0.13559322033898305,0.9365079365079365,0.1909516941296602,0.8994539686061442
2,21,6,29,0.08695652173913043,0.7931034482758621,0.1923850433890964,0.8751883236508442
3,13,8,24,0.1875,0.6666666666666666,0.1740403730064586,0.8682077888626714
33,76,5,114,0.30275229357798167,0.956140350877193,0.1458621292318846,0.8619421247022704
35,59,9,103,0.3723404255319149,0.912621359223301,0.19012504716501527,0.8578628230787084
24,62,22,108,0.27906976744186046,0.7962962962962963,0.20105906457533532,0.8587622939781792
91,276,30,397,0.24795640326975477,0.924433249370277,0.22788849705103603,0.855109901031076
7,83,10,100,0.07777777777777778,0.9,0.22205045561977424,0.8498944815299422
0,6,26,32,0.0,0.1875,0.20962809537132704,0.7633797032048191
2,11,1,14,0.15384615384615385,0.9285714285714286,0.20482040306363475,0.8007946691912136
2,9,3,14,0.18181818181818182,0.7857142857142857,0.18754410138366337,0.7764480884536554
27,205,28,260,0.11637931034482758,0.8923076923076924,0.150978227785508,0.7735461360371401
42,90,25,157,0.3181818181818182,0.8407643312101911,0.15656566360550198,0.7798987124534106
2,9,19,30,0.18181818181818182,0.36666666666666664,0.14711734625527728,0.7002177720671805
6,115,2,123,0.049586776859504134,0.983739837398374,0.1430900604098096,0.712180605981234
4,44,2,50,0.08333333333333333,0.96,0.15499482231457154,0.8225377488383767
20,135,38,193,0.12903225806451613,0.8031088082901554,0.1514499800600518,0.8046145173696234
17,117,11,145,0.12686567164179105,0.9241379310344827,0.1435996214634246,0.8243893238439374
30,96,21,147,0.23809523809523808,0.8571428571428571,0.16098761114205465,0.8193657759632467
4,101,6,111,0.0380952380952381,0.9459459459459459,0.1209752425582575,0.8343917209254972
44,144,30,218,0.23404255319148937,0.8623853211009175,0.12843586704015858,0.9052086715589617
7,78,1,86,0.08235294117647059,0.9883720930232558,0.13311674765686807,0.9058704223625164
6,45,4,55,0.11764705882352941,0.9272727272727272,0.13801870844118178,0.9011950976871915
5,28,3,36,0.15151515151515152,0.9166666666666666,0.14123055036270116,0.917417648883836
5,123,25,153,0.0390625,0.8366013071895425,0.12868724012815957,0.9049124169059874
16,77,36,129,0.17204301075268819,0.7209302325581395,0.11925120765065243,0.8854534705367421
42,65,32,139,0.3925233644859813,0.7697841726618705,0.16988379713504434,0.8602875029247313
35,60,7,102,0.3684210526315789,0.9313725490196079,0.1890807256264857,0.8701428211988299
12,51,6,69,0.19047619047619047,0.9130434782608695,0.20452690409787427,0.8593815905184891
7,112,8,127,0.058823529411764705,0.937007874015748,0.1961235427533364,0.860772325767492
15,29,4,48,0.3409090909090909,0.9166666666666666,0.2231798198096135,0.860772325767492
11,77,7,95,0.125,0.9263157894736842,0.2354566055238992,0.8735886803795123
5,25,0,30,0.16666666666666666,1.0,0.23468855636875327,0.9134557900140639
9,68,2,79,0.11688311688311688,0.9746835443037974,0.19531137813977265,0.9427271288200533
13,34,2,49,0.2765957446808511,0.9591836734693877,0.18219347700395438,0.9467001465985933
6,47,9,62,0.11320754716981132,0.8548387096774194,0.17115509938875736,0.9383851796581004
8,120,46,174,0.0625,0.735632183908046,0.17168030947279098,0.9096172239284286
13,82,116,211,0.1368421052631579,0.45023696682464454,0.1425278829519434,0.8429844096652827
46,86,6,138,0.3484848484848485,0.9565217391304348,0.17445428987835032,0.8472995453305329
2,39,22,63,0.04878048780487805,0.6507936507936508,0.1576134071838091,0.79741292401534
23,173,18,214,0.11734693877551021,0.9158878504672897,0.157679667454151,0.7890135391815533
11,46,8,65,0.19298245614035087,0.8769230769230769,0.14573491194836524,0.777262025389223
2,11,2,15,0.15384615384615385,0.8666666666666667,0.15154042718784275,0.7789517335305441
44,32,6,82,0.5789473684210527,0.926829268292683,0.22531862267656458,0.8062656027283495
8,39,14,61,0.1702127659574468,0.7704918032786885,0.23008585991860583,0.8520162936503557
19,104,7,130,0.15447154471544716,0.9461538461538461,0.20236967366583422,0.8505351660822716
195,339,22,556,0.3651685393258427,0.960431654676259,0.24756796674025772,0.89476916663693
4,49,2,55,0.07547169811320754,0.9636363636363636,0.24158578950278592,0.9015903828039404
19,54,28,101,0.2602739726027397,0.7227722772277227,0.2511988632831272,0.8795688399903184
1,1,0,2,0.5,1.0,0.3006494127336766,0.8986164590379374
1,15,1,17,0.0625,0.9411764705882353,0.22687121724495482,0.9006660593658735
17,62,21,100,0.21518987341772153,0.79,0.23329651831070836,0.9034529446117752
8,125,7,140,0.06015037593984962,0.95,0.21982206562848014,0.9040023951612257
8,51,4,63,0.13559322033898305,0.9365079365079365,0.18702559148750023,0.9005847211371797
2,21,6,29,0.08695652173913043,0.7931034482758621,0.18866628057691773,0.8762228760856795
3,14,7,24,0.17647058823529413,0.7083333333333334,0.1718824029744209,0.8741601698150524
34,75,5,114,0.3119266055045872,0.956140350877193,0.14501477518936193,0.8678945056546514
37,57,9,103,0.39361702127659576,0.912621359223301,0.1923172068003042,0.8638152040310894
24,62,22,108,0.27906976744186046,0.7962962962962963,0.20867617900266763,0.8647146749305603
98,267,32,397,0.2684931506849315,0.9193954659949622,0.23843943253767932,0.8603425986441263
7,83,10,100,0.07777777777777778,0.9,0.227758776094311,0.8551271791429924
0,6,26,32,0.0,0.1875,0.2153364158458638,0.7686124008178693
2,11,1,14,0.15384615384615385,0.9285714285714286,0.21210435379027232,0.800074985851883
2,9,3,14,0.18181818181818182,0.7857142857142857,0.19351743612078587,0.7757284051143248
29,201,30,260,0.12608695652173912,0.8846153846153846,0.1552988554415206,0.7717275515989082
42,90,25,157,0.3181818181818182,0.8407643312101911,0.16088629126151457,0.7780801280151789
2,8,20,30,0.2,0.3333333333333333,0.1511015554493815,0.6943569662063747
5,116,2,123,0.04132231404958678,0.983739837398374,0.14589363205963995,0.7063198001204282
4,44,2,50,0.08333333333333333,0.96,0.15779839396440185,0.8166769429775709
22,135,36,193,0.14012738853503184,0.8134715025906736,0.15583857034852724,0.8002340964088915
16,118,11,145,0.11940298507462686,0.9241379310344827,0.14692211367087654,0.8200089028832055
32,95,20,147,0.25196850393700787,0.8639455782312925,0.1649051918730578,0.8170560733997638
4,102,5,111,0.03773584905660377,0.954954954954955,0.12484148199802718,0.8333690196490159
45,143,30,218,0.2393617021276596,0.8623853211009175,0.13046458230197855,0.9089478750443849
7,78,1,86,0.08235294117647059,0.9883720930232558,0.13632610046296195,0.9096096258479395
6,45,4,55,0.11764705882352941,0.9272727272727272,0.1412280612472757,0.9049343011726149
5,28,3,36,0.15151515151515152,0.9166666666666666,0.1428548845301499,0.9196764674691852
5,123,25,153,0.0390625,0.8366013071895425,0.1313776723766318,0.9071712354913367
16,78,35,129,0.1702127659574468,0.7286821705426356,0.11969828123669449,0.8878478915358142
43,64,32,139,0.40186915887850466,0.7697841726618705,0.17171732549696603,0.8613949226368022
35,60,7,102,0.3684210526315789,0.9313725490196079,0.19015437556895454,0.8712502409109008
12,51,7,70,0.19047619047619047,0.9,0.2056005540403431,0.8586256561932928
15,104,8,127,0.12605042016806722,0.937007874015748,0.20680103423241994,0.8600163914422959
14,30,4,48,0.3181818181818182,0.9166666666666666,0.23061055804194372,0.8600163914422957
11,77,7,95,0.125,0.9263157894736842,0.24288734375622942,0.872832746054316
5,25,0,30,0.16666666666666666,1.0,0.24238075814326085,0.9115924359767966
10,68,1,79,0.1282051282051282,0.9873417721518988,0.20328589661849278,0.9426720930468007
12,36,1,49,0.25,0.9795918367346939,0.1863686033854101,0.9495605627203844
6,50,6,62,0.10714285714285714,0.9032258064516129,0.17446384148064814,0.950021392213472
8,121,46,175,0.06201550387596899,0.7371428571428571,0.1653159962960627,0.9214692469459161
14,101,96,211,0.12173913043478261,0.5450236966824644,0.13725275518934335,0.8683773940910301
44,88,6,138,0.3333333333333333,0.9565217391304348,0.1670146599512481,0.8726925297562802
3,39,21,63,0.07142857142857142,0.6666666666666666,0.15340921777437733,0.8250734821372324
21,174,19,214,0.1076923076923077,0.9112149532710281,0.15047881484397443,0.8141982222971081
9,48,8,65,0.15789473684210525,0.8769230769230769,0.13732092010713232,0.7995312566097342
2,11,2,15,0.15384615384615385,0.8666666666666667,0.1439928196361747,0.794308522354742
44,31,7,82,0.5866666666666667,0.9146341463414634,0.21894298574913154,0.8196644208116857
8,39,14,61,0.1702127659574468,0.7704918032786885,0.22586779082379785,0.851874150325432
22,102,6,130,0.1774193548387097,0.9538461538461539,0.2035943653245659,0.8514919238562492
200,334,22,556,0.37453183520599254,0.960431654676259,0.2468948315784832,0.8934583507147622
4,49,3,56,0.07547169811320754,0.9464285714285714,0.24229188735289747,0.8984888675944113
20,53,27,100,0.273972602739726,0.73,0.25887443962398615,0.8774998566054003
1,1,0,2,0.5,1.0,0.30832498907453554,0.8965474756530194
1,15,1,17,0.0625,0.9411764705882353,0.2334440366935832,0.9003392362597011
16,63,21,100,0.20253164556962025,0.79,0.2380610194953223,0.9031261215056027
8,125,7,140,0.06015037593984962,0.95,0.22130830822405656,0.9025766709561521
7,52,4,63,0.11864406779661017,0.9365079365079365,0.18475291287985907,0.899158996932106
2,21,6,29,0.08695652173913043,0.7931034482758621,0.18639360196927662,0.8772554079102904
3,15,6,24,0.16666666666666666,0.75,0.17027376801016406,0.879730287580478
33,77,4,114,0.3,0.9649122807017544,0.14170233943873548,0.8747177562521572
39,54,9,102,0.41935483870967744,0.9117647058823529,0.19268160211154653,0.8705160755798882
26,59,23,108,0.3058823529411765,0.7870370370370371,0.2125695572936194,0.870395825459638
98,266,32,396,0.2692307692307692,0.9191919191919192,0.2435122987626766,0.8650183092907551
7,83,10,100,0.07777777777777778,0.9,0.23283164231930836,0.8598028897896212
0,7,25,32,0.0,0.21875,0.21984462933229532,0.7788079918304377
2,11,1,14,0.15384615384615385,0.9285714285714286,0.21801312750079352,0.8043181959120702
1,9,3,13,0.1,0.7692307692307693,0.18944169892936497,0.776363694273358
31,198,31,260,0.13537117903930132,0.8807692307692307,0.1488726046907398,0.7719357692571978
42,90,24,156,0.3181818181818182,0.8461538461538461,0.15062967115368858,0.7803810277024562
3,12,15,30,0.2,0.5,0.1407395612635787,0.7204964678178963
6,115,2,123,0.049586776859504134,0.983739837398374,0.13671227541811104,0.7324593017319498
4,43,3,50,0.0851063829787234,0.94,0.14887033012935724,0.8354950160176641
21,135,37,193,0.1346153846153846,0.8082901554404145,0.1461230773821045,0.8183119769989478
16,117,11,144,0.12030075187969924,0.9236111111111112,0.1490231847934901,0.8403663115532822
31,96,20,147,0.2440944881889764,0.8639455782312925,0.16455508610058653,0.8379629326192912
4,101,5,110,0.0380952380952381,0.9545454545454546,0.12454271751678937,0.8534474481038066
45,142,30,217,0.24064171122994651,0.8617511520737328,0.1303486762639246,0.9051261841143399
7,78,1,86,0.08235294117647059,0.9883720930232558,0.1350295568806341,0.9057879349178944
6,45,4,55,0.11764705882352941,0.9272727272727272,0.1396782248584635,0.9039697530997125
3,27,6,36,0.1,0.8333333333333334,0.13473316991340858,0.9075473499415582
5,123,25,153,0.0390625,0.8366013071895425,0.12312770535916583,0.8951173779527626
16,76,37,129,0.17391304347826086,0.7131782945736435,0.11310178468620646,0.8735791945730984
43,64,32,139,0.40186915887850466,0.7697841726618705,0.16506948765524454,0.8471847257325864
37,58,7,102,0.3894736842105263,0.9313725490196079,0.18633119808104165,0.8571306395819972
9,49,12,70,0.15517241379310345,0.8285714285714286,0.1967339798834178,0.8343019732317362
5,112,9,126,0.042735042735042736,0.9285714285714286,0.18603226329934827,0.8344875019886935
13,31,4,48,0.29545454545454547,0.9166666666666666,0.21395434122142618,0.8463922638934553
12,75,6,93,0.13793103448275862,0.9354838709677419,0.22807841757610595,0.8605183444331982
5,25,0,30,0.16666666666666666,1.0,0.22704322088873538,0.9014928737798205
9,65,2,76,0.12162162162162163,0.9736842105263158,0.1870078584234664,0.9306214506175985
12,35,1,48,0.2553191489361702,0.9791666666666666,0.16784292481284407,0.9374491817100354
7,53,2,62,0.11666666666666667,0.967741935483871,0.16234210379478167,0.9573306826975273
8,121,46,175,0.06201550387596899,0.7371428571428571,0.16509645538634254,0.929983743922017
12,101,98,211,0.10619469026548672,0.5355450236966824,0.13805933321647704,0.8755377949263049
44,85,6,135,0.34108527131782945,0.9555555555555556,0.16708136705005858,0.8784051784388497
4,37,22,63,0.0975609756097561,0.6507936507936508,0.15720912547049992,0.828518557123657
23,172,18,213,0.11794871794871795,0.9154929577464789,0.15668442494579943,0.8202055210122516
9,48,8,65,0.15789473684210525,0.8769230769230769,0.1427666517895044,0.8055992939060247
2,10,2,14,0.16666666666666666,0.8571428571428571,0.14990950893236157,0.7897994255715941
44,31,7,82,0.5866666666666667,0.9146341463414634,0.22485967504531837,0.8151553240285379
8,39,14,61,0.1702127659574468,0.7704918032786885,0.2340051144298841,0.8487191496831102
22,101,6,129,0.17886178861788618,0.9534883720930233,0.21083033118703504,0.8484238377598913
197,335,22,554,0.37030075187969924,0.9602888086642599,0.2497931563684555,0.8926374317414068
5,48,3,56,0.09433962264150944,0.9464285714285714,0.2464204284674257,0.8970568051245628
19,53,28,100,0.2638888888888889,0.72,0.2615624501883948,0.8746392227069805
1,1,0,2,0.5,1.0,0.3091814978074425,0.8950473859722866
1,15,1,17,0.0625,0.9411764705882353,0.23430054542649006,0.8988391465789682
13,66,21,100,0.16455696202531644,0.79,0.23349257343618574,0.9016260318248699
8,125,7,140,0.06015037593984962,0.95,0.2165338001964662,0.901127692954438
9,50,4,63,0.15254237288135594,0.9365079365079365,0.18542546033956,0.8977304255035347
2,21,6,29,0.08695652173913043,0.7931034482758621,0.1843707316392202,0.8758268364817191
3,14,7,24,0.17647058823529413,0.7083333333333334,0.17395362119253419,0.871413193574792
35,74,5,114,0.3211009174311927,0.956140350877193,0.14839660939699031,0.8651475294143909
40,53,9,102,0.43010752688172044,0.9117647058823529,0.20091197038009323,0.8609458487421221
26,57,25,108,0.3132530120481928,0.7685185185185185,0.2196883746986662,0.8584893105712981
102,263,31,396,0.27945205479452057,0.9217171717171717,0.25197650902590957,0.8555280432215416
7,83,10,100,0.07777777777777778,0.9,0.2412958525825413,0.8503126237204077
0,7,25,32,0.0,0.21875,0.22830883959552833,0.7693177257612241
2,10,2,14,0.16666666666666666,0.8571428571428571,0.22690827937143868,0.7905762291625847
1,9,3,13,0.1,0.7692307692307693,0.19532243402412544,0.7638748603559528
31,199,31,261,0.13478260869565217,0.8812260536398467,0.15313315999754426,0.7595121957498804
41,89,24,154,0.3153846153846154,0.8441558441558441,0.1534376747598903,0.7703175279837841
3,12,15,30,0.2,0.5,0.14208738121781597,0.7100722177384738
5,116,2,123,0.04132231404958678,0.983739837398374,0.1368794578280744,0.7220350516525272
4,42,4,50,0.08695652173913043,0.92,0.1493018180765216,0.8222136230810986
22,135,36,193,0.14012738853503184,0.8134715025906736,0.14551049262914523,0.8159748581450724
17,116,11,144,0.12781954887218044,0.9236111111111112,0.14948471389659954,0.8380291926994071
29,97,20,146,0.23015873015873015,0.863013698630137,0.1631098741056107,0.8354274276980199
5,100,5,110,0.047619047619047616,0.9545454545454546,0.12485765013910101,0.8511973720393929
45,142,30,217,0.24064171122994651,0.8617511520737328,0.13066360888623624,0.9028761080499261
6,78,1,85,0.07142857142857142,0.9882352941176471,0.13496450279751976,0.9035183161526793
6,45,3,54,0.11764705882352941,0.9444444444444444,0.13934886523814818,0.9070103796447428
3,27,6,36,0.1,0.8333333333333334,0.13361638116171506,0.9098477840365514
5,121,25,151,0.03968253968253968,0.8344370860927153,0.12102537984890924,0.897108637605352
17,76,36,129,0.1827956989247312,0.7209302325581395,0.11425923252976651,0.8768109995950667
43,64,32,139,0.40186915887850466,0.7697841726618705,0.16486639128111752,0.8504165307545547
36,59,7,102,0.37894736842105264,0.9313725490196079,0.1846243423084184,0.8603624446039654
11,42,16,69,0.20754716981132076,0.7681159420289855,0.20406985636309688,0.8289168228770137
13,94,18,125,0.12149532710280374,0.856,0.20461960897442175,0.816281902242093
13,31,4,48,0.29545454545454547,0.9166666666666666,0.23254168689649973,0.828186664146855
11,72,6,89,0.13253012048192772,0.9325842696629213,0.245805627010698,0.84220769037117
4,26,0,30,0.13333333333333333,1.0,0.23873957478335545,0.8820748000057217
10,76,5,91,0.11627906976744186,0.945054945054945,0.1979409906246322,0.9071134817761608
12,35,1,48,0.2553191489361702,0.9791666666666666,0.18027981641250612,0.9139412128685978
6,54,2,62,0.1,0.967741935483871,0.16491593501088886,0.9424592119335814
8,121,46,175,0.06201550387596899,0.7371428571428571,0.15641881740705535,0.9254796200968467
13,102,95,210,0.11304347826086956,0.5476190476190477,0.13036009352224448,0.8727585316614727
39,86,6,131,0.312,0.9541984732824428,0.15599864773911196,0.87584627503569
3,38,22,63,0.07317073170731707,0.6507936507936508,0.14740399036396679,0.8259596537204973
24,172,17,213,0.12244897959183673,0.92018779342723,0.14828540605316604,0.8224072034879665
9,48,8,65,0.15789473684210525,0.8769230769230769,0.13436763289687106,0.8078009763817394
2,10,2,14,0.16666666666666666,0.8571428571428571,0.14389144242068055,0.7920011080473088
44,31,6,81,0.5866666666666667,0.9259259259259259,0.21884160853363738,0.8189701178734615
8,39,14,61,0.1702127659574468,0.7704918032786885,0.22700864963314843,0.850809082967696
21,100,7,128,0.17355371900826447,0.9453125,0.20723060949147193,0.8495396582130612
198,335,21,554,0.3714821763602251,0.9620938628158845,0.24984653015617306,0.8940111170733803
4,49,3,56,0.07547169811320754,0.9464285714285714,0.2431354899449403,0.8977597996450005
18,53,28,99,0.2535211267605634,0.7171717171717171,0.25679640279043436,0.8749381768233777
1,1,0,2,0.5,1.0,0.3044154504094819,0.8953463400886837
1,15,1,17,0.0625,0.9411764705882353,0.2295344980285296,0.8975249893261567
13,65,21,99,0.16666666666666666,0.7878787878787878,0.22902791241556097,0.9000088442690279
7,126,6,139,0.05263157894736842,0.9568345323741008,0.21175332097829017,0.9016548488938996
9,50,4,63,0.15254237288135594,0.9365079365079365,0.1804762061955945,0.8979997165641925
2,20,6,28,0.09090909090909091,0.7857142857142857,0.1826815480235779,0.8750405328907233
3,14,7,24,0.17647058823529413,0.7083333333333334,0.17494618985851806,0.8728987649447796
36,72,6,114,0.3333333333333333,0.9473684210526315,0.15113666604899426,0.8653799679522983
39,53,9,101,0.42391304347826086,0.9108910891089109,0.20276710083160296,0.8610534848838233
25,55,28,108,0.3125,0.7407407407407407,0.21993743050193262,0.8531709667972237
103,261,30,394,0.28296703296703296,0.9238578680203046,0.25266898466205817,0.8515432624342456
5,85,10,100,0.05555555555555555,0.9,0.2388137250440867,0.8463278429331117
0,7,25,32,0.0,0.21875,0.2263913647956395,0.7642773503222743
2,10,2,14,0.16666666666666666,0.8571428571428571,0.22499080457154988,0.785535853723635
1,9,3,13,0.1,0.7692307692307693,0.19165747123821655,0.7600876177490832
30,198,33,261,0.13157894736842105,0.8735632183908046,0.14989545750823943,0.7547550647893537
42,86,24,152,0.328125,0.8421052631578947,0.15212760036538228,0.7692357108489472
3,13,14,30,0.1875,0.5333333333333333,0.1384894527986633,0.7134464916079513
6,115,2,123,0.049586776859504134,0.983739837398374,0.1376367701277988,0.7254093255220047
4,42,4,50,0.08695652173913043,0.92,0.15005913037624602,0.825587896950576
21,134,37,192,0.13548387096774195,0.8072916666666666,0.14560444527639962,0.8184662983111204
18,115,11,144,0.13533834586466165,0.9236111111111112,0.15065278039992272,0.8405206328654549
28,97,18,143,0.224,0.8741258741258742,0.16385578791871971,0.840601012256179
5,100,5,110,0.047619047619047616,0.9545454545454546,0.12378350900715508,0.8566638967401162
44,142,31,217,0.23655913978494625,0.8571428571428571,0.1307919575478617,0.9029224001414767
6,78,1,85,0.07142857142857142,0.9882352941176471,0.13391221391487132,0.90356460824423
6,45,4,55,0.11764705882352941,0.9272727272727272,0.13829657635549972,0.9046035692831911
3,27,6,36,0.1,0.8333333333333334,0.1332274519315366,0.9083238073784292
5,117,27,149,0.040983606557377046,0.8187919463087249,0.11974820345906736,0.8933496409780882
16,76,38,130,0.17391304347826086,0.7076923076923077,0.11259292395596177,0.8695734172018644
42,65,32,139,0.3925233644859813,0.7697841726618705,0.16186496922266658,0.8431789483613527
36,59,7,102,0.37894736842105264,0.9313725490196079,0.18220614474211036,0.8537831900580312
11,35,22,68,0.2391304347826087,0.6764705882352942,0.2061635537926871,0.8092453749319807
7,26,91,124,0.21212121212121213,0.2661290322580645,0.2196598614066418,0.7147962756441719
14,30,4,48,0.3181818181818182,0.9166666666666666,0.25082869257547297,0.7267010375489337
10,74,6,90,0.11904761904761904,0.9333333333333333,0.2619806943597932,0.7430640928381634
4,26,0,30,0.13333333333333333,1.0,0.2561835929105179,0.7848223345964052
10,76,5,91,0.11627906976744186,0.945054945054945,0.2167201222364408,0.8098610163668445
12,35,1,48,0.2553191489361702,0.9791666666666666,0.19905894802431473,0.8166887474592813
8,51,2,61,0.13559322033898305,0.9672131147540983,0.18426791738951107,0.8582233941048248
8,119,46,173,0.06299212598425197,0.7341040462427746,0.16296376222708817,0.925076967531212
13,100,96,209,0.11504424778761062,0.5406698564593302,0.13394410931362996,0.8713631375015926
41,86,6,133,0.3228346456692913,0.9548872180451128,0.1630565416881546,0.8744422638889897
3,38,22,63,0.07317073170731707,0.6507936507936508,0.15446188431300942,0.8245556425737968
24,172,16,212,0.12244897959183673,0.9245283018867925,0.15534330000220867,0.8216232649783465
9,48,8,65,0.15789473684210525,0.8769230769230769,0.1414255268459137,0.8070170378721194
2,10,2,14,0.16666666666666666,0.8571428571428571,0.14586459060701132,0.7912927153562278
44,31,6,81,0.5866666666666667,0.9259259259259259,0.22067523927592772,0.8186958410252494
7,38,15,60,0.15555555555555556,0.75,0.2264625689570627,0.8486001472453452
22,96,8,126,0.1864406779661017,0.9365079365079365,0.20697771642803567,0.8459745355971771
204,329,21,554,0.3827392120075047,0.9620938628158845,0.25120178504234814,0.8904459944574962
4,48,3,55,0.07692307692307693,0.9454545454545454,0.24469808466109674,0.893435457824318
18,53,28,99,0.2535211267605634,0.7171717171717171,0.2583589975065908,0.8706138350026952
1,1,0,2,0.5,1.0,0.30597804512563836,0.8910219982680012
1,15,1,17,0.0625,0.9411764705882353,0.231097092744686,0.8932006475054741
14,63,21,98,0.18181818181818182,0.7857142857142857,0.2348488964964898,0.8983026883218006
7,124,8,139,0.05343511450381679,0.9424460431654677,0.21584810171616334,0.8991509892728765
9,50,4,63,0.15254237288135594,0.9365079365079365,0.1829628389838564,0.8954958569431696
2,20,6,28,0.09090909090909091,0.7857142857142857,0.18496084098185836,0.8726758198374182
3,13,8,24,0.1875,0.6666666666666666,0.17792366495627474,0.8682686233119951
34,77,3,114,0.3063063063063063,0.9736842105263158,0.15025313728574705,0.8645092248157544
38,51,10,99,0.42696629213483145,0.898989898989899,0.20231975044786582,0.8584825717302779
24,58,25,107,0.2926829268292683,0.7663551401869159,0.21519850491352985,0.8539647634741518
105,259,29,393,0.28846153846153844,0.926208651399491,0.24877370833606152,0.8516451360790124
7,83,9,99,0.07777777777777778,0.9090909090909091,0.2380930518926932,0.8477284178765798
0,7,25,32,0.0,0.21875,0.225670691644246,0.7656779252657423
0,13,1,14,0.0,0.9285714285714286,0.19888497735853172,0.803092891252137
1,9,3,13,0.1,0.7692307692307693,0.16941264788620222,0.7738852567813446
30,200,30,260,0.13043478260869565,0.8846153846153846,0.12705100366818287,0.7718317547278426
42,85,24,151,0.33070866141732286,0.8410596026490066,0.13248325146647635,0.7825038207938555
2,11,17,30,0.15384615384615385,0.43333333333333335,0.11325248223570714,0.7120930610701188
5,116,2,123,0.04132231404958678,0.983739837398374,0.10804455884596555,0.7227571936854709
4,41,4,49,0.08888888888888889,0.9183673469387755,0.12074297154437827,0.8227025289624388
21,136,37,194,0.1337579617834395,0.8092783505154639,0.1398512517991553,0.8056606606687294
19,114,10,143,0.14285714285714285,0.9300699300699301,0.14597370077874716,0.8286376836457524
27,97,17,141,0.21774193548387097,0.8794326241134752,0.15844615118948652,0.8278972892883368
5,99,6,110,0.04807692307692308,0.9454545454545454,0.11807018856942939,0.8428108525462711
44,142,31,217,0.23655913978494625,0.8571428571428571,0.1298863294178283,0.9033550702333458
5,79,1,85,0.05952380952380952,0.9882352941176471,0.13248654305700297,0.9039972783360991
6,45,4,55,0.11764705882352941,0.9272727272727272,0.13659485304766592,0.9052694755266637
3,27,6,36,0.1,0.8333333333333334,0.13177228707860314,0.9087059016435022
6,116,27,149,0.04918032786885246,0.8187919463087249,0.11838988493741878,0.8928090468204728
16,79,35,130,0.16842105263157894,0.7307692307692307,0.11134404452994849,0.8715714191998665
41,65,42,148,0.3867924528301887,0.7162162162162162,0.15973197735184358,0.8388230864515337
36,59,7,102,0.37894736842105264,0.9313725490196079,0.18007315287128736,0.8494273281482123
10,22,36,68,0.3125,0.47058823529411764,0.21621260865360029,0.7754777483162796
11,92,21,124,0.10679611650485436,0.8306451612903226,0.2146624740366467,0.7616738103187933
13,30,5,48,0.3023255813953488,0.8958333333333334,0.24356612852169654,0.7706023817473646
12,72,5,89,0.14285714285714285,0.9438202247191011,0.25694853066288087,0.7884635643774184
4,26,0,30,0.13333333333333333,1.0,0.25193599933456007,0.8269251028389569
10,75,6,91,0.11764705882352941,0.9340659340659341,0.21348665733360875,0.8580464911032023
11,36,1,48,0.23404255319148937,0.9791666666666666,0.19278596944367113,0.8648742221956393
6,52,3,61,0.10344827586206896,0.9508196721311475,0.1629214374239667,0.9334787131723578
9,118,46,173,0.07086614173228346,0.7341040462427746,0.15778858388502798,0.9196871253084223
13,90,105,208,0.1262135922330097,0.4951923076923077,0.13262972829040812,0.8624526930739902
40,88,6,134,0.3125,0.9552238805970149,0.15686442216795915,0.8640817867708349
4,37,22,63,0.0975609756097561,0.6507936507936508,0.15175408535030524,0.8141951654556422
24,170,16,210,0.12371134020618557,0.9238095238095239,0.15262041126211326,0.8127299639904407
9,48,8,65,0.15789473684210525,0.8769230769230769,0.14174215178362984,0.7981237368842137
2,9,3,14,0.18181818181818182,0.7857142857142857,0.1529378526345031,0.7745372531103764
45,30,6,81,0.6,0.9259259259259259,0.22852840381560544,0.8019403787793979
6,39,14,59,0.13333333333333333,0.7627118644067796,0.22954550968708026,0.8401574583100367
19,98,9,126,0.1623931623931624,0.9285714285714286,0.2081016757432463,0.8363499651635244
204,328,21,553,0.38345864661654133,0.9620253164556962,0.24894420017278707,0.8808116316866738
5,47,3,55,0.09615384615384616,0.9454545454545454,0.24500741530816714,0.8839037776359626
17,52,29,98,0.2463768115942029,0.7040816326530612,0.25764771170132394,0.8592121427402459
1,1,0,2,0.5,1.0,0.3031022571558694,0.8898243876382053
1,15,1,17,0.0625,0.9411764705882353,0.2263165428701551,0.8920030368756781
15,63,20,98,0.19230769230769232,0.7959183673469388,0.23474145129506355,0.8967468230099864
7,123,9,139,0.05384615384615385,0.935251798561151,0.21923473578834804,0.8977011615799467
9,50,4,63,0.15254237288135594,0.9365079365079365,0.18624669668332158,0.8940558215874096
2,21,6,29,0.08695652173913043,0.7931034482758621,0.184932793195505,0.872291379133312
3,13,8,24,0.1875,0.6666666666666666,0.17667999943082607,0.8672130286603413
35,75,4,114,0.3181818181818182,0.9649122807017544,0.1507059734568001,0.8622004973320205
37,54,10,101,0.4065934065934066,0.900990099009901,0.19986217439871531,0.8564595871065441
24,58,25,107,0.2926829268292683,0.7663551401869159,0.21454924712839377,0.8519417788504182
105,261,29,395,0.28688524590163933,0.9265822784810127,0.24789926589951125,0.8496755267526389
6,84,9,99,0.06666666666666667,0.9090909090909091,0.2356313078688414,0.8457588085502064
0,7,25,32,0.0,0.21875,0.22264429488182838,0.7647639105910227
0,13,1,14,0.0,0.9285714285714286,0.1958585805961141,0.8021788765774174
1,9,3,13,0.1,0.7692307692307693,0.16468974942728296,0.7742243749387052
35,195,31,261,0.15217391304347827,0.8812260536398467,0.1283441074915789,0.7714009398858402
44,84,25,153,0.34375,0.8366013071895425,0.1356394036588263,0.7814361066005012
2,11,17,30,0.15384615384615385,0.43333333333333335,0.11663381907947123,0.7109719715794042
6,115,2,123,0.049586776859504134,0.983739837398374,0.11419383482130516,0.7216361041947562
4,42,4,50,0.08695652173913043,0.92,0.12661619506975236,0.8218146756233277
20,136,37,193,0.1282051282051282,0.8082901554404145,0.14493121338477066,0.8046316366046115
19,114,10,143,0.14285714285714285,0.9300699300699301,0.15105366236436252,0.8276086595816344
28,96,18,142,0.22580645161290322,0.8732394366197183,0.16157259644570893,0.8264677142930446
5,99,6,110,0.04807692307692308,0.9454545454545454,0.11933358545669794,0.8420181769023307
44,142,31,217,0.23655913978494625,0.8571428571428571,0.13114972630509686,0.9025623945894056
6,78,1,85,0.07142857142857142,0.9882352941176471,0.13426998267210646,0.9032046026921589
6,45,4,55,0.11764705882352941,0.9272727272727272,0.1386543451127349,0.9042435637311198
3,27,6,36,0.1,0.8333333333333334,0.13462504108343085,0.9078211605729655
6,116,27,149,0.04918032786885246,0.8187919463087249,0.12124263894224652,0.8919243057499361
16,78,36,130,0.1702127659574468,0.7230769230769231,0.11330068384860989,0.8704725181009654
43,63,42,148,0.4056603773584906,0.7162162162162162,0.16438403446026237,0.8377241853526326
36,59,7,102,0.37894736842105264,0.9313725490196079,0.18472520997970615,0.8483284270493113
8,22,38,68,0.26666666666666666,0.4411764705882353,0.21261636644229118,0.7701771665451097
8,25,91,124,0.24242424242424243,0.2661290322580645,0.23044167838525018,0.6757280672573006
13,31,4,48,0.29545454545454547,0.9166666666666666,0.2583637563073281,0.6876328291620626
13,73,5,91,0.1511627906976744,0.945054945054945,0.2729326795685884,0.7056704004115225
4,26,0,30,0.13333333333333333,1.0,0.26766418919371504,0.7452308399719622
10,74,7,91,0.11904761904761904,0.9230769230769231,0.22671950943501912,0.7747823695234918
11,37,1,49,0.22916666666666666,0.9795918367346939,0.20532226632724968,0.7816708391970754
7,50,5,62,0.12280701754385964,0.9193548387096774,0.1847708878811344,0.8499820346429957
9,117,46,172,0.07142857142857142,0.7325581395348837,0.16034293488175283,0.9166147642539698
13,90,107,210,0.1262135922330097,0.49047619047619045,0.13616565585010484,0.8557304105124732
43,83,6,132,0.3412698412698413,0.9545454545454546,0.16332380593184298,0.857086197582546
5,37,22,64,0.11904761904761904,0.65625,0.16128298960531237,0.8079790547254032
24,170,16,210,0.12371134020618557,0.9238095238095239,0.1619492354851076,0.8080837119729176
9,48,8,65,0.15789473684210525,0.8769230769230769,0.15176753122445596,0.7934167462855438
2,10,2,14,0.16666666666666666,0.8571428571428571,0.15803319538485697,0.7845293203474266
45,30,6,81,0.6,0.9259259259259259,0.23354339946648958,0.8121532898318612
8,38,14,60,0.17391304347826086,0.7666666666666667,0.24035760678723977,0.8516090721447863
20,96,10,126,0.1724137931034483,0.9206349206349206,0.21623531419204076,0.8467647101575674
199,334,20,553,0.37335834896810505,0.9638336347197106,0.2525654184663959,0.8907052294032402
5,47,3,55,0.09615384615384616,0.9454545454545454,0.248628633601776,0.893797375352529
17,52,30,99,0.2463768115942029,0.696969696969697,0.26126892999493284,0.8680897496449032
1,1,0,2,0.5,1.0,0.3088879776139804,0.8884979129102094
1,15,1,17,0.0625,0.9411764705882353,0.23210226332826614,0.8906765621476822
16,63,20,99,0.20253164556962025,0.797979797979798,0.2361906350556032,0.8951498666209865
7,124,8,139,0.05343511450381679,0.9424460431654677,0.21919368096994155,0.8982657412682077
9,50,4,63,0.15254237288135594,0.9365079365079365,0.18764854152897742,0.894362070095097
2,21,6,29,0.08695652173913043,0.7931034482758621,0.18633463804116085,0.8725976276409995
3,13,8,24,0.1875,0.6666666666666666,0.1884836699225976,0.8692685271187175
35,71,8,114,0.330188679245283,0.9298245614035088,0.1642249098147809,0.8592434644620759
37,54,10,101,0.4065934065934066,0.900990099009901,0.2133811107566961,0.8535025542365995
24,58,25,107,0.2926829268292683,0.7663551401869159,0.2226432286943312,0.8489847459804736
103,260,41,404,0.2837465564738292,0.8985148514851485,0.25565965405525415,0.8406533629963375
6,84,9,99,0.06666666666666667,0.9090909090909091,0.24339169602458427,0.836736644793905
0,7,25,32,0.0,0.21875,0.22391117654406476,0.7557417468347214
0,12,2,14,0.0,0.8571428571428571,0.19712546225835048,0.7829526311884628
1,9,3,13,0.1,0.7692307692307693,0.1642413652233101,0.7600106608780715
35,195,34,264,0.15217391304347827,0.8712121212121212,0.12789572328760604,0.7557566640498171
44,83,26,153,0.3464566929133858,0.8300653594771242,0.1355776898710514,0.7648581239484186
2,11,17,30,0.15384615384615385,0.43333333333333335,0.1170204894956692,0.698403621355302
5,116,2,123,0.04132231404958678,0.983739837398374,0.11339986769322921,0.7090677539706541
4,42,4,50,0.08695652173913043,0.92,0.1258222279416764,0.8092463253992256
20,137,36,193,0.12738853503184713,0.8134715025906736,0.14402059008908316,0.8030075604631993
19,114,11,144,0.14285714285714285,0.9236111111111112,0.15014303906867502,0.8250618950175338
29,95,20,144,0.23387096774193547,0.8611111111111112,0.1618140468827403,0.8236188935745324
5,99,6,110,0.04807692307692308,0.9454545454545454,0.11918836547753132,0.8401030629998784
44,142,31,217,0.23655913978494625,0.8571428571428571,0.13100450632593025,0.9006472806869531
6,77,1,84,0.07228915662650602,0.9880952380952381,0.13542834097977585,0.9012694807865052
6,45,4,55,0.11764705882352941,0.9272727272727272,0.13981270342040428,0.9023084418254663
3,27,6,36,0.1,0.8333333333333334,0.13590005555871185,0.9051458462172748
6,116,27,149,0.04918032786885246,0.8187919463087249,0.1225176534175275,0.8901716798169338
16,78,36,130,0.1702127659574468,0.7230769230769231,0.11342362459117197,0.8704525100977641
44,62,42,148,0.41509433962264153,0.7162162162162162,0.16585468409770318,0.8377041773494315
37,58,7,102,0.3894736842105263,0.9313725490196079,0.1876996190156432,0.84830841904611
8,17,43,68,0.32,0.36764705882352944,0.22308688235471377,0.7596729648644374
7,100,18,125,0.06542056074766354,0.856,0.21562595405816148,0.7494911466826192
13,31,4,48,0.29545454545454547,0.9166666666666666,0.24354803198023942,0.761395908587381
12,75,5,92,0.13793103448275862,0.9456521739130435,0.25622670435365463,0.7795187982451408
5,25,0,30,0.16666666666666666,1.0,0.255720118740686,0.8190792378055803
11,73,7,91,0.13095238095238096,0.9230769230769231,0.21512841035922017,0.8486307673571101
12,36,1,49,0.25,0.9795918367346939,0.195203598329145,0.8555192370306938
6,52,4,62,0.10344827586206896,0.9354838709677419,0.16426763773801198,0.9366387816227241
9,117,46,172,0.07142857142857142,0.7325581395348837,0.16512592497814169,0.9190042301277074
14,86,110,210,0.14,0.47619047619047616,0.14291813277034948,0.8560790600596803
41,86,6,133,0.3228346456692913,0.9548872180451128,0.16933293436842559,0.8573983520785473
4,38,22,64,0.09523809523809523,0.65625,0.15912885273577254,0.8082912092214044
23,171,17,211,0.11855670103092783,0.919431279620853,0.15735804131842207,0.8077704030133945
9,48,8,65,0.15789473684210525,0.8769230769230769,0.14420014658157995,0.7931034373260205
1,12,2,15,0.07692307692307693,0.8666666666666667,0.14041083244743827,0.7832724081401528
45,30,6,81,0.6,0.9259259259259259,0.2159210365290709,0.8108963776245872
8,38,14,60,0.17391304347826086,0.7666666666666667,0.22076575702596532,0.8523929762640431
20,98,8,126,0.1694915254237288,0.9365079365079365,0.19885959699088498,0.8497673646158751
121,337,96,554,0.26419213973799127,0.8267148014440433,0.22299588906229867,0.8741194791078813
4,48,3,55,0.07692307692307693,0.9454545454545454,0.21704822847546285,0.8778370885126945
17,52,30,99,0.2463768115942029,0.696969696969697,0.22968852486861963,0.8521294628050686
1,1,0,2,0.5,1.0,0.29012808530818013,0.8711770818526878
1,15,1,17,0.0625,0.9411764705882353,0.2133423710224658,0.8733557310901604
15,64,20,99,0.189873417721519,0.797979797979798,0.21562242448578842,0.877829035563465
7,124,8,139,0.05343511450381679,0.9424460431654677,0.19904293721151523,0.8786773365145407
9,50,4,63,0.15254237288135594,0.9365079365079365,0.1830929705177102,0.894362070095097
2,20,6,28,0.09090909090909091,0.7857142857142857,0.1850909725157122,0.8715420329893456
2,13,10,25,0.13333333333333333,0.6,0.18133638959910142,0.8593756869072751
35,74,5,114,0.3211009174311927,0.956140350877193,0.15577937780355752,0.8531100227468739
39,51,10,100,0.43333333333333335,0.9,0.20875556827974803,0.8472276698056975
24,55,27,106,0.3037974683544304,0.7452830188679245,0.21918817364906223,0.8411425599470028
104,259,41,404,0.2865013774104683,0.8985148514851485,0.25242463415825,0.8358944246504308
6,84,9,99,0.06666666666666667,0.9090909090909091,0.24015667612758013,0.8319777064479984
0,7,25,32,0.0,0.21875,0.22067615664706067,0.746825590045882
2,11,1,14,0.15384615384615385,0.9285714285714286,0.22360655957746361,0.7937643655560862
1,9,3,13,0.1,0.7692307692307693,0.19202071423015035,0.7670629967494541
36,191,37,264,0.15859030837004406,0.8598484848484849,0.15277171066396616,0.7613270660135235
44,82,27,153,0.3492063492063492,0.8235294117647058,0.15925869364281173,0.7725051221416351
3,13,14,30,0.1875,0.5333333333333333,0.1451156397270305,0.7203363338342329
5,116,2,123,0.04132231404958678,0.983739837398374,0.14149501792459054,0.7310004664495852
4,42,4,50,0.08695652173913043,0.92,0.15391737817303772,0.8311790378781565
20,137,36,193,0.12738853503184713,0.8134715025906736,0.15013771834242254,0.8147361913094772
20,113,11,144,0.15037593984962405,0.9236111111111112,0.15733428117808307,0.8367905258638118
30,94,22,146,0.24193548387096775,0.8493150684931506,0.1692407348210722,0.8352857520987641
6,99,5,110,0.05714285714285714,0.9545454545454546,0.1275173788120019,0.8540023296388709
45,140,32,217,0.24324324324324326,0.8525345622119815,0.13548069927532233,0.8996025051929636
6,77,1,84,0.07228915662650602,0.9880952380952381,0.13990453392916796,0.9002247052925156
6,45,4,55,0.11764705882352941,0.9272727272727272,0.14428889636979636,0.9012636663314766
3,27,6,36,0.1,0.8333333333333334,0.14037624850810393,0.9041010707232852
6,116,27,149,0.04918032786885246,0.8187919463087249,0.12591973251085084,0.8891269043229444
14,80,36,130,0.14893617021276595,0.7230769230769231,0.11263411627396487,0.8710928835491974
44,62,42,148,0.41509433962264153,0.7162162162162162,0.1637700423425055,0.8370458495021634
37,58,7,102,0.3894736842105263,0.9313725490196079,0.18466010533783164,0.8483084190461101
12,27,28,67,0.3076923076923077,0.582089552238806,0.21828912691866045,0.7903076067809055
6,110,10,126,0.05172413793103448,0.9206349206349206,0.20887156679116117,0.7893593486897902
14,30,4,48,0.3181818181818182,0.9166666666666666,0.24004039795999235,0.8012641105945522
14,74,5,93,0.1590909090909091,0.946236559139785,0.2557419095631433,0.8194704838561321
4,26,0,30,0.13333333333333333,1.0,0.2535129328660815,0.8590309234165717
12,65,1,78,0.15584415584415584,0.9871794871794872,0.21647719232629783,0.8977399621256102
12,36,1,49,0.25,0.9795918367346939,0.19655238029622263,0.904628431799194
9,48,5,62,0.15789473684210525,0.9193548387096774,0.1751527273176223,0.9528091870093186
9,117,46,172,0.07142857142857142,0.7325581395348837,0.177967646388699,0.925941075423599
16,93,101,210,0.14678899082568808,0.5190476190476191,0.1534829567663947,0.8691383543351636
43,84,6,133,0.33858267716535434,0.9548872180451128,0.1791246379198869,0.8703741627502105
4,39,21,64,0.09302325581395349,0.671875,0.17336605541711833,0.8234991627502105
24,172,17,213,0.12244897959183673,0.92018779342723,0.16859531595250132,0.8139289207856023
9,47,9,65,0.16071428571428573,0.8615384615384616,0.15584021391168498,0.7970641529004263
2,11,2,15,0.15384615384615385,0.8666666666666667,0.15526184491226336,0.7895372711799962
45,30,6,81,0.6,0.9259259259259259,0.230772048993896,0.8171612406644309
8,37,13,58,0.17777777777777778,0.7758620689655172,0.23519901855848024,0.8538490192241305
22,95,9,126,0.18803418803418803,0.9285714285714286,0.21369209153974222,0.85008962072789
122,334,98,554,0.2675438596491228,0.8231046931407943,0.2386236063733378,0.8716938626051461
5,48,3,56,0.09433962264150944,0.9464285714285714,0.2346079839518625,0.8754425451767665
17,52,30,99,0.2463768115942029,0.696969696969697,0.24684548764899353,0.851932721666943
1,1,0,2,0.5,1.0,0.29629603709954294,0.870980340714562
1,15,1,17,0.0625,0.9411764705882353,0.21951032281382868,0.8731589899520348
18,61,20,99,0.22784810126582278,0.797979797979798,0.22666322616926365,0.8763186655255035
7,126,6,139,0.05263157894736842,0.9568345323741008,0.207319996299718,0.880356251783028
9,50,4,63,0.15254237288135594,0.9365079365079365,0.1908912124757513,0.8965567151211912
3,19,6,28,0.13636363636363635,0.7857142857142857,0.19689464300748374,0.8735975314477218
2,13,10,25,0.13333333333333333,0.6,0.17725826221270338,0.8624589345948391
34,72,8,114,0.32075471698113206,0.9298245614035088,0.15165179321000793,0.8524338719381976
39,50,10,99,0.43820224719101125,0.898989898989899,0.20532354280872384,0.8464072188527211
25,53,28,106,0.32051282051282054,0.7358490566037735,0.214481051966233,0.8389744000991476
107,259,38,404,0.2923497267759563,0.905940594059406,0.24980061551210003,0.8317038374827626
6,83,9,98,0.06741573033707865,0.9081632653061225,0.23763966657720328,0.8276545987396462
0,7,25,32,0.0,0.21875,0.22465265359019027,0.7425024823375299
2,10,2,14,0.16666666666666666,0.8571428571428571,0.229414558352095,0.7792371762150809
1,9,3,13,0.1,0.7692307692307693,0.1978781702119333,0.7562952059046896
33,192,39,264,0.14666666666666667,0.8522727272727273,0.15623023013702694,0.749621324230808
44,81,27,152,0.352,0.8223684210526315,0.16072839863519545,0.7619812334377876
3,14,13,30,0.17647058823529413,0.5666666666666667,0.14417423598652943,0.7135135295245391
7,114,2,123,0.05785123966942149,0.983739837398374,0.1428078801768641,0.724310182680575
4,42,4,50,0.08695652173913043,0.92,0.15523024042531128,0.8244887541091465
19,137,37,193,0.12179487179487179,0.8082901554404145,0.1488199840150549,0.8175097967230833
18,112,11,141,0.13846153846153847,0.9219858156028369,0.15431448950956042,0.8393319462048072
29,93,23,145,0.23770491803278687,0.8413793103448276,0.1673199539904347,0.8377757437865359
6,95,5,106,0.0594059405940594,0.9528301886792453,0.1255208026467289,0.8564131391617663
45,140,32,217,0.24324324324324326,0.8525345622119815,0.13505975336215023,0.8972514099539541
5,76,1,82,0.06172839506172839,0.9878048780487805,0.13561363270390833,0.8978321300468695
6,45,3,54,0.11764705882352941,0.9444444444444444,0.13999799514453676,0.9013241935389329
3,27,6,36,0.1,0.8333333333333334,0.13688444203098366,0.9049017903807784
5,117,27,149,0.040983606557377046,0.8187919463087249,0.12295902318753203,0.8901598090530481
15,78,37,130,0.16129032258064516,0.7153846153846154,0.11204265240865464,0.872160566915875
44,62,42,148,0.41509433962264153,0.7162162162162162,0.16285528084130924,0.8383585708497279
37,57,7,101,0.39361702127659576,0.9306930693069307,0.18433724913178814,0.8495240718632922
11,36,20,67,0.23404255319148937,0.7014925373134329,0.20895355743603972,0.8086223089010998
7,107,10,124,0.06140350877192982,0.9193548387096774,0.2009187645715255,0.8050380795104186
14,30,4,48,0.3181818181818182,0.9166666666666666,0.23208759574035667,0.8169428414151805
12,73,8,93,0.1411764705882353,0.9139784946236559,0.24640086203047926,0.830540919745885
4,26,0,30,0.13333333333333333,1.0,0.24240700642372046,0.8712002604052255
9,66,2,77,0.12,0.974025974025974,0.20025067219191447,0.9080302258066196
12,36,1,49,0.25,0.9795918367346939,0.17973395486668656,0.9150157640105857
6,54,2,62,0.1,0.967741935483871,0.16058501869647376,0.9530513923206484
9,117,46,172,0.07142857142857142,0.7325581395348837,0.16201717050456543,0.9263661495813921
12,86,112,210,0.12244897959183673,0.4666666666666667,0.13405533642028236,0.8620804352956778
41,85,6,132,0.3253968253968254,0.9545454545454546,0.16037252996436666,0.8678757152845061
4,38,22,64,0.09523809523809523,0.65625,0.15493035309361838,0.8187685724273633
25,171,17,213,0.12755102040816327,0.92018779342723,0.15600907029478456,0.8110774037703999
9,47,9,65,0.16071428571428573,0.8615384615384616,0.14325396825396822,0.7942126358852238
2,11,2,15,0.15384615384615385,0.8666666666666667,0.1509462759462759,0.7797733117684803
45,30,6,81,0.6,0.9259259259259259,0.22645648002790858,0.8073972812529151
8,36,13,57,0.18181818181818182,0.7719298245614035,0.2349377946316722,0.851006303809306
22,95,8,125,0.18803418803418803,0.936,0.21531456072272398,0.8483569531599553
124,331,99,554,0.2725274725274725,0.8212996389891697,0.24064161462120645,0.871935473015551
5,48,3,56,0.09433962264150944,0.9464285714285714,0.23589712922597017,0.8756841555871712
18,52,26,96,0.2571428571428571,0.7291666666666666,0.24967263943005177,0.8567738991769148
1,1,0,2,0.5,1.0,0.29912318888060124,0.8758215182245338
1,15,1,17,0.0625,0.9411764705882353,0.22233747459488695,0.8780001674620067
18,60,21,99,0.23076923076923078,0.7878787878787878,0.229330481587894,0.8802785907930615
7,123,9,139,0.05384615384615385,0.935251798561151,0.2101607624181748,0.8801717048732259
9,50,4,63,0.15254237288135594,0.9365079365079365,0.19302003389730102,0.8966300330901927
3,19,5,27,0.13636363636363635,0.8148148148148148,0.1990234644290334,0.8778280678596558
2,13,10,25,0.13333333333333333,0.6,0.17966000907889526,0.8331027599784023
36,72,6,114,0.3333333333333333,0.9473684210526315,0.15585048526937142,0.825583962985921
38,51,9,98,0.42696629213483145,0.9081632653061225,0.20494090795529973,0.8481787151725101
25,54,27,106,0.31645569620253167,0.7452830188679245,0.21718183158862844,0.8420936053138153
103,261,39,403,0.28296703296703296,0.9032258064516129,0.2511121869475552,0.8354629651255049
7,82,9,98,0.07865168539325842,0.9081632653061225,0.2381350669432023,0.8314137263823886
0,7,25,32,0.0,0.21875,0.22452962476633154,0.7472791109977733
3,9,2,14,0.25,0.8571428571428571,0.2411962914329982,0.7840138048753243
1,9,3,13,0.1,0.7692307692307693,0.2078629580996649,0.7585655689007725
26,61,177,264,0.2988505747126437,0.32954545454545453,0.1895607127536381,0.6759058816492487
45,69,37,151,0.39473684210526316,0.7549668874172185,0.20074373359688544,0.6772892914420049
3,13,14,30,0.1875,0.5333333333333333,0.18710558603016647,0.6244475095679649
7,114,2,123,0.05785123966942149,0.983739837398374,0.18413409378390402,0.6352441627240009
4,42,4,50,0.08695652173913043,0.92,0.19655645403235125,0.7354227341525723
19,137,37,193,0.12179487179487179,0.8082901554404145,0.17824143571733295,0.7284437767665092
18,112,11,141,0.13846153846153847,0.9219858156028369,0.18373594121183842,0.7502659262482332
28,94,22,144,0.22950819672131148,0.8472222222222222,0.17382988721307666,0.8242197502020571
5,96,5,106,0.04950495049504951,0.9528301886792453,0.1245110455544747,0.8524859360966323
44,140,33,217,0.2391304347826087,0.847926267281106,0.13188682195199022,0.897427783803457
6,75,1,82,0.07407407407407407,0.9878048780487805,0.13420436972408348,0.8980085038963722
6,45,3,54,0.11764705882352941,0.9444444444444444,0.13858873216471188,0.9015005673884355
3,27,6,36,0.1,0.8333333333333334,0.13547517905115877,0.9050781642302812
5,117,27,149,0.040983606557377046,0.8187919463087249,0.12154976020770715,0.8903361829025508
15,80,35,130,0.15789473684210525,0.7307692307692307,0.11131926593924911,0.8737000412664092
41,65,33,139,0.3867924528301887,0.762589928057554,0.15950319484426898,0.8465228611775962
37,57,7,101,0.39361702127659576,0.9306930693069307,0.18157270720055285,0.8583466900384283
11,35,21,67,0.2391304347826087,0.6865671641791045,0.2051521873017721,0.8153127309141889
8,106,11,125,0.07017543859649122,0.912,0.19837052726933807,0.8106778102792681
14,30,4,48,0.3181818181818182,0.9166666666666666,0.22953935843816925,0.8225825721840302
14,72,7,93,0.16279069767441862,0.9247311827956989,0.24694037145488945,0.8377167488250264
5,25,0,30,0.16666666666666666,1.0,0.24819350428696965,0.8761782872865649
10,65,1,76,0.13333333333333333,0.9868421052631579,0.21198505864456177,0.9082143126016512
12,35,1,48,0.2553191489361702,0.9791666666666666,0.19222821973878665,0.9151391122244706
7,51,4,62,0.1206896551724138,0.9354838709677419,0.17530810836590166,0.9506986417657045
9,116,46,171,0.072,0.7309941520467836,0.17556875999497437,0.9248406634866735
10,87,111,208,0.10309278350515463,0.46634615384615385,0.14484175504116528,0.8605091616551718
44,80,8,132,0.3548387096774194,0.9393939393939394,0.17227718532730824,0.8626038411692062
3,38,22,63,0.07317073170731707,0.6507936507936508,0.15892062319025832,0.8127172198540134
23,172,17,212,0.11794871794871795,0.9198113207547169,0.1567228209924561,0.8031413934956646
9,47,9,65,0.16071428571428573,0.8615384615384616,0.1432078405321869,0.7863373641916355
2,11,2,15,0.15384615384615385,0.8666666666666667,0.14794448319986406,0.7765063350057675
46,29,6,81,0.6133333333333333,0.9259259259259259,0.2252778165331974,0.8043537312742164
9,35,13,57,0.20454545454545456,0.7719298245614035,0.23977105525324025,0.848008541376395
22,97,6,125,0.18487394957983194,0.952,0.21549037523929918,0.8498094071772607
122,328,103,553,0.27111111111111114,0.8137432188065099,0.24376757229698404,0.8730879168933834
5,48,3,56,0.09433962264150944,0.9464285714285714,0.24039484439595424,0.8768903812753627
16,52,27,95,0.23529411764705882,0.7157894736842105,0.25104910610063613,0.856069097296184
1,1,0,2,0.5,1.0,0.3004996555511856,0.875116716343803
1,15,1,17,0.0625,0.9411764705882353,0.22180917936070937,0.8772953655812757
20,58,21,99,0.2564102564102564,0.7878787878787878,0.22921843676996678,0.8795737889123306
6,127,6,139,0.045112781954887216,0.9568345323741008,0.20925255568068898,0.880264436394345
9,50,4,63,0.15254237288135594,0.9365079365079365,0.19231416450500965,0.8978022532088346
2,20,5,27,0.09090909090909091,0.8148148148148148,0.1918240885432356,0.8790002879782979
2,13,10,25,0.13333333333333333,0.6,0.17797951902631218,0.8371623694336952
35,71,8,114,0.330188679245283,0.9298245614035088,0.15372075891849546,0.8271373067770534
35,49,10,94,0.4166666666666667,0.8936170212765957,0.20133980653754308,0.8405111669594243
25,51,28,104,0.32894736842105265,0.7307692307692307,0.21719675660501947,0.8323526588009161
101,255,47,403,0.28370786516853935,0.8833746898263027,0.2510819333566713,0.8259693924965544
6,84,9,99,0.06666666666666667,0.9090909090909091,0.2363926678199481,0.822052674294122
0,7,25,32,0.0,0.21875,0.22278722564307737,0.7379180589095066
2,10,2,14,0.16666666666666666,0.8571428571428571,0.2275491304049821,0.7746527527870578
1,9,3,13,0.1,0.7692307692307693,0.1946650333699417,0.7517107824766663
26,59,179,264,0.3058823529411765,0.32196969696969696,0.1788387028377288,0.6700468790042521
45,63,42,150,0.4166666666666667,0.72,0.19137003115853082,0.6685084174657907
3,13,14,30,0.1875,0.5333333333333333,0.17762605042016805,0.6185025093953664
9,112,2,123,0.0743801652892562,0.983739837398374,0.1787279787948237,0.6291666420107186
5,41,4,50,0.10869565217391304,0.92,0.1942559291053827,0.7293452134392899
20,135,37,192,0.12903225806451613,0.8072916666666666,0.18887958501936117,0.7222236147998343
18,114,10,142,0.13636363636363635,0.9295774647887324,0.1940743902141664,0.745130285593829
29,92,23,144,0.2396694214876033,0.8402777777777778,0.18461540000651305,0.8191742971378405
5,96,5,106,0.04950495049504951,0.9528301886792453,0.1321637262677106,0.8524357526634471
44,141,32,217,0.23783783783783785,0.8525345622119815,0.1393548459588303,0.8980359282175396
6,75,1,82,0.07407407407407407,0.9878048780487805,0.13931111864237572,0.8986166483104547
6,41,7,54,0.1276595744680851,0.8703703703703703,0.14202025039868602,0.8915267012205076
3,29,4,36,0.09375,0.8888888888888888,0.13697992781804086,0.9031834472522539
5,117,27,149,0.040983606557377046,0.8187919463087249,0.12335420927428951,0.8873569446122527
15,79,36,130,0.1595744680851064,0.7230769230769231,0.11191207307393282,0.8706139653692734
43,63,33,139,0.4056603773584906,0.762589928057554,0.16279141976871012,0.8434367852804604
37,57,7,101,0.39361702127659576,0.9306930693069307,0.18504558883138983,0.8546022862940246
10,35,24,69,0.2222222222222222,0.6521739130434783,0.20620960999541096,0.8066550055789813
6,105,14,125,0.05405405405405406,0.888,0.19569453565054942,0.8091735240974999
14,30,4,48,0.3181818181818182,0.9166666666666666,0.2277562239622377,0.8131417780657538
12,74,7,93,0.13953488372093023,0.9247311827956989,0.24183497784274532,0.8282759547067501
5,24,1,30,0.1724137931034483,0.9666666666666667,0.24366916713107986,0.8630744895052851
10,66,1,77,0.13157894736842105,0.987012987012987,0.20451467713249855,0.8951349264989182
12,35,1,48,0.2553191489361702,0.9791666666666666,0.18475783822672343,0.9020597261217377
9,49,3,61,0.15517241379310345,0.9508196721311475,0.17517929416542075,0.9447234059914047
8,115,47,170,0.06504065040650407,0.7235294117647059,0.17674880793005646,0.921227607672077
12,84,111,207,0.125,0.463768115942029,0.14915140533265386,0.8565278147114145
45,80,7,132,0.36,0.946969696969697,0.18064642194394956,0.8597047453076999
2,38,23,63,0.05,0.6349206349206349,0.16315873721488552,0.8123124550582668
23,169,17,209,0.11979166666666667,0.9186602870813397,0.16147483997177772,0.80254778363946
9,47,9,65,0.16071428571428573,0.8615384615384616,0.14795985951150853,0.7857437543354308
1,12,2,15,0.07692307692307693,0.8666666666666667,0.13678138281579044,0.7737218964119335
46,29,6,81,0.6133333333333333,0.9259259259259259,0.2151089089481946,0.8026356841492507
9,34,13,56,0.20930232558139536,0.7678571428571429,0.2271520983169654,0.8460769737085526
20,97,6,123,0.17094017094017094,0.9512195121951219,0.2001435513084184,0.8466840901693276
119,332,98,549,0.2638580931263858,0.8214936247723132,0.23069470746933066,0.8733373744338531
5,48,3,56,0.09433962264150944,0.9464285714285714,0.22705870118002247,0.8773042721977432
16,52,27,95,0.23529411764705882,0.7157894736842105,0.23771296288470434,0.8564829882185646
1,1,0,2,0.5,1.0,0.2981525233242648,0.8755306072661836
1,11,4,16,0.08333333333333333,0.75,0.22243823760997908,0.8503983321339085
18,60,21,99,0.23076923076923078,0.7878787878787878,0.2255049383510984,0.8532585671370007
6,126,7,139,0.045454545454545456,0.9496402877697842,0.2075784204245805,0.8530329636476666
10,49,4,63,0.1694915254237288,0.9365079365079365,0.1940974821813438,0.8694635796098985
2,19,5,26,0.09523809523809523,0.8076923076923077,0.19422583540942745,0.8496441133618609
1,13,11,25,0.07142857142857142,0.56,0.169177965316617,0.817529974756252
35,73,6,114,0.32407407407407407,0.9473684210526315,0.14404569018434188,0.8100111777637709
36,46,10,92,0.43902439024390244,0.8913043478260869,0.19377644723217208,0.825095472351171
25,50,28,103,0.3333333333333333,0.7281553398058253,0.21025996371568859,0.8165635511978906
97,255,50,402,0.2755681818181818,0.8756218905472637,0.2430334402391651,0.8060945199204924
6,84,10,100,0.06666666666666667,0.9,0.2307654822084952,0.8008791004193586
0,7,25,32,0.0,0.21875,0.21572788822353278,0.7315999998902581
2,10,2,14,0.16666666666666666,0.8571428571428571,0.22933333040040352,0.7740489794820948
1,9,3,13,0.1,0.7692307692307693,0.19732274838982153,0.7486007435075432
25,60,178,263,0.29411764705882354,0.3231939163498099,0.17662178507766743,0.6674421104395034
42,62,43,147,0.40384615384615385,0.7074829931972789,0.18669504515092747,0.6644889180668541
4,12,14,30,0.25,0.5333333333333333,0.1830424477483301,0.6155905527505782
9,112,2,123,0.0743801652892562,0.983739837398374,0.18414437612298573,0.6275533866646317
5,40,4,49,0.1111111111111111,0.9183673469387755,0.20001739199600158,0.7274987219415997
20,133,38,191,0.13071895424836602,0.8010471204188482,0.19488200450767293,0.7194850452667413
20,110,12,142,0.15384615384615385,0.9154929577464789,0.20257431219998062,0.7403796436261283
25,94,22,141,0.21008403361344538,0.8439716312056738,0.1905695102792123,0.8147764600341089
4,96,6,106,0.04,0.9433962264150944,0.13859148830119034,0.8484783504937968
44,141,32,217,0.23783783783783785,0.8525345622119815,0.1368540365637386,0.8940785260478894
6,75,1,82,0.07407407407407407,0.9878048780487805,0.13681030924728402,0.8946592461408046
6,41,7,54,0.1276595744680851,0.8703703703703703,0.13917437544113745,0.887802535202461
3,28,3,34,0.0967741935483871,0.9117647058823529,0.13432512391256904,0.9036193331258188
5,116,28,149,0.04132231404958678,0.8120805369127517,0.11825028965591658,0.8888461301495721
15,79,36,130,0.1595744680851064,0.7230769230769231,0.11103463743758243,0.8715754575597506
43,63,33,139,0.4056603773584906,0.762589928057554,0.16327183420308108,0.8457459863658162
36,59,7,102,0.37894736842105264,0.9313725490196079,0.1834303385721118,0.8570085559097629
11,34,23,68,0.24444444444444444,0.6617647058823529,0.20776896291073613,0.810431388457416
7,108,10,125,0.06086956521739131,0.92,0.19822753301777984,0.8175213355473632
13,31,4,48,0.29545454545454547,0.9166666666666666,0.22661044043294534,0.818221615659408
12,74,6,92,0.13953488372093023,0.9347826086956522,0.24064080752885153,0.8357504830569652
5,24,1,30,0.1724137931034483,0.9666666666666667,0.24247499681718612,0.8705490178555
11,65,1,77,0.14473684210526316,0.987012987012987,0.20520020606672504,0.9026094548491334
11,36,1,48,0.23404255319148937,0.9791666666666666,0.18449951817678742,0.9094371859415703
9,51,2,62,0.15,0.967741935483871,0.17100745468472395,0.9531482187417871
7,116,45,168,0.056910569105691054,0.7321428571428571,0.17044188381162392,0.9263114840479095
11,85,112,208,0.11458333333333333,0.46153846153846156,0.14460313922287932,0.8612931690295945
45,77,7,129,0.36885245901639346,0.9457364341085271,0.1773627928365169,0.8628580012314337
4,35,23,62,0.10256410256410256,0.6290322580645161,0.1673842656166104,0.8146245142882694
25,167,17,209,0.13020833333333334,0.9186602870813397,0.16530876436347755,0.8048598428694627
9,46,10,65,0.16363636363636364,0.8461538461538461,0.15525073728417388,0.7858580113676312
1,11,2,14,0.08333333333333333,0.8571428571428571,0.14572692776036436,0.7700581430332006
46,29,6,81,0.6133333333333333,0.9259259259259259,0.22521589407859896,0.797741438573639
9,35,13,57,0.20454545454545456,0.7719298245614035,0.23806762568033055,0.8420830618626308
19,95,9,123,0.16666666666666666,0.926829268292683,0.20918394105894103,0.839382038174653
115,334,99,548,0.2561247216035635,0.8193430656934306,0.23112117235029256,0.866569296407355
6,45,3,54,0.11764705882352941,0.9444444444444444,0.22932670456317772,0.8702527474592271
16,52,27,95,0.23529411764705882,0.7157894736842105,0.23956352656470561,0.8516292656778506
1,1,0,2,0.5,1.0,0.29908733608851507,0.8720374289431568
1,11,3,15,0.08333333333333333,0.8,0.22337305037422941,0.8540480109537388
17,61,21,99,0.21794871794871795,0.7878787878787878,0.22528780228898135,0.8563264342847937
6,123,10,139,0.046511627906976744,0.9280575539568345,0.20812279675188278,0.8565019036653868
10,49,4,63,0.1694915254237288,0.9365079365079365,0.19574662586904923,0.8732397423531734
2,19,5,26,0.09523809523809523,0.8076923076923077,0.1925453453568444,0.8537037228171539
2,13,9,24,0.13333333333333333,0.625,0.17500406528833054,0.8261728933997841
34,74,6,114,0.3148148148148148,0.9473684210526315,0.14854903883330411,0.8186540964073029
33,48,11,92,0.4074074074074074,0.8804347826086957,0.19376308404734935,0.8321855959636472
24,45,34,103,0.34782608695652173,0.6699029126213593,0.21231699390560702,0.8153318994983002
95,249,58,402,0.2761627906976744,0.8557213930348259,0.24501966479267637,0.8041744514444519
7,83,10,100,0.07777777777777778,0.9,0.2367603158553613,0.798959031943318
0,7,25,32,0.0,0.21875,0.22247460156964705,0.7281682156167874
0,12,2,14,0.0,0.8571428571428571,0.203426982522028,0.7613314809229098
1,8,3,12,0.1111111111111111,0.75,0.1743264534214989,0.7331359922011054
27,59,177,263,0.313953488372093,0.3269961977186312,0.1609758935593111,0.6540733372168104
43,60,43,146,0.4174757281553398,0.7054794520547946,0.17092584230199942,0.6591556999930155
3,9,18,30,0.25,0.4,0.1671883007737602,0.5940526438451832
8,113,2,123,0.06611570247933884,0.983739837398374,0.16552229001684035,0.6060154777592367
5,40,4,49,0.1111111111111111,0.9183673469387755,0.18139530588985625,0.7059608130362046
21,132,37,190,0.13725490196078433,0.8052631578947368,0.20100314902711114,0.6985494274293302
18,110,13,141,0.140625,0.9078014184397163,0.20521941886838097,0.7210924872064327
20,95,24,139,0.17391304347826086,0.8273381294964028,0.18521364102640495,0.7925699060318285
4,95,7,106,0.04040404040404041,0.9339622641509434,0.13134625706193362,0.8252103077598498
45,140,32,217,0.24324324324324326,0.8525345622119815,0.13038100609668266,0.8898581023615614
6,75,1,82,0.07407407407407407,0.9878048780487805,0.131517916324502,0.8904388224544766
5,41,8,54,0.10869565217391304,0.8518518518518519,0.1311728507620451,0.8809366088706304
3,27,4,34,0.1,0.8823529411764706,0.1258507219105045,0.8919494350537354
6,115,28,149,0.049586776859504134,0.8120805369127517,0.11284526146186223,0.878275023407026
14,78,38,130,0.15217391304347827,0.7076923076923077,0.10973967139975042,0.8611827631492981
43,63,33,139,0.4056603773584906,0.762589928057554,0.16191914810752903,0.8367010008502425
36,58,7,101,0.3829787234042553,0.9306930693069307,0.18188135955910217,0.8478665018638066
11,32,25,68,0.2558139534883721,0.6323529411764706,0.20784419947543048,0.797087653739191
3,100,21,124,0.02912621359223301,0.8306451612903226,0.19647713682090476,0.7940581265161153
12,32,4,48,0.2727272727272727,0.9166666666666666,0.2211524614962294,0.7989600873004291
13,71,8,92,0.15476190476190477,0.9130434782608695,0.2361774797680009,0.8133833646358745
6,23,1,30,0.20689655172413793,0.9666666666666667,0.24399499957952378,0.8503797016322114
10,65,2,77,0.13333333333333333,0.974025974025974,0.20509113614735844,0.8805848510562715
11,36,1,48,0.23404255319148937,0.9791666666666666,0.18381454040267758,0.8875096506790908
10,48,4,62,0.1724137931034483,0.9354838709677419,0.17190023177625988,0.9308140692207011
7,116,45,168,0.056910569105691054,0.7321428571428571,0.1758694254210396,0.9167423114853488
9,84,117,210,0.0967741935483871,0.44285714285714284,0.1507332712526274,0.8490552366554169
42,80,7,129,0.3442622950819672,0.9457364341085271,0.17780475558406486,0.8537256589193679
3,36,23,62,0.07692307692307693,0.6290322580645161,0.15923711632677046,0.8054921719762035
23,166,17,206,0.12169312169312169,0.9174757281553398,0.15757422894959736,0.7974135654232558
9,45,11,65,0.16666666666666666,0.8307692307692308,0.1479491023031941,0.7762139317236222
2,10,2,14,0.16666666666666666,0.8571428571428571,0.1471280842407967,0.7650223583200672
46,29,6,81,0.6133333333333333,0.9259259259259259,0.2266170505590313,0.7927056538605056
9,36,13,58,0.2,0.7758620689655172,0.24136359433783316,0.840277786161702
22,92,9,123,0.19298245614035087,0.926829268292683,0.21975218877474514,0.8375767624737243
123,328,98,549,0.2727272727272727,0.8214936247723132,0.24772421674677306,0.8650712434319809
5,46,3,54,0.09803921568627451,0.9444444444444444,0.24434508731722349,0.8689239171875673
15,47,28,90,0.24193548387096775,0.6888888888888889,0.2550977754892665,0.848655296918947
1,1,0,2,0.5,1.0,0.30271682310831416,0.8690634601842532
1,10,3,14,0.09090909090909091,0.7857142857142857,0.2280847884762795,0.8490332258683045
17,61,21,99,0.21794871794871795,0.7878787878787878,0.23064889104038208,0.8507498999987718
6,124,7,137,0.046153846153846156,0.948905109489051,0.20967337532802424,0.853903591598253
9,50,4,63,0.15254237288135594,0.9365079365079365,0.19250410392146472,0.8703342075604849
2,17,8,27,0.10526315789473684,0.7037037037037037,0.19353609566553076,0.8359426731689504
2,12,10,24,0.14285714285714285,0.5833333333333334,0.17691875573794594,0.82750038091653
38,69,7,114,0.35514018691588783,0.9385964912280702,0.15622449672592995,0.8187284510919685
32,49,11,92,0.3950617283950617,0.8804347826086957,0.20075712459189116,0.8302191343217821
25,52,27,104,0.3246753246753247,0.7403846153846154,0.21600378269569212,0.8234342525369004
106,255,40,401,0.29362880886426596,0.9002493765586035,0.251306237118162,0.8185009336601793
7,83,10,100,0.07777777777777778,0.9,0.2406255806747937,0.8132855141590455
0,7,25,32,0.0,0.21875,0.22702013849792294,0.7373926570161883
2,10,2,14,0.16666666666666666,0.8571428571428571,0.23042149904214063,0.7765083032746916
1,9,3,13,0.1,0.7692307692307693,0.1939729009112995,0.7523132001322201
28,59,176,263,0.3218390804597701,0.33079847908745247,0.18351252263482928,0.6737937282006138
44,60,43,147,0.4230769230769231,0.7074829931972789,0.19756989383505763,0.6690934964595658
3,10,17,30,0.23076923076923078,0.43333333333333335,0.18858995410719545,0.6023912045702415
7,114,2,123,0.05785123966942149,0.983739837398374,0.18574330580600168,0.614354038484295
5,40,4,49,0.1111111111111111,0.9183673469387755,0.20161632167901758,0.714299373761263
22,132,37,191,0.14285714285714285,0.806282722513089,0.1982149611347999,0.7070336402427246
19,109,13,141,0.1484375,0.9078014184397163,0.20513460399194275,0.7268294472725741
21,95,23,139,0.1810344827586207,0.8345323741007195,0.1850196614632071,0.7987914322744694
5,95,6,106,0.05,0.9433962264150944,0.1317229581665038,0.8324933227341573
43,142,32,217,0.23243243243243245,0.8525345622119815,0.13196055840410406,0.8923792125739641
5,76,1,82,0.06172839506172839,0.9878048780487805,0.1325144377458622,0.8929599326668795
7,40,8,55,0.14893617021276595,0.8545454545454545,0.13791801761752714,0.8838425194678337
3,27,4,34,0.1,0.8823529411764706,0.13179556863793532,0.8947096935626024
6,115,28,149,0.049586776859504134,0.8120805369127517,0.11767403676072163,0.8810352819158932
15,78,37,130,0.16129032258064516,0.7153846153846154,0.11485344244958226,0.8640141735278782
43,63,33,139,0.4056603773584906,0.762589928057554,0.1656620677865095,0.8381847023339439
36,58,7,101,0.3829787234042553,0.9306930693069307,0.1871686807824842,0.8493502033475081
11,32,25,68,0.2558139534883721,0.6323529411764706,0.2148951891291476,0.7985713552228925
3,99,22,124,0.029411764705882353,0.8225806451612904,0.19782027405673563,0.7940049538822976
11,33,4,48,0.25,0.9166666666666666,0.21924884548530704,0.7989069146666112
14,71,7,92,0.16470588235294117,0.9239130434782609,0.2356944319843695,0.8148829870331126
6,23,1,30,0.20689655172413793,0.9666666666666667,0.24220960757629703,0.8507804229305485
10,66,1,77,0.13157894736842105,0.987012987012987,0.2030551175777157,0.8828408599241817
11,36,1,48,0.23404255319148937,0.9791666666666666,0.18177852183303483,0.8897656595470013
10,49,3,62,0.1694915254237288,0.9516129032258065,0.16944674639522864,0.9353742255540493
7,115,46,168,0.05737704918032787,0.7261904761904762,0.17344178703443514,0.9216042014153614
9,82,119,210,0.0989010989010989,0.43333333333333335,0.15185622973459215,0.8525565823677423
46,76,7,129,0.3770491803278688,0.9457364341085271,0.18219098658815322,0.8556742096006376
3,36,23,62,0.07692307692307693,0.6290322580645161,0.1636233473308588,0.8074407226574731
23,167,17,207,0.12105263157894737,0.9178743961352657,0.16211958793236256,0.797563781103513
9,46,10,65,0.16363636363636364,0.8461538461538461,0.15206156085305886,0.7785619496016815
2,10,2,14,0.16666666666666666,0.8571428571428571,0.15165800960204998,0.7650662287326888
46,29,6,81,0.6133333333333333,0.9259259259259259,0.2310803359096222,0.7935998644091816
9,36,13,58,0.2,0.7758620689655172,0.24552303606660805,0.842532540928065
19,94,10,123,0.168141592920354,0.9186991869918699,0.2156790950083917,0.8386700770542568
122,330,97,549,0.26991150442477874,0.8233151183970856,0.24324887036577764,0.8664247713874811
4,47,3,54,0.0784313725490196,0.9444444444444444,0.23716011907578796,0.8702204925745066
15,47,28,90,0.24193548387096775,0.6888888888888889,0.24834570768073141,0.847754070108084
1,1,0,2,0.5,1.0,0.295964755299779,0.8681622333733902
1,10,3,14,0.09090909090909091,0.7857142857142857,0.2213327206677444,0.8481319990574415
17,61,21,99,0.21794871794871795,0.7878787878787878,0.22389682323184698,0.8498486731879088
6,121,9,136,0.047244094488188976,0.9338235294117647,0.20662575202725195,0.852009293533608
8,51,4,63,0.13559322033898305,0.9365079365079365,0.18743742572928118,0.8681796961208725
2,18,8,28,0.1,0.7142857142857143,0.19051865822227834,0.8352998775267683
1,9,15,25,0.1,0.4,0.17461751323736793,0.7991563933691149
37,66,11,114,0.3592233009708738,0.9035087719298246,0.15450655623320705,0.7853719322162327
34,48,11,93,0.4146341463414634,0.8817204301075269,0.20183524380579707,0.7970462793744508
24,52,28,104,0.3157894736842105,0.7307692307692307,0.21214949096214947,0.7888877712159427
107,241,53,401,0.3074712643678161,0.8678304239401496,0.24927123621197353,0.7814766847506668
6,84,10,100,0.06666666666666667,0.9,0.23700327818130365,0.7762612652495332
0,7,25,32,0.0,0.21875,0.2233978360044329,0.700368408106676
2,10,2,14,0.16666666666666666,0.8571428571428571,0.23292164552824238,0.7656745305556555
1,9,3,13,0.1,0.7692307692307693,0.19588974538954615,0.7464919587415048
20,67,176,263,0.22988505747126436,0.33079847908745247,0.16949701840808915,0.6677888228814942
44,60,43,147,0.4230769230769231,0.7074829931972789,0.18482379689276238,0.6644622175140725
4,12,14,30,0.25,0.5333333333333333,0.17661361626878863,0.6166769188559558
7,114,2,123,0.05785123966942149,0.983739837398374,0.17535426955489647,0.6286397527700093
5,40,4,49,0.1111111111111111,0.9183673469387755,0.19122728542791237,0.7285850880469772
22,132,37,191,0.14285714285714285,0.806282722513089,0.18782592488369465,0.721319354528439
19,109,13,141,0.1484375,0.9078014184397163,0.19474556774083754,0.7411151615582884
25,93,22,140,0.211864406779661,0.8428571428571429,0.19217118907060846,0.8142663992396727
5,96,5,106,0.04950495049504951,0.9528301886792453,0.1388037644160551,0.8493159985942393
44,140,33,217,0.2391304347826087,0.847926267281106,0.1372509693849992,0.8942578463010642
5,76,1,82,0.06172839506172839,0.9878048780487805,0.13780484872675733,0.8948385663939792
6,41,8,55,0.1276595744680851,0.8545454545454545,0.14016891492061076,0.8857211531949334
3,27,4,34,0.1,0.8823529411764706,0.13404646594101893,0.8965883272897023
7,114,28,149,0.05785123966942149,0.8120805369127517,0.12110557160807914,0.882913915642993
15,78,37,130,0.16129032258064516,0.7153846153846154,0.11388070243679116,0.8647035545754891
44,63,32,139,0.411214953271028,0.7697841726618705,0.16555355997621665,0.8385541237158641
37,57,7,101,0.39361702127659576,0.9306930693069307,0.18762307233250053,0.8503779525766962
11,31,26,68,0.2619047619047619,0.6176470588235294,0.2162196961672196,0.7974982641159462
3,99,21,123,0.029411764705882353,0.8292682926829268,0.2021842947726192,0.7938872409927279
13,31,4,48,0.29545454545454547,0.9166666666666666,0.23010637269469716,0.7987892017770416
13,72,7,92,0.15294117647058825,0.9239130434782609,0.2436906493805781,0.8147652741435429
6,23,1,30,0.20689655172413793,0.9666666666666667,0.25020582497250565,0.8506627100409787
10,67,1,78,0.12987012987012986,0.9871794871794872,0.2100137073438059,0.8817191835434954
12,35,1,48,0.2553191489361702,0.9791666666666666,0.19025686843803083,0.8886439831663148
7,51,4,62,0.1206896551724138,0.9354838709677419,0.1700832817619811,0.9340492420440595
7,115,46,168,0.05737704918032787,0.7261904761904762,0.17407832240118756,0.9193238396879951
9,86,115,210,0.09473684210526316,0.4523809523809524,0.14540436477986154,0.8529973090757502
44,78,7,129,0.36065573770491804,0.9457364341085271,0.1750778735276229,0.8561149363086454
4,36,22,62,0.1,0.6451612903225806,0.15980693756703182,0.8101855968309187
23,167,17,207,0.12105263157894737,0.9178743961352657,0.1585472949540057,0.8002848695388872
8,44,13,65,0.15384615384615385,0.8,0.14405115279828912,0.7746896314436491
2,9,3,14,0.18181818181818182,0.7857142857142857,0.15278379946197027,0.7532939764074411
46,29,6,81,0.6133333333333333,0.9259259259259259,0.23220612576954247,0.7818276120839338
9,33,13,55,0.21428571428571427,0.7636363636363637,0.24928453608103546,0.8262926708347068
22,94,7,123,0.1896551724137931,0.943089430894309,0.22485588389658906,0.82591452751839
119,329,101,549,0.265625,0.8160291438979964,0.24851659818230334,0.8503242208863065
5,46,3,54,0.09803921568627451,0.9444444444444444,0.24522896734049296,0.8541199420733321
16,47,27,90,0.25396825396825395,0.7,0.25953212450079294,0.8398342277876178
1,1,0,2,0.5,1.0,0.3049866699553384,0.8704464726855771
1,11,3,15,0.08333333333333333,0.8,0.2292723842410527,0.852457054696159
17,61,21,99,0.21794871794871795,0.7878787878787878,0.22979567047862465,0.8559202581593625
6,123,9,138,0.046511627906976744,0.9347826086956522,0.20934659269193662,0.85473356927384
9,50,4,63,0.15254237288135594,0.9365079365079365,0.19319193167498747,0.8719448253609744
2,19,7,28,0.09523809523809523,0.75,0.1927917716109618,0.8441670475831966
1,8,16,25,0.1111111111111111,0.36,0.1802076139514563,0.7730677672913696
37,67,10,114,0.3557692307692308,0.9122807017543859,0.15960321834706065,0.7605364389705677
27,48,17,92,0.36,0.8152173913043478,0.1991270278708702,0.7627103520140459
24,51,29,104,0.32,0.7211538461538461,0.2082112769551193,0.7531782174819115
105,218,78,401,0.32507739938080493,0.8054862842892768,0.2472617428765151,0.7481648709311042
6,83,11,100,0.06741573033707865,0.89,0.23351593811947433,0.7505911747859795
0,7,25,32,0.0,0.21875,0.21991049594260362,0.6746983176431224
2,10,2,14,0.16666666666666666,0.8571428571428571,0.22784700387911155,0.7457187258063875
0,9,3,12,0.0,0.75,0.17702282805493574,0.7225357684129039
21,66,176,263,0.2413793103448276,0.33079847908745247,0.16007701524705395,0.6533330666676332
44,60,41,145,0.4230769230769231,0.7172413793103448,0.17480228997232866,0.6527741428328472
4,12,14,30,0.25,0.5333333333333333,0.16407694720364224,0.6138951498391411
7,114,2,123,0.05785123966942149,0.983739837398374,0.16271059139397695,0.6272865551817659
5,40,4,49,0.1111111111111111,0.9183673469387755,0.17858360726699282,0.7272318904587338
21,133,37,191,0.13636363636363635,0.806282722513089,0.17425460293798847,0.7199661569401956
18,109,14,141,0.14173228346456693,0.900709219858156,0.19450207200435518,0.7414960454913607
22,95,22,139,0.18803418803418803,0.841726618705036,0.1868813402456924,0.8144857797224441
5,96,4,105,0.04950495049504951,0.9619047619047619,0.13351391559113904,0.8494376915216465
43,142,32,217,0.23243243243243245,0.8525345622119815,0.13100426308148652,0.8950378670757392
5,76,1,82,0.06172839506172839,0.9878048780487805,0.13155814242324465,0.8956185871686543
6,41,7,54,0.1276595744680851,0.8703703703703703,0.13392220861709808,0.8887618762303108
3,27,4,34,0.1,0.8823529411764706,0.12872740342229289,0.8996290503250794
7,112,30,149,0.058823529411764705,0.7986577181208053,0.11688329570046399,0.8850502643626008
11,77,42,130,0.125,0.676923076923077,0.10787841169557999,0.8615069012508924
30,65,44,139,0.3157894736842105,0.6834532374100719,0.1459190578654601,0.8217281120373653
38,56,7,101,0.40425531914893614,0.9306930693069307,0.1704651845392464,0.8328936130509295
9,35,24,68,0.20454545454545456,0.6470588235294118,0.1908676216083501,0.7842156052624482
11,91,21,123,0.10784313725490197,0.8292682926829268,0.1880367020064668,0.7783438798785277
14,30,4,48,0.3181818181818182,0.9166666666666666,0.21920553317529798,0.7832458406628414
12,72,8,92,0.14285714285714285,0.9130434782608695,0.2312103350960663,0.7995866635399934
5,24,1,30,0.1724137931034483,0.9666666666666667,0.2379837341108446,0.8409786049319349
10,67,1,78,0.12987012987012986,0.9871794871794872,0.21142382785169023,0.8843680691847086
12,35,1,48,0.2553191489361702,0.9791666666666666,0.19014723210700937,0.8912928688075279
8,49,5,62,0.14035087719298245,0.9193548387096774,0.18097657819951335,0.9301922995475659
7,113,47,167,0.058333333333333334,0.718562874251497,0.1739037490678607,0.9143772397716472
13,84,113,210,0.13402061855670103,0.46190476190476193,0.14759500626427255,0.8494112533770893
37,77,15,129,0.32456140350877194,0.8837209302325582,0.17355275778593385,0.8452223179444734
6,34,22,62,0.15,0.6451612903225806,0.17035078734258408,0.799292978466747
23,166,17,206,0.12169312169312169,0.9174757281553398,0.1691826433172972,0.7893352986061545
8,45,12,65,0.1509433962264151,0.8153846153846154,0.1542718215016179,0.7659378627087186
2,10,2,14,0.16666666666666666,0.8571428571428571,0.1580312199978585,0.7570504367706014
46,29,6,81,0.6133333333333333,0.9259259259259259,0.23731693428357278,0.7866737298669484
8,34,13,55,0.19047619047619047,0.7636363636363637,0.24538201598635695,0.8297782444000344
22,94,7,123,0.1896551724137931,0.943089430894309,0.22610969725850286,0.8382594587802844
118,329,100,547,0.2639821029082774,0.8171846435100548,0.24239285481682818,0.8628342235213522
6,45,3,54,0.11764705882352941,0.9444444444444444,0.24181484583545787,0.8666868972769386
15,47,27,89,0.24193548387096775,0.6966292134831461,0.2548137154989654,0.8497218398624431
1,1,0,2,0.5,1.0,0.302432763118013,0.8701300031277491
1,11,3,15,0.08333333333333333,0.8,0.22671847740372728,0.8521405851383311
19,59,21,99,0.24358974358974358,0.7878787878787878,0.2343061278485206,0.8556037886015346
6,120,11,137,0.047619047619047616,0.9197080291970803,0.2140152528778427,0.8522635883590733
9,50,4,63,0.15254237288135594,0.9365079365079365,0.19809529144542534,0.8693097730730565
2,19,7,28,0.09523809523809523,0.75,0.19489401093322045,0.8415319952952787
1,8,16,25,0.1111111111111111,0.36,0.17667424471935747,0.7709973739166286
38,61,15,114,0.3838383838383838,0.868421052631579,0.1600797281248409,0.7522003814354256
29,41,22,92,0.4142857142857143,0.7608695652173914,0.20735863968946672,0.7466103193236243
24,46,34,104,0.34285714285714286,0.6730769230769231,0.22337119855916845,0.7302100529233579
105,245,49,399,0.3,0.8771929824561403,0.2587095444238301,0.7375109137711295
6,81,12,99,0.06896551724137931,0.8787878787878788,0.24518513779597523,0.7383354860242731
0,7,25,32,0.0,0.21875,0.23157969561910446,0.6624426288814159
2,10,2,14,0.16666666666666666,0.8571428571428571,0.23951620355561237,0.7334630370446814
0,8,4,12,0.0,0.6666666666666666,0.18468214872155755,0.7046409819068368
20,54,189,263,0.2702702702702703,0.2813688212927757,0.16410851386220843,0.6361408756318917
45,55,44,144,0.45,0.6944444444444444,0.17941463631118798,0.6391933786843946
4,11,15,30,0.26666666666666666,0.5,0.17465273154928324,0.585308666904946
6,115,2,123,0.049586776859504134,0.983739837398374,0.17188434006615824,0.6003018038493025
5,39,5,49,0.11363636363636363,0.8979591836734694,0.18811810629992445,0.6973316872312267
20,122,47,189,0.14084507042253522,0.7513227513227513,0.1844293068364771,0.6822145292569258
17,109,15,141,0.1349206349206349,0.8936170212765957,0.20370368325371066,0.7146360084869157
21,92,25,138,0.18584070796460178,0.8188405797101449,0.19164231721004374,0.7914176882608256
4,94,7,105,0.04081632653061224,0.9333333333333333,0.1331875067144169,0.8255446723878099
42,143,32,217,0.22702702702702704,0.8525345622119815,0.12752470105161123,0.8759067527038072
5,71,5,81,0.06578947368421052,0.9382716049382716,0.12983937202656928,0.8694112909237924
8,37,8,53,0.17777777777777778,0.8490566037735849,0.13900243118962846,0.8624252080809518
3,26,5,34,0.10344827586206896,0.8529411764705882,0.1336600319667047,0.8769421259592143
7,112,30,149,0.058823529411764705,0.7986577181208053,0.12278901689400898,0.8633765112226728
11,78,41,130,0.12359550561797752,0.6846153846153846,0.1138968451302055,0.8442014833519929
29,64,46,139,0.3118279569892473,0.6690647482014388,0.15261279233858197,0.8064488283331507
38,54,8,100,0.41304347826086957,0.92,0.17918657108627373,0.8160867480171533
9,32,27,68,0.21951219512195122,0.6029411764705882,0.2011469598630938,0.7681824010931987
11,91,21,123,0.10784313725490197,0.8292682926829268,0.19115629693125444,0.7653554995088189
13,31,4,48,0.29545454545454547,0.9166666666666666,0.21858576401589394,0.7744591409654014
12,67,10,89,0.1518987341772152,0.8876404494382022,0.23188222183952975,0.7871709597250296
5,23,2,30,0.17857142857142858,0.9333333333333333,0.23973592511859418,0.8227020952561651
9,64,5,78,0.1232876712328767,0.9358974358974359,0.21280159858196981,0.8608210506413077
12,34,2,48,0.2608695652173913,0.9583333333333334,0.19106246814718716,0.8662972411174981
10,47,4,61,0.17543859649122806,0.9344262295081968,0.1847662397713696,0.9136522486942992
7,112,47,166,0.058823529411764705,0.7168674698795181,0.17776343865092142,0.8975949882938122
11,79,117,207,0.12222222222222222,0.43478260869565216,0.15301596390344666,0.8287544085836673
35,78,15,128,0.30973451327433627,0.8828125,0.17556393234589254,0.8280647015210671
4,36,22,62,0.1,0.6451612903225806,0.16433944254997415,0.7868972668052453
25,154,26,205,0.13966480446927373,0.8731707317073171,0.16667903301231654,0.7779363090637997
8,45,12,65,0.1509433962264151,0.8153846153846154,0.15097529458503428,0.7575150636425543
2,9,3,14,0.18181818181818182,0.7857142857142857,0.15188666391745623,0.7362705002434241
46,22,13,81,0.6764705882352942,0.8395061728395061,0.2401219580351033,0.7537903149519939
8,33,14,55,0.1951219512195122,0.7454545454545455,0.25053620503471613,0.7981720202032643
24,81,18,123,0.22857142857142856,0.8536585365853658,0.23894147864858645,0.794007168286888
119,327,99,545,0.26681614349775784,0.818348623853211,0.26277235629112333,0.8187482159341208
5,45,4,54,0.1,0.9259259259259259,0.25710595565265565,0.826284672251065
15,41,31,87,0.26785714285714285,0.6436781609195402,0.2738079194570453,0.8017551787560543
1,1,0,2,0.5,1.0,0.31926246491159077,0.8323674236540136
1,11,3,15,0.08333333333333333,0.8,0.2345285713541678,0.8267236846769412
20,58,21,99,0.2564102564102564,0.7878787878787878,0.2432840435242741,0.8327842907375472
6,110,22,138,0.05172413793103448,0.8405797101449275,0.2180201448613607,0.8309158869603417
9,46,8,63,0.16363636363636364,0.873015873015873,0.20328017630973294,0.8387254939835793
2,19,7,28,0.09523809523809523,0.75,0.2025999042008894,0.8135932188513041
1,9,15,25,0.1,0.4,0.17853471580179653,0.7965465643621789
35,63,15,113,0.35714285714285715,0.8672566371681416,0.15812655253649038,0.7775832268147705
28,40,22,90,0.4117647058823529,0.7555555555555555,0.2059610709592441,0.7694483061798499
24,39,41,104,0.38095238095238093,0.6057692307692307,0.22558430486819228,0.7264186614060192
101,239,59,399,0.29705882352941176,0.8521303258145363,0.26056786350903993,0.729103946046191
6,81,12,99,0.06896551724137931,0.8787878787878788,0.24444605428378247,0.7299285182993346
0,7,25,32,0.0,0.21875,0.2308406121069117,0.6540356611564775
2,10,2,14,0.16666666666666666,0.8571428571428571,0.24036442163072122,0.7193417836054571
1,8,4,13,0.1111111111111111,0.6923076923076923,0.20521702934047178,0.6943490771968215
19,56,189,264,0.25333333333333335,0.2840909090909091,0.18258397611918328,0.6269969848447292
47,55,44,146,0.46078431372549017,0.6986301369863014,0.19398853794391316,0.6402628285900249
4,12,14,30,0.25,0.5333333333333333,0.18726584886828293,0.5947204010927102
7,114,2,123,0.05785123966942149,0.983739837398374,0.1856780949294318,0.6097135380370666
4,39,5,48,0.09302325581395349,0.8958333333333334,0.1989671314742823,0.7064397285132572
19,123,47,189,0.13380281690140844,0.7513227513227513,0.19427229579353109,0.6913225705389563
16,106,15,137,0.13114754098360656,0.8905109489051095,0.19713464291817331,0.7196373214814445
23,91,23,137,0.20175438596491227,0.8321167883211679,0.18976622186554176,0.7979267328000529
4,94,7,105,0.04081632653061224,0.9333333333333333,0.12977079512341633,0.8314557608496289
42,142,33,217,0.22826086956521738,0.847926267281106,0.12666520506130452,0.8763976085564537
5,71,5,81,0.06578947368421052,0.9382716049382716,0.12779923849198865,0.8699021467764388
7,39,8,54,0.15217391304347827,0.8518518518518519,0.13624933238192077,0.8636190779933701
3,25,5,33,0.10714285714285714,0.8484848484848485,0.13244076670212773,0.8774993775879555
7,112,30,149,0.058823529411764705,0.7986577181208053,0.12210876504900746,0.8643774874759121
10,78,42,130,0.11363636363636363,0.676923076923077,0.10952047614492909,0.8422069572761847
30,63,46,139,0.3225806451612903,0.6690647482014388,0.1497725216635974,0.8044543022573427
38,53,8,99,0.4175824175824176,0.9191919191919192,0.176818457094626,0.814635109673173
6,28,34,68,0.17647058823529413,0.5,0.1926300448876379,0.7520248803962772
8,93,21,122,0.07920792079207921,0.8278688524590164,0.18220633170886666,0.7485987376258721
11,31,5,47,0.2619047619047619,0.8936170212765957,0.2043151752462816,0.755046190881836
12,70,7,89,0.14634146341463414,0.9213483146067416,0.21681773724669154,0.7725734189512554
5,23,2,30,0.17857142857142858,0.9333333333333333,0.22609417509455795,0.8092034555812921
11,63,4,78,0.14864864864864866,0.9487179487179487,0.20124674702132342,0.8491539127979364
12,34,2,48,0.2608695652173913,0.9583333333333334,0.1788591966834625,0.8547455433895669
8,49,4,61,0.14035087719298245,0.9344262295081968,0.1736992379631323,0.9168064333193093
6,112,48,166,0.05084745762711865,0.7108433734939759,0.16964774322528076,0.900088507752875
11,76,119,206,0.12643678160919541,0.4223300970873786,0.1502951746116284,0.8327618042972725
26,77,24,127,0.2524271844660194,0.8110236220472441,0.1654502776189692,0.81700113393163
4,35,22,61,0.10256410256410256,0.639344262295082,0.1545920881893512,0.7750026952118799
26,154,26,206,0.14444444444444443,0.8737864077669902,0.15399148758875056,0.764298189361743
8,46,11,65,0.14814814814814814,0.8307692307692308,0.13788842800743012,0.7460747461382997
1,11,2,14,0.08333333333333333,0.8571428571428571,0.1297430645989088,0.7350342643718226
46,22,13,81,0.6764705882352942,0.8395061728395061,0.2191177975429339,0.7534146642783269
8,32,14,54,0.2,0.7407407407407407,0.22962682874162027,0.7989018990859501
23,83,17,123,0.2169811320754717,0.8617886178861789,0.224563106971542,0.8061540413486552
129,321,106,556,0.2866666666666667,0.8093525179856115,0.2508634732719083,0.8304409350187308
6,44,4,54,0.12,0.9259259259259259,0.24737140977984481,0.8378894376128644
15,41,31,87,0.26785714285714285,0.6436781609195402,0.2644726947382726,0.8111621419200514
1,1,0,2,0.5,1.0,0.32399650426208215,0.8315703051853577
1,11,3,15,0.08333333333333333,0.8,0.23926261070465918,0.8259265662082853
18,60,21,99,0.23076923076923078,0.7878787878787878,0.2436582151002636,0.8326605729422921
6,108,24,138,0.05263157894736842,0.8260869565217391,0.22017970751053453,0.8275603356045149
9,46,8,63,0.16363636363636364,0.873015873015873,0.20260394993477698,0.836655100608838
2,19,7,28,0.09523809523809523,0.75,0.19906653496879056,0.8115228254765628
0,9,16,25,0.0,0.36,0.16045358150621306,0.7896407403541127
37,64,13,114,0.36633663366336633,0.8859649122807017,0.14135881488669394,0.77335001353707
30,40,22,92,0.42857142857142855,0.7608695652173914,0.19159429369360131,0.7659742371395545
25,40,45,110,0.38461538461538464,0.5909090909090909,0.2168547475254837,0.7209780568492565
107,232,59,398,0.31563421828908556,0.8517587939698492,0.2531734203136488,0.7246454621989865
5,82,12,99,0.05747126436781609,0.8787878787878788,0.23540957496359657,0.7254700344521303
0,7,25,32,0.0,0.21875,0.22180413278672587,0.6495771773092731
2,10,2,14,0.16666666666666666,0.8571428571428571,0.24561365659624965,0.7205975854725384
1,8,4,13,0.1111111111111111,0.6923076923076923,0.2091528676602132,0.6929322683335372
19,54,191,264,0.2602739726027397,0.2765151515151515,0.1851103739504005,0.6237387806617886
47,54,46,147,0.46534653465346537,0.6870748299319728,0.19664339538441203,0.6374767433793431
3,13,14,30,0.1875,0.5333333333333333,0.1783385070573998,0.5919873918598408
7,114,2,123,0.05785123966942149,0.983739837398374,0.17839278924334345,0.6069805288041972
4,39,5,48,0.09302325581395349,0.8958333333333334,0.19168182578819395,0.7037067192803877
18,122,46,186,0.12857142857142856,0.7526881720430108,0.18623964891744563,0.6887846214089811
17,105,14,136,0.13934426229508196,0.8970588235294118,0.19027295622944146,0.7180347830120839
23,90,24,137,0.20353982300884957,0.8248175182481752,0.1821680777160286,0.7963636925453731
3,95,7,105,0.030612244897959183,0.9333333333333333,0.12006317917952772,0.8315434787455673
43,141,33,217,0.23369565217391305,0.847926267281106,0.1266625580615153,0.8764853264523921
5,71,5,81,0.06578947368421052,0.9382716049382716,0.12779659149219944,0.8699898646723775
7,38,9,54,0.15555555555555556,0.8333333333333334,0.13672977716957116,0.8610612932438059
4,25,4,33,0.13793103448275862,0.8787878787878788,0.1380668637283326,0.8790755370645014
6,113,30,149,0.05042016806722689,0.7986577181208053,0.12536342169578188,0.8650182362918433
10,80,40,130,0.1111111111111111,0.6923076923076923,0.11215931999610497,0.8460882611574886
30,63,46,139,0.3225806451612903,0.6690647482014388,0.15386909146229513,0.8083356061386465
40,52,8,100,0.43478260869565216,0.92,0.18259579953682928,0.8186318536699171
9,30,29,68,0.23076923076923078,0.5735294117647058,0.20616433626326072,0.7665258260736935
10,91,21,122,0.09900990099009901,0.8278688524590164,0.19808638561105266,0.7657451859487912
11,32,5,48,0.2558139534883721,0.8958333333333334,0.21492680261185457,0.768180250883856
12,69,7,88,0.14814814814814814,0.9204545454545454,0.22888794262341475,0.7855797976458189
5,23,2,30,0.17857142857142858,0.9333333333333333,0.23852513083203156,0.8200120320780533
10,62,6,78,0.1388888888888889,0.9230769230769231,0.21228345136454566,0.8562994856316939
12,34,2,48,0.2608695652173913,0.9583333333333334,0.18743873086765123,0.8617756761078843
9,48,4,61,0.15789473684210525,0.9344262295081968,0.1770280888780619,0.9133323643569546
5,113,48,166,0.0423728813559322,0.7108433734939759,0.1689370860731809,0.8966144387905202
11,81,115,207,0.11956521739130435,0.4444444444444444,0.14947298091645694,0.8321303118063932
25,79,24,128,0.2403846153846154,0.8125,0.1626496190930951,0.8167082338843151
5,34,14,53,0.1282051282051282,0.7358490566037735,0.15545443332648076,0.788496194351521
25,155,27,207,0.1388888888888889,0.8695652173913043,0.15545443332648076,0.7808516649678612
7,46,12,65,0.1320754716981132,0.8153846153846154,0.13705527710944104,0.7604304195466157
1,11,2,14,0.08333333333333333,0.8571428571428571,0.12640364803675933,0.7493899377801386
46,22,13,81,0.6764705882352942,0.8395061728395061,0.21698903473381104,0.7677703376866429
8,32,14,54,0.2,0.7407407407407407,0.2284797179636247,0.8100983800146853
23,85,15,123,0.21296296296296297,0.8780487804878049,0.2245623390462458,0.819462491512943
126,324,105,555,0.28,0.8108108108108109,0.2462473207312275,0.8301713135425199
6,44,4,54,0.12,0.9259259259259259,0.24354890803281481,0.8382228433331801
15,40,32,87,0.2727272727272727,0.632183908045977,0.26364202246555185,0.8120513137133746
1,1,0,2,0.5,1.0,0.3231658319893614,0.8324594769786808
1,12,3,16,0.07692307692307693,0.8125,0.2375161875161875,0.8286014522873228
19,59,8,86,0.24358974358974358,0.9069767441860465,0.24374329374329373,0.8523494527795094
6,109,23,138,0.05217391304347826,0.8333333333333334,0.2207734294690816,0.8459615317574419
10,45,8,63,0.18181818181818182,0.873015873015873,0.2067474554431076,0.8548479692153078
2,19,7,28,0.09523809523809523,0.75,0.20321004047712118,0.8297156940830328
1,8,15,24,0.1111111111111111,0.375,0.18242149202740335,0.7887519500553845
38,56,20,114,0.40425531914893614,0.8245614035087719,0.16874368047725133,0.7636892934137804
23,44,22,89,0.34328358208955223,0.7528089887640449,0.20679518121531926,0.7551620060943582
24,41,44,109,0.36923076923076925,0.5963302752293578,0.22429197014067961,0.7109402807069556
106,235,58,399,0.31085043988269795,0.8546365914786967,0.2600784861830355,0.7129484066117798
5,80,11,96,0.058823529411764705,0.8854166666666666,0.2425078215535473,0.7147199485618932
0,7,25,32,0.0,0.21875,0.228222107267833,0.6439291322353624
0,12,2,14,0.0,0.8571428571428571,0.21234909139481714,0.7128066832557707
1,8,4,13,0.1111111111111111,0.6923076923076923,0.17047134738941358,0.6939132959413309
18,54,192,264,0.25,0.2727272727272727,0.1571451213766204,0.6253301936503634
46,55,46,147,0.45544554455445546,0.6870748299319728,0.1694615178514327,0.6382937014650226
1,8,20,29,0.1111111111111111,0.3103448275862069,0.14092732802692032,0.5605377351946669
7,114,2,123,0.05785123966942149,0.983739837398374,0.14078842949229986,0.5745839024420537
5,40,5,50,0.1111111111111111,0.9,0.15666144536531573,0.6719053310134823
18,122,46,186,0.12857142857142856,0.7526881720430108,0.17502879230409124,0.6569832331420756
16,106,13,135,0.13114754098360656,0.9037037037037037,0.17789113942873344,0.6871826633415058
26,86,24,136,0.23214285714285715,0.8235294117647058,0.17534011902057017,0.7658686832039964
2,95,9,106,0.020618556701030927,0.9150943396226415,0.11322197789865239,0.7984428988740918
44,141,33,218,0.23783783783783785,0.8486238532110092,0.1313257960024705,0.8753399025347778
5,71,5,81,0.06578947368421052,0.9382716049382716,0.13245982943315462,0.8688444407547632
9,37,8,54,0.1956521739130435,0.8518518518518519,0.14453712411914496,0.8619661338764563
4,25,4,33,0.13793103448275862,0.8787878787878788,0.14587421067790643,0.8799803776971518
6,113,30,149,0.05042016806722689,0.7986577181208053,0.1343417288327093,0.8649738083281662
11,76,43,130,0.12643678160919541,0.6692307692307692,0.11924086089932907,0.8429311451090324
27,65,47,139,0.29347826086956524,0.6618705035971223,0.15822081863769114,0.8067563113911013
40,52,8,100,0.43478260869565216,0.92,0.18635578590309315,0.8169529037895285
9,31,28,68,0.225,0.5882352941176471,0.2091001468053488,0.7669477165294392
9,101,11,121,0.08181818181818182,0.9090909090909091,0.19283814793465429,0.7751247247064474
13,31,4,48,0.29545454545454547,0.9166666666666666,0.21534150664490953,0.7805359801177029
14,68,7,89,0.17073170731707318,0.9213483146067416,0.23252886939488757,0.7980632081871223
5,23,2,30,0.17857142857142858,0.9333333333333333,0.23997667610377804,0.83579214591606
12,61,4,77,0.1643835616438356,0.948051948051948,0.22153457621438807,0.8766752094096065
12,34,2,48,0.2608695652173913,0.9583333333333334,0.19668985571749367,0.8821513998857969
9,45,7,61,0.16666666666666666,0.8852459016393442,0.18835652238416034,0.9245814866746109
6,113,48,167,0.05042016806722689,0.7125748502994012,0.1838710918483096,0.8965077639901098
10,76,119,205,0.11627906976744186,0.4195121951219512,0.15827459532158056,0.825485696626579
25,78,23,126,0.24271844660194175,0.8174603174603174,0.1685584152194189,0.8106445541770898
3,35,15,53,0.07894736842105263,0.7169811320754716,0.15432640662650804,0.7797370968545382
24,156,27,207,0.13333333333333333,0.8695652173913043,0.14989065972500773,0.7685247067601605
7,46,12,65,0.1320754716981132,0.8153846153846154,0.131491503507968,0.7481034613389151
2,10,2,14,0.16666666666666666,0.8571428571428571,0.131491503507968,0.7440887406965597
47,21,13,81,0.6911764705882353,0.8395061728395061,0.22302811815382634,0.7622217867737177
8,33,13,54,0.1951219512195122,0.7592592592592593,0.23429138693269352,0.8107570816504758
22,80,21,123,0.21568627450980393,0.8292682926829268,0.23042964806238814,0.8124439352537058
128,323,99,550,0.2838137472283814,0.82,0.25969627360629227,0.8271609163857813
6,44,4,54,0.12,0.9259259259259259,0.2577915117015303,0.8352124461764413
15,40,32,87,0.2727272727272727,0.632183908045977,0.2778846261342674,0.809040916556636
1,1,0,2,0.5,1.0,0.32550367375331507,0.8294490798219422
1,12,3,16,0.07692307692307693,0.8125,0.2377531889440067,0.8255910551305841
16,61,8,85,0.2077922077922078,0.9058823529411765,0.23956322559724894,0.846537211370858
7,107,24,138,0.06140350877192982,0.8260869565217391,0.21752283049183835,0.8460827347764026
10,45,8,63,0.18181818181818182,0.873015873015873,0.20295203543323842,0.8536564309215274
2,19,7,28,0.09523809523809523,0.75,0.199414620467252,0.8285241557892522
1,8,15,24,0.1111111111111111,0.375,0.1856006566532882,0.7868378982870532
38,59,17,114,0.3917525773195876,0.8508771929824561,0.170136739127515,0.7655346401416898
24,45,22,91,0.34782608695652173,0.7582417582417582,0.20883716913229283,0.7577834627476553
24,41,44,109,0.36923076923076925,0.5963302752293578,0.23044889074401445,0.7134053957538427
108,232,59,399,0.3176470588235294,0.8521303258145363,0.26705511217995725,0.7171258770813852
5,80,11,96,0.058823529411764705,0.8854166666666666,0.24948444755046909,0.7188974190314984
0,7,25,32,0.0,0.21875,0.22805587612189765,0.6481066027049679
0,12,2,14,0.0,0.8571428571428571,0.21218286024888178,0.7169841537253762
1,8,4,13,0.1111111111111111,0.6923076923076923,0.17209122221909942,0.6943313679146954
17,55,192,264,0.2361111111111111,0.2727272727272727,0.1561319399554693,0.6249721556983404
45,56,46,147,0.44554455445544555,0.6870748299319728,0.16703390927328024,0.6379356635129997
1,10,18,29,0.09090909090909091,0.3793103448275862,0.13464277099978902,0.5703899519434354
8,113,2,123,0.06611570247933884,0.983739837398374,0.13568451000944245,0.5844361191908221
5,40,5,50,0.1111111111111111,0.9,0.15155752588245835,0.6817575477622507
18,121,47,186,0.12949640287769784,0.7473118279569892,0.17005701200784376,0.6660674007356981
16,106,13,135,0.13114754098360656,0.9037037037037037,0.17291935913248596,0.6962668309351283
26,86,24,136,0.23214285714285715,0.8235294117647058,0.17235246570844967,0.7749528507976188
3,93,10,106,0.03125,0.9056603773584906,0.11316752935767174,0.8061793575728357
44,141,33,218,0.23783783783783785,0.8486238532110092,0.13415735034749274,0.8732241444847533
5,71,5,81,0.06578947368421052,0.9382716049382716,0.13411074623390298,0.8667286827047386
8,38,8,54,0.17391304347826086,0.8518518518518519,0.1430824508577815,0.8598503758264318
4,25,4,33,0.13793103448275862,0.8787878787878788,0.14428739822993306,0.8786326688022731
6,113,30,149,0.05042016806722689,0.7986577181208053,0.13275491638473597,0.8636260994332876
11,75,44,130,0.12790697674418605,0.6615384615384615,0.11786407632778295,0.8404845351152527
28,64,47,139,0.30434782608695654,0.6618705035971223,0.15687805148306247,0.8056574102922001
40,52,8,100,0.43478260869565216,0.92,0.1850130187484645,0.8158540026906272
9,31,28,68,0.225,0.5882352941176471,0.20775737965072014,0.7658488154305382
10,93,19,122,0.0970873786407767,0.8442622950819673,0.19678228467393669,0.7647645930348403
12,32,4,48,0.2727272727272727,0.9166666666666666,0.21603889013743868,0.7701758484460957
13,70,6,89,0.1566265060240964,0.9325842696629213,0.23121122413127718,0.7893082129521123
5,23,2,30,0.17857142857142858,0.9333333333333333,0.23844900296374041,0.8281360517799511
8,64,5,77,0.1111111111111111,0.935064935064935,0.21084375796719107,0.8671638277039244
12,33,2,47,0.26666666666666666,0.9574468085106383,0.18682719482019314,0.8725133717768728
9,45,7,61,0.16666666666666666,0.8852459016393442,0.1784938614868598,0.9149434585656866
6,113,48,167,0.05042016806722689,0.7125748502994012,0.1718271171192098,0.8961309664538913
10,77,118,205,0.11494252873563218,0.424390243902439,0.14928643940611833,0.8258057632018589
26,78,23,127,0.25,0.8188976377952756,0.16262550997410455,0.8095648157921952
4,34,15,53,0.10526315789473684,0.7169811320754716,0.15215289987743427,0.7786573584696435
23,157,27,207,0.12777777777777777,0.8695652173913043,0.1545338522583867,0.7693002559448392
6,44,15,65,0.12,0.7692307692307693,0.13358147130600573,0.7424122503334293
1,11,2,14,0.08333333333333333,0.8571428571428571,0.12167670940124384,0.738397529691074
47,21,13,81,0.6911764705882353,0.8395061728395061,0.21321332404710217,0.7565305757682318
8,34,13,55,0.19047619047619047,0.7636363636363637,0.2240038471528962,0.8049943071587925
21,80,22,123,0.2079207920792079,0.8211382113821138,0.21799253173564018,0.8053143890997694
130,325,96,551,0.2857142857142857,0.8257713248638838,0.24377126428129006,0.8208558452123997
5,45,4,54,0.1,0.9259259259259259,0.23980301031303605,0.8289073750030599
15,40,32,87,0.2727272727272727,0.632183908045977,0.2616211921312179,0.8093292519766611
1,1,0,2,0.5,1.0,0.3211450016550274,0.8297374152419673
1,12,3,16,0.07692307692307693,0.8125,0.23339451684571905,0.8258793905506092
19,58,8,85,0.24675324675324675,0.9058823529411765,0.24143409631386994,0.8462002461655824
7,109,22,138,0.0603448275862069,0.8405797101449275,0.2203518156720127,0.8489776031316987
10,45,8,63,0.18181818181818182,0.873015873015873,0.20550951511542642,0.8557268242962686
2,18,8,28,0.1,0.7142857142857143,0.20550951511542642,0.8254925083476667
1,8,17,26,0.1111111111111111,0.34615384615384615,0.18460983460983457,0.7849512566209309
38,58,18,114,0.3958333333333333,0.8421052631578947,0.1697288822288822,0.7623948656434872
27,42,22,91,0.391304347826087,0.7582417582417582,0.21464049235788366,0.7546436882494527
24,41,45,110,0.36923076923076925,0.5909090909090909,0.23442071213810342,0.7094911663527448
107,229,63,399,0.31845238095238093,0.8421052631578947,0.2713669008700064,0.7095452584174389
7,80,12,99,0.08045977011494253,0.8787878787878788,0.2594845303669463,0.7103698306705825
0,7,25,32,0.0,0.21875,0.23805595893837483,0.6395790143440518
2,10,2,14,0.16666666666666666,0.8571428571428571,0.24599246687488277,0.7125774444853391
1,8,4,13,0.1111111111111111,0.6923076923076923,0.20531786370027957,0.6911777915067389
9,63,192,264,0.125,0.2727272727272727,0.16727438543941003,0.6218185792903838
44,57,46,147,0.43564356435643564,0.6870748299319728,0.1767619276002195,0.6355565420079383
2,8,19,29,0.2,0.3448275862068966,0.15984015889273653,0.5645168738720815
7,114,2,123,0.05785123966942149,0.983739837398374,0.15661036882909066,0.5795100108164378
6,40,4,50,0.13043478260869565,0.92,0.17524390920176147,0.6796885822450093
19,121,48,188,0.1357142857142857,0.7446808510638298,0.1708221404942785,0.6636225813765769
19,107,14,140,0.15079365079365079,0.9,0.1764910747346413,0.6932929110469066
26,88,24,138,0.22807017543859648,0.8260869565217391,0.19121538551158365,0.7723442944461161
3,95,8,106,0.030612244897959183,0.9245283018867925,0.133353768446087,0.8062662190110903
44,142,32,218,0.23655913978494625,0.8532110091743119,0.13857650270107932,0.8788924222921496
5,72,5,82,0.06493506493506493,0.9390243902439024,0.13958847773902838,0.8725045012700823
6,40,8,54,0.13043478260869565,0.8518518518518519,0.1395884777390284,0.8627690515346326
4,25,4,33,0.13793103448275862,0.8787878787878788,0.13990515613452453,0.8819271983523539
6,113,31,150,0.05042016806722689,0.7933333333333333,0.12556608717360682,0.8666891031142585
9,79,42,130,0.10227272727272728,0.676923076923077,0.10759502314991122,0.8453799774573068
30,63,46,139,0.3225806451612903,0.6690647482014388,0.14930479461610138,0.8088851840736849
40,51,8,99,0.43956043956043955,0.9191919191919192,0.1783049802983147,0.8183110283619144
9,30,29,68,0.23076923076923078,0.5735294117647058,0.20199557541748128,0.7660974600077435
10,92,21,123,0.09803921568627451,0.8292682926829268,0.1973676372857068,0.7628712372693257
13,31,4,48,0.29545454545454547,0.9166666666666666,0.2198709959959621,0.768282492680581
15,68,6,89,0.18072289156626506,0.9325842696629213,0.23848567078153898,0.7881754835848079
4,24,2,30,0.14285714285714285,0.9333333333333333,0.24428344443645547,0.8248055202148444
10,61,5,76,0.14084507042253522,0.9342105263157895,0.2183212194737762,0.8626834885168947
10,36,2,48,0.21739130434782608,0.9583333333333334,0.18658277158626,0.8682751191085253
12,46,3,61,0.20689655172413793,0.9508196721311475,0.18317238886553242,0.9221737277323026
6,113,48,167,0.05042016806722689,0.7125748502994012,0.17636966777709703,0.9055032359632275
12,84,113,209,0.125,0.45933014354066987,0.1520190184264477,0.840169446945228
26,78,48,152,0.25,0.6842105263157895,0.16191574820269553,0.8046874836099234
5,34,14,53,0.1282051282051282,0.7358490566037735,0.1598226032524077,0.7764754440771292
23,156,28,207,0.12849162011173185,0.8647342995169082,0.15805782463657866,0.7665502688201461
7,41,17,65,0.14583333333333334,0.7384615384615385,0.147835257348794,0.7351400124098897
2,9,3,14,0.18181818181818182,0.7857142857142857,0.14425263307651456,0.7115535286360523
47,21,13,81,0.6911764705882353,0.8395061728395061,0.2357892477223729,0.7296865747132102
8,35,13,56,0.18604651162790697,0.7678571428571429,0.24451017795493105,0.7737618603298493
21,84,18,123,0.2,0.8536585365853658,0.2373673208120739,0.7979687189397886
131,309,117,557,0.29772727272727273,0.7899461400359067,0.26158477002952313,0.8056968737158077
6,44,4,54,0.12,0.9259259259259259,0.26037168144213285,0.8144385346313816
12,44,31,87,0.21428571428571427,0.6436781609195402,0.2701505930067587,0.800898052125382
1,1,0,2,0.5,1.0,0.31560513846130417,0.831510297023341
1,12,3,16,0.07692307692307693,0.8125,0.2278546536519958,0.8276522723319831
17,61,8,86,0.21794871794871795,0.9069767441860465,0.23241211169782597,0.847526501093255
7,107,24,138,0.06140350877192982,0.8260869565217391,0.21261261295095876,0.8435877039413083
10,45,8,63,0.18181818181818182,0.873015873015873,0.19605417139251724,0.855454808652732
3,17,8,28,0.15,0.7142857142857143,0.2003398856782315,0.8252204927041304
1,9,16,26,0.1,0.38461538461538464,0.19608603956430043,0.7824440002596148
35,59,20,114,0.3723404255319149,0.8245614035087719,0.1778489574974311,0.7573813436180108
27,42,22,91,0.391304347826087,0.7582417582417582,0.22276056762643254,0.7496301662239764
24,38,48,110,0.3870967741935484,0.5636363636363636,0.24509307382990647,0.7005815404311645
109,210,80,399,0.34169278996865204,0.7994987468671679,0.28521067736580086,0.6957480280788552
7,80,12,99,0.08045977011494253,0.8787878787878788,0.27073090426533813,0.6965726003319987
0,7,25,32,0.0,0.21875,0.23898487251930636,0.6325845050939035
1,11,2,14,0.08333333333333333,0.8571428571428571,0.23660392013835402,0.7000884297406854
1,8,4,13,0.1111111111111111,0.6923076923076923,0.19928544664966777,0.6811950424262454
10,64,190,264,0.13513513513513514,0.2803030303030303,0.16268984483667465,0.6129180812921414
44,56,46,146,0.44,0.684931506849315,0.17024744852331056,0.6302459588939916
2,11,16,29,0.15384615384615385,0.4482758620689655,0.1434122147915251,0.580071261065677
8,113,2,123,0.06611570247933884,0.983739837398374,0.14136306227215314,0.5950643980100334
6,40,4,50,0.13043478260869565,0.92,0.15999660264482393,0.6952429694386048
21,121,46,188,0.14788732394366197,0.7553191489361702,0.16921860130344232,0.6806967254090781
17,109,14,140,0.1349206349206349,0.9,0.17261996184766001,0.7103670550794078
26,88,24,138,0.22807017543859648,0.8260869565217391,0.18589639617672593,0.7883361873963662
3,95,8,106,0.030612244897959183,0.9245283018867925,0.12741243116214868,0.8225643009731487
46,139,33,218,0.24864864864864866,0.8486238532110092,0.1409556447053622,0.8797568711362979
5,72,5,82,0.06493506493506493,0.9390243902439024,0.14078698219903737,0.8733689501142304
5,41,7,53,0.10869565217391304,0.8679245283018868,0.13768139213692557,0.8659295970144999
4,25,4,33,0.13793103448275862,0.8787878787878788,0.13625906507108224,0.8835679869933155
7,109,34,150,0.0603448275862069,0.7733333333333333,0.12560537830902108,0.8654727488980775
10,75,44,129,0.11764705882352941,0.6589147286821705,0.1098306473640115,0.8415910020638533
31,62,46,139,0.3333333333333333,0.6690647482014388,0.15307651714049353,0.8050962086802314
39,52,8,99,0.42857142857142855,0.9191919191919192,0.17877977141517637,0.8151773609632186
7,21,40,68,0.25,0.4117647058823529,0.20521761928159568,0.7398545489115687
13,91,20,124,0.125,0.8387096774193549,0.20754681182817952,0.7356809987854926
13,31,4,48,0.29545454545454547,0.9166666666666666,0.2300501705384348,0.7410922541967481
15,65,7,87,0.1875,0.9195402298850575,0.24821519516897667,0.7619789537041372
4,24,2,30,0.14285714285714285,0.9333333333333333,0.25181663574520713,0.8011816115114462
10,62,5,77,0.1388888888888889,0.935064935064935,0.22403885796742934,0.8391816382062313
10,37,2,49,0.2127659574468085,0.9591836734693877,0.19320950494962652,0.8448947459601553
12,43,6,61,0.21818181818181817,0.9016393442622951,0.18866405040417195,0.9148768371572898
6,113,48,167,0.05042016806722689,0.7125748502994012,0.17800978869949008,0.8968575761401538
11,83,115,209,0.11702127659574468,0.44976076555023925,0.1525193217196614,0.8301567331235213
26,79,47,152,0.24761904761904763,0.6907894736842105,0.16110775709381106,0.7974780536662573
4,35,14,53,0.10256410256410256,0.7358490566037735,0.1553516084805196,0.7692660141334632
23,156,28,207,0.12849162011173185,0.8647342995169082,0.15386628436949715,0.759218780483745
6,38,21,65,0.13636363636363635,0.676923076923077,0.14295166707190113,0.7188958381199864
2,10,2,14,0.16666666666666666,0.8571428571428571,0.13559235971259376,0.7125391971029238
47,21,13,81,0.6911764705882353,0.8395061728395061,0.2271289743584521,0.7306722431800816
8,34,14,56,0.19047619047619047,0.75,0.23762253348423007,0.7735635623871903
24,82,17,123,0.22641509433962265,0.8617886178861789,0.23459339730145506,0.7979920115589001
133,315,98,546,0.296875,0.8205128205128205,0.2623520969351547,0.8100868349744782
7,42,4,53,0.14285714285714285,0.9245283018867925,0.2644043144702134,0.8186288353130331
12,44,31,87,0.21428571428571427,0.6436781609195402,0.27553603988765313,0.8138795615982423
1,1,0,2,0.5,1.0,0.3231550875067008,0.8342877248635483
1,12,3,16,0.07692307692307693,0.8125,0.2354046026973924,0.8304297001721902
18,60,8,86,0.23076923076923078,0.9069767441860465,0.2411607513106839,0.8528549493416254
7,110,22,139,0.05982905982905983,0.841726618705036,0.21736274638060352,0.849988949458605
9,46,8,63,0.16363636363636364,0.873015873015873,0.1983286554715126,0.8574893855304698
3,17,8,28,0.15,0.7142857142857143,0.1993490636347779,0.8274547301588872
2,7,17,26,0.2222222222222222,0.34615384615384615,0.21553176420433054,0.7670755451852774
34,53,27,114,0.39080459770114945,0.7631578947368421,0.19993242101878048,0.7332409587191121
25,43,22,90,0.36764705882352944,0.7555555555555555,0.24146441843313085,0.7251060380841914
25,37,42,104,0.4032258064516129,0.5961538461538461,0.2642695702705407,0.680702766936734
102,222,75,399,0.3148148148148148,0.8120300751879699,0.30039355772196175,0.6780095844005618
6,81,12,99,0.06896551724137931,0.8787878787878788,0.2842717484967043,0.6788341566537054
0,7,25,32,0.0,0.21875,0.25252571675067254,0.6243698709394198
2,10,2,14,0.16666666666666666,0.8571428571428571,0.2445892088141646,0.697368301080707
1,8,4,13,0.1111111111111111,0.6923076923076923,0.20463299644415914,0.6872468435908284
12,63,189,264,0.16,0.2840909090909091,0.17496913089794064,0.6198947512387362
43,57,46,146,0.43,0.684931506849315,0.1787940156905674,0.6325772741952316
3,10,16,29,0.23076923076923078,0.4482758620689655,0.16678750368405537,0.5806123866068026
6,115,2,123,0.049586776859504134,0.983739837398374,0.16401911220093038,0.5956055235511589
6,40,4,50,0.13043478260869565,0.92,0.18265265257360117,0.6957840949797304
21,119,46,186,0.15,0.7526881720430108,0.1802717001926488,0.6808619971083238
19,107,14,140,0.15079365079365079,0.9,0.1859406344330116,0.7105323267786534
25,88,24,137,0.22123893805309736,0.8248175182481752,0.19468905415488266,0.7877789852296914
3,95,8,106,0.030612244897959183,0.9245283018867925,0.1376336605688768,0.8220070988064739
47,138,32,217,0.25405405405405407,0.8525345622119815,0.14096006389528015,0.8797583416840477
5,72,5,82,0.06493506493506493,0.9390243902439024,0.1431526764775031,0.8733704206619803
5,41,7,53,0.10869565217391304,0.8679245283018868,0.1400470864153913,0.8659310675622498
3,24,5,32,0.1111111111111111,0.84375,0.13449153085983573,0.8789399001275341
7,110,33,150,0.05982905982905983,0.78,0.12149658929346561,0.8617970429846767
10,76,43,129,0.11627906976744186,0.6666666666666666,0.10650232239551483,0.8392040641873184
30,62,46,138,0.32608695652173914,0.6666666666666666,0.14871299548462624,0.8023666877273005
38,53,8,99,0.4175824175824176,0.9191919191919192,0.17207419027439247,0.811889167295863
9,31,28,68,0.225,0.5882352941176471,0.19494060956938322,0.7617764392778267
13,91,20,124,0.125,0.8387096774193549,0.19726980211596706,0.7576028891517507
12,32,4,48,0.2727272727272727,0.9166666666666666,0.22035782520399014,0.7680195558184172
14,65,7,86,0.17721518987341772,0.9186046511627907,0.2371272723531841,0.7878202202702445
5,23,2,30,0.17857142857142858,0.9333333333333333,0.24602618075375363,0.8259154583654826
9,63,5,77,0.125,0.935064935064935,0.21729947267921948,0.8642580681366638
11,35,2,48,0.2391304347826087,0.9583333333333334,0.19180633227924676,0.8698496987282943
11,46,4,61,0.19298245614035087,0.9344262295081968,0.18723239744215406,0.91930554664123
6,113,48,167,0.05042016806722689,0.7125748502994012,0.17657813573747214,0.9012862856240939
11,86,112,209,0.1134020618556701,0.46411483253588515,0.15381739132724323,0.8366360236054107
26,79,47,152,0.24761904761904763,0.6907894736842105,0.16387508529090464,0.8040909982513279
4,35,14,53,0.10256410256410256,0.7358490566037735,0.15301689586128667,0.7758789587185335
23,153,29,205,0.13068181818181818,0.8585365853658536,0.15382858417297496,0.7649463373329505
6,40,19,65,0.13043478260869565,0.7076923076923077,0.13830063386241595,0.7291404765270897
3,9,2,14,0.25,0.8571428571428571,0.14644599727093727,0.7180999947606125
47,21,13,81,0.6911764705882353,0.8395061728395061,0.2379826119167956,0.7362330408377705
7,33,15,55,0.175,0.7272727272727273,0.24678231736598558,0.7738270258001766
21,83,19,123,0.20192307692307693,0.8455284552845529,0.24025432155227547,0.7959325946002255
128,319,99,546,0.28635346756152125,0.8186813186813187,0.2665099451233353,0.8077657748970176
7,42,4,53,0.14285714285714285,0.9245283018867925,0.26824927721981023,0.8171931629714374
12,44,32,88,0.21428571428571427,0.6363636363636364,0.2802279817450986,0.8070033527816273
1,1,0,2,0.5,1.0,0.3159422674593843,0.8274115160469334
1,12,3,16,0.07692307692307693,0.8125,0.22819178265007597,0.8235534913555753
18,60,8,86,0.23076923076923078,0.9069767441860465,0.23615881561710897,0.8492254937717638
7,108,23,138,0.06086956521739131,0.8333333333333334,0.21600831394486816,0.8474833334930182
10,45,8,63,0.18181818181818182,0.873015873015873,0.20107470169581967,0.8552454126836688
4,14,9,27,0.2222222222222222,0.6666666666666666,0.2124125701765453,0.8184080362236507
2,7,17,26,0.2222222222222222,0.34615384615384615,0.21505517543253388,0.7885248232278569
37,57,19,113,0.39361702127659576,0.831858407079646,0.19985760704347613,0.7645045956678063
26,43,21,90,0.37681159420289856,0.7666666666666667,0.24269882379773638,0.750218881382092
26,35,43,104,0.4262295081967213,0.5865384615384616,0.27062172057309214,0.701357028948811
94,209,96,399,0.3102310231023102,0.7593984962406015,0.3041587670001068,0.6984979905966281
6,81,12,99,0.06896551724137931,0.8787878787878788,0.28543955517744674,0.6908672033048238
0,7,25,32,0.0,0.21875,0.25686812660601815,0.6268791080667286
2,10,2,14,0.16666666666666666,0.8571428571428571,0.24893161866951022,0.6998775382080158
0,8,4,12,0.0,0.6666666666666666,0.19270061562999657,0.6762787181490187
9,62,193,264,0.1267605633802817,0.2689393939393939,0.1569790397981941,0.6051748220451226
42,59,46,147,0.4158415841584158,0.6870748299319728,0.15549505064986477,0.6195371603870529
3,14,13,30,0.17647058823529413,0.5666666666666667,0.1363864170974339,0.5920040418764907
5,116,2,123,0.04132231404958678,0.983739837398374,0.13243738807003497,0.6069971788208471
6,39,4,49,0.13333333333333333,0.9183673469387755,0.15148500711765403,0.7069425140978153
19,120,48,187,0.1366906474820144,0.7433155080213903,0.14720271866270368,0.6906814642233199
19,106,14,139,0.152,0.8992805755395683,0.16891700437698942,0.7239120226337344
24,86,25,135,0.21818181818181817,0.8148148148148148,0.18197718363435175,0.8018942256159374
3,95,8,106,0.030612244897959183,0.9245283018867925,0.12694442088285798,0.8358161501809117
47,138,32,217,0.25405405405405407,0.8525345622119815,0.1380277731426808,0.8766544209730994
5,72,5,82,0.06493506493506493,0.9390243902439024,0.1414010232691777,0.870266499951032
5,41,7,53,0.10869565217391304,0.8679245283018868,0.13788135453211764,0.8630603830029051
3,25,5,33,0.10714285714285714,0.8484848484848485,0.13366024162652376,0.878084574497685
8,110,31,149,0.06779661016949153,0.7919463087248322,0.1216311859364511,0.8627511078098654
10,75,45,130,0.11764705882352941,0.6538461538461539,0.10726907745669557,0.8397555848143424
30,62,46,138,0.32608695652173914,0.6666666666666666,0.149479750545807,0.8029182083543246
39,52,7,98,0.42857142857142855,0.9285714285714286,0.17441080404828907,0.8137806178342455
10,23,35,68,0.30303030303030304,0.4852941176470588,0.20842440949046595,0.7489620074632679
13,91,19,123,0.125,0.8455284552845529,0.2107536020370498,0.7457625684607915
12,32,4,48,0.2727272727272727,0.9166666666666666,0.23440851854910916,0.7555028282010513
13,67,6,86,0.1625,0.9302325581395349,0.2479375742391818,0.775258006688866
4,24,2,30,0.14285714285714285,0.9333333333333333,0.2515390148154123,0.8151847466156059
9,63,4,76,0.125,0.9473684210526315,0.22281230674087812,0.8552849972421723
10,36,2,48,0.21739130434782608,0.9583333333333334,0.19264371756607776,0.8595366979224445
10,48,3,61,0.1724137931034483,0.9508196721311475,0.17398421614795567,0.9260403485630285
7,113,47,167,0.058333333333333334,0.718562874251497,0.16446040662414615,0.9079024084154491
10,84,114,208,0.10638297872340426,0.4519230769230769,0.14069693605216496,0.8415104670235076
25,78,49,152,0.24271844660194175,0.6776315789473685,0.15215671413815662,0.8054246128531981
4,33,16,53,0.10810810810810811,0.6981132075471698,0.14719256631686592,0.771821737740889
26,150,30,206,0.14772727272727273,0.8543689320388349,0.15043931956361917,0.758536096453204
8,43,14,65,0.1568627450980392,0.7846153846153846,0.14179238252793536,0.733719246636354
2,9,3,14,0.18181818181818182,0.7857142857142857,0.14313586663004016,0.7101327628625167
47,21,13,81,0.6911764705882353,0.8395061728395061,0.2335420290950261,0.7274103769465181
7,34,15,56,0.17073170731707318,0.7321428571428571,0.2427347046084074,0.7674417741207723
19,84,20,123,0.18446601941747573,0.8373983739837398,0.23441292929634083,0.7902656019831111
125,317,104,546,0.2828054298642534,0.8095238095238095,0.25936968954721873,0.8061814022654882
7,42,4,53,0.14285714285714285,0.9245283018867925,0.25867395670862875,0.816204169386625
12,45,32,89,0.21052631578947367,0.6404494382022472,0.26634018109311935,0.7956090341847483
1,1,0,2,0.5,1.0,0.3117947265476649,0.8262212790827075
1,12,3,16,0.07692307692307693,0.8125,0.22404424173835652,0.8223632543913494
19,59,8,86,0.24358974358974358,0.9069767441860465,0.23445253263445226,0.8473395239689478
7,106,23,136,0.061946902654867256,0.8308823529411765,0.21694980166836536,0.8464086638200102
10,45,8,63,0.18181818181818182,0.873015873015873,0.20252305194749795,0.8554789586045908
4,14,12,30,0.2222222222222222,0.6,0.2138609204282236,0.8091177726207633
1,8,17,26,0.1111111111111111,0.34615384615384615,0.17919565814302651,0.7653257990926553
36,52,23,111,0.4090909090909091,0.7927927927927928,0.16620864515601355,0.7357247694916257
28,42,19,89,0.4,0.7865168539325843,0.21236249130985968,0.7242747962438998
27,36,38,101,0.42857142857142855,0.6237623762376238,0.24061994813874507,0.6973122785635602
101,208,82,391,0.3268608414239482,0.7902813299232737,0.27779054453264246,0.7007205603148517
5,82,10,97,0.05747126436781609,0.8969072164948454,0.2626241017799928,0.6956782498383285
0,7,24,31,0.0,0.22580645161290322,0.2475865077950304,0.637460123878267
1,11,1,13,0.08333333333333333,0.9230769230769231,0.24361825382677643,0.7198777062958495
1,8,3,12,0.1111111111111111,0.75,0.20104971125823387,0.7137644501825934
10,63,185,258,0.136986301369863,0.28294573643410853,0.16347632573964285,0.6418257191113825
42,59,44,145,0.4158415841584158,0.696551724137931,0.16165777653778393,0.652224197382855
2,13,15,30,0.13333333333333333,0.5,0.13401098966769606,0.6107554359652444
6,115,0,121,0.049586776859504134,1.0,0.13288463430936578,0.6254829764659808
7,38,3,48,0.15555555555555556,0.9375,0.155106856531588,0.7271534833784232
19,121,43,183,0.1357142857142857,0.7650273224043715,0.16258984972886692,0.7045749689966302
16,110,12,138,0.12698412698412698,0.9130434782608695,0.16485742342501203,0.7278668944624685
24,86,21,131,0.21818181818181817,0.8396946564885496,0.17645678296957706,0.8074024544702458
3,98,5,106,0.0297029702970297,0.9528301886792453,0.12129412384652191,0.8440136636904336
46,139,32,217,0.24864864864864866,0.8525345622119815,0.1377677403201384,0.894375744006431
5,72,4,81,0.06493506493506493,0.9506172839506173,0.13996035290236136,0.8873210702850907
5,41,6,52,0.10869565217391304,0.8846153846153846,0.13326608099069812,0.8797661252301455
3,25,4,32,0.10714285714285714,0.875,0.12918444833763693,0.8954765077438067
7,110,27,144,0.05982905982905983,0.8125,0.11959086731548448,0.8811131537065396
10,75,43,128,0.11764705882352941,0.6640625,0.10522875883572892,0.8560228456367468
33,60,42,135,0.3548387096774194,0.6888888888888889,0.15167672160435602,0.818316945666696
40,52,5,97,0.43478260869565216,0.9484536082474226,0.17826728732535654,0.8320196665289019
9,30,28,67,0.23076923076923078,0.582089552238806,0.2019578824445231,0.7793728477129288
11,104,5,120,0.09565217391304348,0.9583333333333334,0.200094528407256,0.7899039832440644
14,29,3,46,0.32558139534883723,0.9347826086956522,0.23130003386525314,0.7984443559148718
14,65,9,88,0.17721518987341772,0.8977272727272727,0.24806948101444712,0.8106196805901965
2,26,2,30,0.07142857142857142,0.9333333333333333,0.24146683995802457,0.8490869424949583
10,62,3,75,0.1388888888888889,0.96,0.21061686555966305,0.887817101225117
10,36,1,47,0.21739130434782608,0.9787234042553191,0.17956096493854506,0.8921413577976738
9,49,4,62,0.15517241379310345,0.9354838709677419,0.16876141965624117,0.9426262604732359
7,113,39,159,0.058333333333333334,0.7547169811320755,0.16343015671628255,0.9135382101587706
10,83,111,204,0.10752688172043011,0.45588235294117646,0.1322795119122244,0.8451238879081312
29,78,43,150,0.27102803738317754,0.7133333333333334,0.1456813472707615,0.81878189656614
4,32,15,51,0.1111111111111111,0.7058823529411765,0.1513502815111243,0.7862888993672603
24,150,25,199,0.13793103448275862,0.8743718592964824,0.15121344516739144,0.7740563078381865
7,43,8,58,0.14,0.8620689655172413,0.14015754454627344,0.757391388018461
2,9,2,13,0.18181818181818182,0.8461538461538461,0.14396408283557033,0.7446299559021902
46,22,11,79,0.6764705882352942,0.8607594936708861,0.23226940496442186,0.7597788862648773
7,34,12,53,0.17073170731707318,0.7735849056603774,0.24129866576394235,0.8051649652247631
21,84,17,122,0.2,0.860655737704918,0.23115180328063123,0.8262110229921324
126,322,101,549,0.28125,0.8160291438979964,0.2554573588361868,0.8419462788431068
7,43,3,53,0.14,0.9433962264150944,0.25575292533864985,0.8518069027171943
13,44,29,86,0.22807017543859648,0.6627906976744186,0.26833437897273504,0.823338578739648
1,1,0,2,0.5,1.0,0.3137889244272805,0.84531660071767
1,12,2,15,0.07692307692307693,0.8666666666666667,0.22813927995410663,0.8461604825742101
18,60,6,84,0.23076923076923078,0.9285714285714286,0.23671606901870054,0.868301414418646
8,98,30,136,0.07547169811320754,0.7794117647058824,0.21892631160630163,0.8566951325616409
11,44,4,59,0.2,0.9322033898305084,0.20731916874915876,0.8732914534091426
4,16,10,30,0.2,0.6666666666666666,0.21589059732058738,0.8337586591593673
2,8,14,24,0.2,0.4166666666666667,0.20991500711126876,0.800485577429203
33,53,26,112,0.38372093023255816,0.7678571428571429,0.19330371143020564,0.7673223121230804
23,47,19,89,0.32857142857142857,0.7865168539325843,0.22925347595139872,0.7558723388753545
25,32,43,100,0.43859649122807015,0.57,0.2534485790938703,0.7212294817324975
88,200,104,392,0.3055555555555556,0.7346938775510204,0.2864184648674944,0.7154197044054175
5,82,9,96,0.05747126436781609,0.90625,0.26865461951744213,0.7117120772867734
0,7,24,31,0.0,0.22580645161290322,0.24484509570791832,0.6296844275171881
1,11,1,13,0.08333333333333333,0.9230769230769231,0.22817842904125166,0.7020287498615104
1,8,3,12,0.1111111111111111,0.75,0.18923416916675923,0.6994777294533472
10,64,184,258,0.13513513513513514,0.2868217054263566,0.16160041296157446,0.6280927082381719
43,58,44,145,0.42574257425742573,0.696551724137931,0.15976413910862527,0.646171525972162
1,7,22,30,0.125,0.26666666666666666,0.13397048831497446,0.5793104958458258
5,116,0,121,0.04132231404958678,1.0,0.13166349541237027,0.5927033529886829
7,39,2,48,0.15217391304347827,0.9583333333333334,0.15340262584715286,0.6973500503773158
20,121,40,181,0.14184397163120568,0.7790055248618785,0.16176128846113463,0.6767684220608808
13,109,11,133,0.10655737704918032,0.9172932330827067,0.16111075502371594,0.7006674553584104
24,85,22,131,0.22018348623853212,0.8320610687022901,0.1732605194670584,0.7785587929692579
4,95,8,107,0.04040404040404041,0.9252336448598131,0.11821215748800333,0.8112276387866697
45,140,32,217,0.24324324324324326,0.8525345622119815,0.13510404937989523,0.8949230524360005
5,72,4,81,0.06493506493506493,0.9506172839506173,0.13847729950639212,0.8878683787146601
5,41,7,53,0.10869565217391304,0.8679245283018868,0.1322661193821685,0.874952835138739
3,25,4,32,0.10714285714285714,0.875,0.12730881731240443,0.8886663315870421
6,113,26,145,0.05042016806722689,0.8206896551724138,0.11928921602926823,0.8748658204570002
9,76,44,129,0.10588235294117647,0.6589147286821705,0.10296048270107458,0.8501306290255546
30,62,42,134,0.32608695652173914,0.6865671641791045,0.1437723278607458,0.8160354174997391
40,52,5,97,0.43478260869565216,0.9484536082474226,0.17113509435394708,0.829738138361945
7,29,31,67,0.19444444444444445,0.5373134328358209,0.18963643428385843,0.7706947310598312
11,94,16,121,0.10476190476190476,0.8677685950413223,0.18907447036785727,0.7706724548797504
13,31,3,47,0.29545454545454547,0.9361702127659575,0.21597614012666985,0.7794110567034588
12,67,10,89,0.1518987341772152,0.8876404494382022,0.23047307814238246,0.7889754558842856
4,24,2,30,0.14285714285714285,0.9333333333333333,0.23575519098752057,0.8281781136915948
9,63,3,75,0.125,0.96,0.2070284829129864,0.8672399473802941
11,35,1,47,0.2391304347826087,0.9787234042553191,0.1790781723539802,0.8715642039528507
9,51,2,62,0.15,0.967741935483871,0.1727289660047738,0.9330539900454294
6,112,41,159,0.05084745762711865,0.7421383647798742,0.1650269021283758,0.9151068142937938
11,77,113,201,0.125,0.43781094527363185,0.14067625277772647,0.8439126332234616
27,68,54,149,0.28421052631578947,0.6375838926174496,0.15957793736895137,0.8081902679633541
2,33,24,59,0.05714285714285714,0.5932203389830508,0.14733303940976766,0.759602697341885
24,150,25,199,0.13793103448275862,0.8743718592964824,0.14918033005016176,0.7473701058128113
7,43,8,58,0.14,0.8620689655172413,0.13501883936693196,0.7307051859930859
2,10,1,13,0.16666666666666666,0.9230769230769231,0.13739979174788436,0.7243244699349505
46,22,11,79,0.6764705882352942,0.8607594936708861,0.22677452469190942,0.7412703454908093
7,34,12,53,0.17073170731707318,0.7735849056603774,0.23330762573720557,0.7892380541174873
21,80,21,122,0.2079207920792079,0.8278688524590164,0.22240909227483677,0.8164216198091395
133,310,102,545,0.3002257336343115,0.8128440366972477,0.2571352174879017,0.8477964337683106
7,43,3,53,0.14,0.9433962264150944,0.25743078399036473,0.8576570576423981
12,50,29,91,0.1935483870967742,0.6813186813186813,0.2650805535756182,0.8318355884711751
1,1,0,2,0.5,1.0,0.31269960119466583,0.8428245994601861
1,12,2,15,0.07692307692307693,0.8666666666666667,0.22704995672149192,0.8436684813167262
18,60,18,96,0.23076923076923078,0.8125,0.2356267457860859,0.8492277805081009
7,98,32,137,0.06666666666666667,0.7664233576642335,0.2154475850128657,0.8404498526802747
9,46,4,59,0.16363636363636364,0.9322033898305084,0.19593481787030173,0.8575011888421692
2,17,11,30,0.10526315789473684,0.6333333333333333,0.1909724118552641,0.813206489830489
2,8,14,24,0.2,0.4166666666666667,0.19898841898841899,0.8050860662127935
35,50,27,112,0.4117647058823529,0.7589285714285714,0.18638337697161228,0.7706472907025895
24,46,19,89,0.34285714285714286,0.7865168539325843,0.22437395781933597,0.7591973174548634
25,36,39,100,0.4098360655737705,0.61,0.2517864360514863,0.7314653586919768
108,215,69,392,0.33436532507739936,0.8239795918367347,0.28632539783503014,0.7373754867183427
5,81,10,96,0.05813953488372093,0.8958333333333334,0.2738518248963409,0.7321797643616034
0,7,24,31,0.0,0.22580645161290322,0.25099468203919806,0.6453902098301133
1,11,1,13,0.08333333333333333,0.9230769230769231,0.2343280153725314,0.7177345321744356
1,8,3,12,0.1111111111111111,0.75,0.19137750183378258,0.716459021970354
11,62,185,258,0.1506849315068493,0.28294573643410853,0.16392432878374064,0.6445202908991432
45,56,44,145,0.44554455445544555,0.696551724137931,0.16902554148112278,0.6568848229188476
1,9,20,30,0.1,0.3333333333333333,0.13554478075578,0.5867925002755047
7,114,0,121,0.05785123966942149,1.0,0.13550359572516582,0.601673452656457
7,39,2,48,0.15217391304347827,0.9583333333333334,0.15724272615994841,0.7063201500450899
20,122,40,182,0.14084507042253522,0.7802197802197802,0.16545868860126298,0.6859119867797837
14,108,11,133,0.11475409836065574,0.9172932330827067,0.16597911535119794,0.7098110200773132
24,87,22,133,0.21621621621621623,0.8345864661654135,0.17534072745253607,0.7886168386103568
3,97,7,107,0.03,0.9345794392523364,0.11597721967318668,0.8226207979124147
45,140,32,217,0.24324324324324326,0.8525345622119815,0.13644054013650717,0.8967924020379359
5,72,4,81,0.06493506493506493,0.9506172839506173,0.1374525151744562,0.8897377283165956
5,41,7,53,0.10869565217391304,0.8679245283018868,0.1312413350502326,0.8768221847406746
2,25,4,31,0.07407407407407407,0.8709677419354839,0.12170262128616673,0.8897861792714894
6,114,26,146,0.05,0.821917808219178,0.11245203580607306,0.8761611185766996
9,77,43,129,0.10465116279069768,0.6666666666666666,0.09651417103099898,0.8521725757911643
29,63,43,135,0.31521739130434784,0.6814814814814815,0.1372595126459058,0.8160157246810422
39,53,5,97,0.42391304347826086,0.9484536082474226,0.16306948410805117,0.829718445543248
8,28,31,67,0.2222222222222222,0.5373134328358209,0.18553907800621652,0.7706750382411344
17,69,35,121,0.19767441860465115,0.7107438016528925,0.19825033035346482,0.7482206487198494
13,32,3,48,0.28888888888888886,0.9375,0.22893816104129547,0.7577252570147802
11,68,10,89,0.13924050632911392,0.8876404494382022,0.2416868048025975,0.767114205760355
5,23,2,30,0.17857142857142858,0.9333333333333333,0.2522468427712733,0.8052094438555931
9,63,3,75,0.125,0.96,0.22507292972779508,0.844997803643953
12,34,1,47,0.2608695652173913,0.9787234042553191,0.20178100426195655,0.8493220602165097
9,50,3,62,0.15254237288135594,0.9516129032258065,0.19182674007040426,0.9085076988436505
6,114,41,161,0.05,0.7453416149068323,0.17073039455545405,0.9134502435942133
11,75,115,201,0.12790697674418605,0.42786069651741293,0.14773297853478226,0.8406446288109866
26,69,54,149,0.2736842105263158,0.6375838926174496,0.16693922199152536,0.804922263550879
3,33,24,60,0.08333333333333333,0.6,0.15333377981465462,0.7573032159318315
24,153,27,204,0.13559322033898305,0.8676470588235294,0.1548470970059379,0.744109938620907
8,44,7,59,0.15384615384615385,0.8813559322033898,0.1395580382386183,0.7302002997563458
2,10,1,13,0.16666666666666666,0.9230769230769231,0.14157579449366267,0.7261237311636481
46,22,11,79,0.6764705882352942,0.8607594936708861,0.23107159281299042,0.7426119995585129
7,34,12,53,0.17073170731707318,0.7735849056603774,0.23718941146626,0.7920011722932221
20,81,21,122,0.19801980198019803,0.8278688524590164,0.22638021024538604,0.8191847379848746
127,309,109,545,0.29128440366972475,0.8,0.2560875060077276,0.8477561665563031
7,43,3,53,0.14,0.9433962264150944,0.2567170459593015,0.8585774762122409
12,50,30,92,0.1935483870967742,0.6739130434782609,0.26238879356653294,0.8289427778229369
1,1,0,2,0.5,1.0,0.31000784118558056,0.8399317888119479
1,12,2,15,0.07692307692307693,0.8666666666666667,0.22435819671240667,0.8407756706684878
21,57,18,96,0.2692307692307692,0.8125,0.23842949127150614,0.8463349698598626
8,99,31,138,0.07476635514018691,0.7753623188405797,0.2208218560086474,0.8388340364858002
10,45,4,59,0.18181818181818182,0.9322033898305084,0.20518382431556983,0.8577202350330156
4,20,6,30,0.16666666666666666,0.8,0.20899334812509365,0.8372350598308593
2,7,16,25,0.2222222222222222,0.36,0.19996515207524376,0.7980260248049261
37,44,31,112,0.4567901234567901,0.7232142857142857,0.19379231256907095,0.7584852084783955
27,43,19,89,0.38571428571428573,0.7865168539325843,0.23790534239638653,0.7470352352306693
25,36,40,101,0.4098360655737705,0.6039603960396039,0.26348631879703505,0.718440475902012
110,222,60,392,0.3313253012048193,0.8469387755102041,0.29902296077780216,0.7265952906229314
4,75,18,97,0.05063291139240506,0.8144329896907216,0.2880744156520418,0.7097709477458191
0,7,24,31,0.0,0.22580645161290322,0.265217272794899,0.6229813932143289
2,10,1,13,0.16666666666666666,0.9230769230769231,0.2572807648583911,0.7034209536538895
1,8,3,12,0.1111111111111111,0.75,0.2078980488090083,0.7072474842661344
12,20,226,258,0.375,0.12403100775193798,0.20636743656411038,0.6126066490974704
45,47,53,145,0.4891304347826087,0.6344827586206897,0.2176952035939444,0.6169669866090542
2,11,17,30,0.15384615384615385,0.43333333333333335,0.1923410396855636,0.5578804948695012
7,114,0,121,0.05785123966942149,1.0,0.1933722294394231,0.5843900677708268
7,37,4,48,0.1590909090909091,0.9166666666666666,0.21609950216669582,0.6830843842070786
21,121,41,183,0.14788732394366197,0.7759562841530054,0.21341673892055232,0.6620671500750903
18,107,13,138,0.144,0.9057971014492754,0.218115151618965,0.6843238788535582
26,83,25,134,0.23853211009174313,0.8134328358208955,0.19861973877492828,0.7828098542919807
4,96,7,107,0.04,0.9345794392523364,0.1344582480916985,0.8256808086679304
45,138,34,217,0.2459016393442623,0.8433179723502304,0.14760903173428544,0.8842500428132014
5,73,4,82,0.0641025641025641,0.9512195121951219,0.14850207808187724,0.8772814016982188
5,41,7,53,0.10869565217391304,0.8679245283018868,0.14130275566516348,0.8703182390746788
3,25,5,33,0.10714285714285714,0.8484848484848485,0.1354821175507628,0.8806794625506563
6,115,25,146,0.049586776859504134,0.8287671232876712,0.12199451424497768,0.8696751799561415
9,79,40,128,0.10227272727272728,0.6875,0.10252888812797542,0.8516847748388707
32,56,47,135,0.36363636363636365,0.6518518518518519,0.14876265436174166,0.8112951194959444
39,52,6,97,0.42857142857142855,0.9381443298969072,0.1748583385370511,0.8248417420026125
9,27,31,67,0.25,0.5373134328358209,0.20141511509382767,0.7657123020941409
12,90,20,122,0.11764705882352941,0.8360655737704918,0.2026938874723443,0.7611610228753702
14,32,3,49,0.30434782608695654,0.9387755102040817,0.2308660258929299,0.7740596888352606
12,69,25,106,0.14814814814814814,0.7641509433962265,0.24494622179130765,0.7648288059936258
5,20,5,30,0.2,0.8333333333333334,0.2589072607523466,0.785662139326959
10,62,3,75,0.1388888888888889,0.96,0.22680047864556446,0.829683303348123
11,35,1,47,0.2391304347826087,0.9787234042553191,0.19973747953287596,0.8354803139707533
10,49,3,62,0.1694915254237288,0.9516129032258065,0.18823626887912295,0.894665952597894
6,114,41,161,0.05,0.7453416149068323,0.17857240333290444,0.8817053870459427
12,83,109,204,0.12631578947368421,0.46568627450980393,0.1531392552452941,0.8141212105181888
27,70,54,151,0.27835051546391754,0.6423841059602649,0.17173959343326115,0.7967259480273371
3,33,24,60,0.08333333333333333,0.6,0.15507292676659448,0.7633926146940038
23,154,27,204,0.12994350282485875,0.8676470588235294,0.15379501447173302,0.7501993373830794
9,48,7,64,0.15789473684210525,0.890625,0.14218991476594683,0.737613851060891
2,9,2,13,0.18181818181818182,0.8461538461538461,0.14395086567944013,0.7225482714791823
46,19,14,79,0.7076923076923077,0.8227848101265823,0.23790690963548405,0.7336115850820037
7,34,12,53,0.17073170731707318,0.7735849056603774,0.24425204075596824,0.7775971038177999
20,85,17,122,0.19047619047619047,0.860655737704918,0.2316985657577215,0.8087787654956076
131,303,117,551,0.30184331797235026,0.7876588021778584,0.2629142778490096,0.8355871658067302
6,36,11,53,0.14285714285714285,0.7924528301886793,0.26475908356790734,0.8248451331446088
13,39,39,91,0.25,0.5714285714285714,0.27791697830474943,0.7792456433486904
1,1,0,2,0.5,1.0,0.3233715237592949,0.8012236653267123
1,12,2,15,0.07692307692307693,0.8666666666666667,0.2332616336494048,0.8074925019752958
17,61,19,97,0.21794871794871795,0.8041237113402062,0.2400069208824969,0.8118551885009856
10,98,30,138,0.09259259259259259,0.782608695652174,0.22602354975626865,0.8007056110648794
8,47,4,59,0.14545454545454545,0.9322033898305084,0.20368229653943937,0.8213548378724008
4,21,5,30,0.16,0.8333333333333334,0.20613127613127613,0.8271949097502086
2,7,16,25,0.2222222222222222,0.36,0.1951882964430185,0.7835788900188082
37,43,32,112,0.4625,0.7142857142857143,0.18983115358587566,0.7427625634881959
24,46,18,88,0.34285714285714286,0.7954545454545454,0.22782173443359935,0.7325894033150359
26,33,42,101,0.4406779661016949,0.5841584158415841,0.26330320211845687,0.7011657896723754
94,208,90,392,0.31125827814569534,0.7704081632653061,0.29728374250886425,0.6983876597868809
4,74,18,96,0.05128205128205128,0.8125,0.2793996658012581,0.6909724055495927
0,7,24,31,0.0,0.22580645161290322,0.26154252294411523,0.6089447557800075
2,10,1,13,0.16666666666666666,0.9230769230769231,0.25360601500760727,0.689384316219568
1,8,3,12,0.1111111111111111,0.75,0.2034076023091946,0.6944863570358945
13,18,227,258,0.41935483870967744,0.12015503875968993,0.21433584457384236,0.5980149989366295
45,47,53,145,0.4891304347826087,0.6344827586206897,0.22125762581397293,0.605204190762216
2,12,16,30,0.14285714285714285,0.4666666666666667,0.19720032077275113,0.5618125483909818
5,116,0,121,0.04132231404958678,1.0,0.19577750116811332,0.588598262676696
6,37,4,47,0.13953488372093023,0.9148936170212766,0.21571105598538906,0.6870392863064636
21,121,41,183,0.14788732394366197,0.7759562841530054,0.21302829273924556,0.6660220521744754
19,106,13,138,0.152,0.9057971014492754,0.2188695625805154,0.6882787809529434
25,84,25,134,0.22935779816513763,0.8134328358208955,0.1917271282170097,0.7873184662474012
4,96,7,107,0.04,0.9345794392523364,0.1275656375337799,0.8301894206233509
45,138,34,217,0.2459016393442623,0.8433179723502304,0.14228627988908268,0.8839967500067171
5,73,4,82,0.0641025641025641,0.9512195121951219,0.14554060132522229,0.8770281088917345
5,40,8,53,0.1111111111111111,0.8490566037735849,0.14148006238096242,0.8676228212849214
3,25,5,33,0.10714285714285714,0.8484848484848485,0.13565942426656175,0.877984044760899
7,114,25,146,0.05785123966942149,0.8287671232876712,0.12220960136219337,0.8669797621663841
9,77,42,128,0.10465116279069768,0.671875,0.10439436773727338,0.8467572141919704
31,57,47,135,0.3522727272727273,0.6518518518518519,0.149004757347663,0.8063675588490441
39,52,6,97,0.42857142857142855,0.9381443298969072,0.17510044152297247,0.8199141813557123
7,22,38,67,0.2413793103448276,0.43283582089552236,0.20042569098615298,0.7458593683129122
14,88,20,122,0.13725490196078433,0.8360655737704918,0.204160518250392,0.7440035068838989
14,32,3,49,0.30434782608695654,0.9387755102040817,0.23233265667097763,0.7569021728437894
12,70,24,106,0.14634146341463414,0.7735849056603774,0.244974117206008,0.749018998897033
5,20,5,30,0.2,0.8333333333333334,0.2585953796644798,0.7720844750875093
9,62,4,75,0.1267605633802817,0.9466666666666667,0.22637935625127323,0.8142008772039114
10,35,1,46,0.2222222222222222,0.9782608695652174,0.19690089820138665,0.8199318114422416
9,50,3,62,0.15254237288135594,0.9516129032258065,0.1842099071351764,0.8940428232037105
5,114,41,160,0.04201680672268908,0.74375,0.17060446495830564,0.8808548840936403
13,79,112,204,0.14130434782608695,0.45098039215686275,0.14731253949246711,0.8111698672297519
27,67,55,149,0.2872340425531915,0.6308724832214765,0.16744005079797533,0.7907823783099089
4,33,23,60,0.10810810810810811,0.6166666666666667,0.1543126376705622,0.759829997357528
23,154,27,204,0.12994350282485875,0.8676470588235294,0.15476734330550176,0.7485414819513655
9,47,8,64,0.16071428571428573,0.875,0.1459804952329394,0.7337899291563346
1,10,2,13,0.09090909090909091,0.8461538461538461,0.13717574066547297,0.7187243495746258
46,19,14,79,0.7076923076923077,0.8227848101265823,0.23227224080398992,0.7300150367355663
6,35,12,53,0.14634146341463414,0.7735849056603774,0.232991828745211,0.7761013958074968
20,83,19,122,0.1941747572815534,0.8442622950819673,0.21969764513497697,0.8065856546447098
137,310,106,553,0.30648769574944074,0.8083182640144665,0.2480375862265959,0.8339644542658241
6,35,11,52,0.14634146341463414,0.7884615384615384,0.25038015202513525,0.822652237071254
14,39,39,92,0.2641509433962264,0.5760869565217391,0.26515681740826963,0.7799503737172168
1,1,0,2,0.5,1.0,0.3235983758498281,0.8019283956952387
1,12,2,15,0.07692307692307693,0.8666666666666667,0.23348848573993794,0.8081972323438221
18,60,19,97,0.23076923076923078,0.8041237113402062,0.2455495953620232,0.8125599188695121
9,100,29,138,0.08256880733944955,0.7898550724637681,0.2296058882274369,0.8047874584954835
7,48,4,59,0.12727272727272726,0.9322033898305084,0.2040037498736207,0.822485333612061
4,21,5,30,0.16,0.8333333333333334,0.20595496938581584,0.8288955900223174
2,7,16,25,0.2222222222222222,0.36,0.1950295075295075,0.7752797708132778
39,44,29,112,0.46987951807228917,0.7410714285714286,0.19072658153983452,0.7382899748949104
25,45,18,88,0.35714285714285715,0.7954545454545454,0.23075797871408885,0.7281168147217503
26,34,40,100,0.43333333333333335,0.6,0.2670217149778251,0.6989562845302922
100,221,71,392,0.3115264797507788,0.8188775510204082,0.3009434872173543,0.7041375495828971
4,72,20,96,0.05263157894736842,0.7916666666666666,0.28167656992412127,0.7010100273875784
0,6,25,31,0.0,0.1935483870967742,0.2638194270669784,0.6143740826871175
1,11,1,13,0.08333333333333333,0.9230769230769231,0.24397815722570856,0.6948136431266779
1,8,3,12,0.1111111111111111,0.75,0.192725527659826,0.6960891533307595
10,20,228,258,0.3333333333333333,0.11627906976744186,0.1893241671156083,0.5990640853754591
45,47,53,145,0.4891304347826087,0.6344827586206897,0.1972951816083619,0.6039901937498433
1,14,15,30,0.06666666666666667,0.5,0.16231520831063162,0.558436257889785
6,115,0,121,0.049586776859504134,1.0,0.16188023658379386,0.5881981626516898
6,37,4,47,0.13953488372093023,0.9148936170212766,0.1818137914010696,0.6912474812123329
20,122,41,183,0.14084507042253522,0.7759562841530054,0.19002975384238416,0.6702302470803447
18,108,12,138,0.14285714285714285,0.9130434782608695,0.1945649012346744,0.6935221725461832
25,82,25,132,0.2336448598130841,0.8106060606060606,0.1803236907317817,0.7927117426659859
4,96,7,107,0.04,0.9345794392523364,0.11616220004855186,0.8355826970419356
45,138,34,217,0.2459016393442623,0.8433179723502304,0.14176719614535122,0.884628121663397
5,73,4,82,0.0641025641025641,0.9512195121951219,0.14384088003721693,0.8776594805484143
5,41,7,53,0.10869565217391304,0.8679245283018868,0.1394352755305002,0.8709496107313586
3,25,5,33,0.10714285714285714,0.8484848484848485,0.13462067363340333,0.8813108342073361
7,114,25,146,0.05785123966942149,0.8287671232876712,0.12247697317801456,0.8692713549254508
10,77,42,129,0.11494252873563218,0.6744186046511628,0.10551949730980714,0.849816004074751
30,58,47,135,0.3409090909090909,0.6518518518518519,0.14850651029682013,0.8094263487318248
39,52,6,97,0.42857142857142855,0.9381443298969072,0.1746021944721296,0.8229729712384929
8,27,32,67,0.22857142857142856,0.5223880597014925,0.19809774653911025,0.7617113351679744
15,83,24,122,0.15306122448979592,0.8032786885245902,0.20443568544137922,0.7524762151997891
14,32,3,49,0.30434782608695654,0.9387755102040817,0.23260782386196485,0.7653748811596796
16,65,25,106,0.19753086419753085,0.7641509433962265,0.25256205593740905,0.7561439983180446
7,18,5,30,0.28,0.8333333333333334,0.2761416946894616,0.7788461024154975
9,61,5,75,0.12857142857142856,0.9333333333333333,0.24580774292693844,0.8190577426271377
10,36,1,47,0.21739130434782608,0.9787234042553191,0.21563915375213805,0.824854753249768
9,47,5,61,0.16071428571428573,0.9180327868852459,0.20594527620111763,0.8813754285617329
6,113,41,160,0.05042016806722689,0.74375,0.19128226814075064,0.872871330201077
12,83,109,204,0.12631578947368421,0.46568627450980393,0.16584912005314031,0.805287153673323
28,69,51,148,0.28865979381443296,0.6554054054054054,0.1788675385698406,0.7897520768174914
4,33,23,60,0.10810810810810811,0.6166666666666667,0.15431155401385604,0.7587996958651105
24,152,27,203,0.13636363636363635,0.8669950738916257,0.1554247265556,0.7493228016591523
9,48,7,64,0.15789473684210525,0.890625,0.1469252169119256,0.736737315336964
2,9,2,13,0.18181818181818182,0.8461538461538461,0.14994005921248219,0.7264688952324782
46,19,14,79,0.7076923076923077,0.8227848101265823,0.24383607915892233,0.7377595823934185
6,35,12,53,0.14634146341463414,0.7735849056603774,0.2466968897219152,0.7817451011292148
21,84,17,122,0.2,0.860655737704918,0.23403120489128187,0.8110665771720021
131,308,113,552,0.2984054669703872,0.7952898550724637,0.2612165418716075,0.8365841755156875
7,34,11,52,0.17073170731707318,0.7884615384615384,0.26612626629352704,0.825365099025675
14,39,39,92,0.2641509433962264,0.5760869565217391,0.2813057243726872,0.7804310928144949
1,1,0,2,0.5,1.0,0.32676026982723266,0.8024091147925169
1,12,2,15,0.07692307692307693,0.8666666666666667,0.23665037971734254,0.8086779514411004
15,63,19,97,0.19230769230769232,0.8041237113402062,0.2432169838449223,0.8130406379667903
8,101,29,138,0.07339449541284404,0.7898550724637681,0.2251304831896143,0.8029262572180546
9,42,8,59,0.17647058823529413,0.864406779661017,0.2077112147988867,0.8128001035878478
3,21,6,30,0.125,0.8,0.20117811375359054,0.8144484552361996
2,7,16,25,0.2222222222222222,0.36,0.1918601468290909,0.7830172035652875
40,44,28,112,0.47619047619047616,0.75,0.1884587862848732,0.7473029178510018
25,44,19,88,0.36231884057971014,0.7840909090909091,0.22922960966439224,0.7355063810544651
29,35,36,100,0.453125,0.64,0.2624218638387893,0.712351619149703
101,219,72,392,0.315625,0.8163265306122449,0.29850214054406593,0.7140628626533158
4,71,21,96,0.05333333333333334,0.78125,0.2813959134378389,0.6997620151956886
0,6,25,31,0.0,0.1935483870967742,0.26897355318939165,0.6178879752571325
1,11,1,13,0.08333333333333333,0.9230769230769231,0.24913228334812182,0.6983275356966929
1,8,3,12,0.1111111111111111,0.75,0.19697808833678396,0.6983275356966929
10,20,228,258,0.3333333333333333,0.11627906976744186,0.19283730158730153,0.602925844364769
45,48,53,146,0.4838709677419355,0.636986301369863,0.19722958269329233,0.6024953159890353
1,14,15,30,0.06666666666666667,0.5,0.16166410650281615,0.5573058116158573
4,116,1,121,0.03333333333333333,0.9917355371900827,0.1588069636456733,0.5873751740715835
7,37,4,48,0.1590909090909091,0.9166666666666666,0.18153423637294602,0.6906777854387111
20,122,42,184,0.14084507042253522,0.7717391304347826,0.1897501988142606,0.669058100775548
19,107,12,138,0.15079365079365079,0.9130434782608695,0.19541913305462338,0.6923500262413864
26,80,24,130,0.24528301886792453,0.8153846153846154,0.18284051670242213,0.7922222470438397
4,93,7,104,0.041237113402061855,0.9326923076923077,0.11960710893958304,0.8344659622327606
44,139,34,217,0.24043715846994534,0.8433179723502304,0.14443146491147998,0.883511386854222
5,73,4,82,0.0641025641025641,0.9512195121951219,0.1488270693070844,0.8777233832835133
6,39,7,52,0.13333333333333333,0.8653846153846154,0.1451474156274307,0.870397375957506
3,25,4,32,0.10714285714285714,0.875,0.14033281373033385,0.885148928752537
7,116,23,146,0.056910569105691054,0.8424657534246576,0.12692094491776815,0.8750663966330782
10,76,43,129,0.11627906976744186,0.6666666666666666,0.1084918093319849,0.853820975387657
32,55,48,135,0.367816091954023,0.6444444444444445,0.1551459491251222,0.8126427092093907
39,52,6,97,0.42857142857142855,0.9381443298969072,0.1820222734253341,0.826189331716059
6,27,34,67,0.18181818181818182,0.4925373134328358,0.19883879024185092,0.7606633033214466
13,89,18,120,0.12745098039215685,0.85,0.19799845410739714,0.7584655011236444
14,32,3,49,0.30434782608695654,0.9387755102040817,0.22617059252798274,0.767576288295656
14,65,27,106,0.17721518987341772,0.7452830188679245,0.2433569669233723,0.753693040501837
6,19,5,30,0.24,0.8333333333333334,0.26103138552802346,0.7775025643113608
8,64,4,76,0.1111111111111111,0.9473684210526315,0.2243592454076075,0.8207774181125306
10,36,1,47,0.21739130434782608,0.9787234042553191,0.19419065623280712,0.8265744287351607
7,50,4,61,0.12280701754385964,0.9344262295081968,0.18576048990790398,0.8897014167459266
6,113,41,160,0.05042016806722689,0.74375,0.1747560881471997,0.8745228453173552
11,83,110,204,0.11702127659574468,0.46078431372549017,0.147995152505598,0.8062383886775564
25,67,56,148,0.2717391304347826,0.6216216216216216,0.16149857258579295,0.7885724747852274
4,33,23,60,0.10810810810810811,0.6166666666666667,0.1426568737440941,0.7576200938328465
22,154,27,203,0.125,0.8669950738916257,0.14464100072822111,0.7461381870955598
9,48,7,64,0.15789473684210525,0.890625,0.1361414910845467,0.7335527007733715
2,10,1,13,0.16666666666666666,0.9230769230769231,0.1424071552449477,0.7319313712831895
46,19,14,79,0.7076923076923077,0.8227848101265823,0.23630317519138783,0.7432220584441298
6,35,12,53,0.14634146341463414,0.7735849056603774,0.24049177330837201,0.7879078572919708
19,86,18,123,0.18095238095238095,0.8536585365853658,0.22752223766802895,0.8210559880010772
146,293,113,552,0.3325740318906606,0.7952898550724637,0.2595887982083936,0.8465735863447624
7,34,11,52,0.17073170731707318,0.7884615384615384,0.26612189925368973,0.83535450985475
14,39,39,92,0.2641509433962264,0.5760869565217391,0.28130135733284994,0.7904205036435699
1,1,0,2,0.5,1.0,0.3289204049518975,0.8014095146325809
1,12,2,15,0.07692307692307693,0.8666666666666667,0.23881051484200744,0.8076783512811644
14,64,19,97,0.1794871794871795,0.8041237113402062,0.24354561713808537,0.8120410378068542
8,100,30,138,0.07407407407407407,0.782608695652174,0.2282772875840415,0.8018910605306839
9,39,11,59,0.1875,0.8135593220338984,0.20755242588537567,0.8045009843823175
3,21,6,30,0.125,0.8,0.20101932484007953,0.8061493360306692
2,7,16,25,0.2222222222222222,0.36,0.20884255578133123,0.7678857862231112
39,45,28,112,0.4642857142857143,0.75,0.20374051496500473,0.7321715005088255
23,46,19,88,0.3333333333333333,0.7840909090909091,0.23945480067929045,0.729898773236098
25,37,39,101,0.4032258064516129,0.6138613861386139,0.26551859863248933,0.7030099236368524
99,219,73,391,0.3113207547169811,0.8132992327365729,0.30073373290422734,0.7073942860774809
7,69,21,97,0.09210526315789473,0.7835051546391752,0.2847371086906322,0.7006795260864671
0,6,25,31,0.0,0.1935483870967742,0.26092758488110834,0.6140435813860063
2,10,1,13,0.16666666666666666,0.9230769230769231,0.2529910769446004,0.6944831418255669
1,8,3,12,0.1111111111111111,0.75,0.20253756220537136,0.6944831418255669
12,19,227,258,0.3870967741935484,0.12015503875968993,0.21021805375683064,0.5996351603496783
44,48,53,145,0.4782608695652174,0.6344827586206897,0.2209373484873456,0.6025810707042607
1,13,16,30,0.07142857142857142,0.4666666666666667,0.18666703658900136,0.5530621326942741
5,118,0,123,0.04065040650406504,1.0,0.1793163427813114,0.5839899677458205
5,38,4,47,0.11627906976744186,0.9148936170212766,0.19592763846237451,0.6870392863064636
20,123,41,184,0.13986013986013987,0.7771739130434783,0.1920981346328707,0.6661959991588287
17,109,12,138,0.1349206349206349,0.9130434782608695,0.19549949517708837,0.6894879246246671
28,83,22,133,0.25225225225225223,0.8345864661654135,0.1762359920426175,0.791549557111199
4,93,7,104,0.041237113402061855,0.9326923076923077,0.11380402687645241,0.8341509212642874
43,141,34,218,0.23369565217391305,0.8440366972477065,0.13698503841150123,0.8880609256330073
5,73,4,82,0.0641025641025641,0.9512195121951219,0.14033534663985822,0.8810922845180248
5,41,7,53,0.10869565217391304,0.8679245283018868,0.13925200126935414,0.8743824147009691
3,26,3,32,0.10344827586206896,0.90625,0.13405030641248686,0.892821855694758
8,115,22,145,0.06504065040650407,0.8482758620689655,0.12406745148189673,0.8835693390959144
11,76,42,129,0.12643678160919541,0.6744186046511628,0.10609381281860289,0.86068821602245
32,54,48,134,0.37209302325581395,0.6417910447761194,0.1533589427977103,0.8191308927487089
38,53,6,97,0.4175824175824176,0.9381443298969072,0.17962848071321097,0.8325748402700233
8,27,32,67,0.22857142857142856,0.5223880597014925,0.20312403278019162,0.7713132041995048
13,89,18,120,0.12745098039215685,0.85,0.2058033653827979,0.7687525572992353
14,31,3,48,0.3111111111111111,0.9375,0.23546948470408963,0.773216843013521
13,63,32,108,0.17105263157894737,0.7037037037037037,0.2506140534430101,0.7525636775327692
6,20,4,30,0.23076923076923078,0.8666666666666667,0.26551868903730086,0.7800276863921269
8,62,6,76,0.11428571428571428,0.9210526315789473,0.22868907347014375,0.8199221987925309
10,36,1,47,0.21739130434782608,0.9787234042553191,0.20009034300805925,0.8257192094151612
7,51,3,61,0.1206896551724138,0.9508196721311475,0.18467866109391431,0.8869237254765405
7,112,41,160,0.058823529411764705,0.74375,0.17487473952528684,0.871745154047969
8,88,109,205,0.08333333333333333,0.4682926829268293,0.1423350569856043,0.8047155373232303
32,71,45,148,0.3106796116504854,0.6959459459459459,0.16228176842439548,0.8036072862149793
4,32,23,59,0.1111111111111111,0.6101694915254238,0.14518775133037834,0.7669648326233732
22,154,27,203,0.125,0.8669950738916257,0.14671836357527632,0.7592423243823273
9,49,6,64,0.15517241379310345,0.90625,0.13782995063888737,0.7488889809172816
2,9,2,13,0.18181818181818182,0.8461538461538461,0.14656259730256854,0.7339367200633814
45,20,14,79,0.6923076923076923,0.8227848101265823,0.2370603348591296,0.7452274072243217
6,36,12,54,0.14285714285714285,0.7777777777777778,0.24556373621967384,0.7894395636316001
19,86,19,124,0.18095238095238095,0.8467741935483871,0.22703127469137319,0.8109864561462347
146,299,106,551,0.32808988764044944,0.8076225045372051,0.25802824276699293,0.8391940294336321
7,34,11,52,0.17073170731707318,0.7884615384615384,0.2645613438122891,0.8279749529436194
14,39,38,91,0.2641509433962264,0.5824175824175825,0.2801297051841638,0.7817131790032741
1,1,0,2,0.5,1.0,0.32558425063870927,0.8036912009812961
1,12,2,15,0.07692307692307693,0.8666666666666667,0.23767216272662137,0.8099600376298797
17,60,19,96,0.22077922077922077,0.8020833333333334,0.24880388814406104,0.8134322598521019
7,104,27,138,0.06306306306306306,0.8043478260869565,0.23196255701701562,0.8073713502147546
9,43,7,59,0.17307692307692307,0.8813559322033898,0.20981784779365475,0.8179046970242095
2,21,7,30,0.08695652173913043,0.7666666666666667,0.1978499641396629,0.8147911439106564
2,7,15,24,0.2222222222222222,0.375,0.20176940459959325,0.7752221725093867
33,50,29,112,0.39759036144578314,0.7410714285714286,0.1871394562347051,0.7382323765910195
22,48,19,89,0.3142857142857143,0.7865168539325843,0.2201326535136167,0.7363062128671031
26,33,49,108,0.4406779661016949,0.5462962962962963,0.2571126226969757,0.6997652075760977
85,218,89,392,0.28052805280528054,0.7729591836734694,0.2877540965478648,0.7004570992395954
8,69,20,97,0.1038961038961039,0.7938144329896907,0.27512386963192365,0.6879511707804955
0,6,25,31,0.0,0.1935483870967742,0.2513143458223998,0.6013152260800346
0,12,1,13,0.0,0.9230769230769231,0.21956831407636807,0.679611929376738
1,8,3,12,0.1111111111111111,0.75,0.17864270688570066,0.6808874395808197
11,20,227,258,0.3548387096774194,0.12015503875968993,0.18443599194165852,0.5856928945561205
45,47,53,145,0.4891304347826087,0.6344827586206897,0.19135777318178906,0.5982909606024622
0,9,21,30,0.0,0.3,0.151282337066749,0.5307253629348239
4,119,0,123,0.032520325203252036,1.0,0.1410857972534844,0.5601804439362966
6,38,4,48,0.13636363636363635,0.9166666666666666,0.1605663167340039,0.6634830553034241
19,123,42,184,0.13380281690140844,0.7717391304347826,0.17968100486277655,0.6418633706402611
15,106,12,133,0.12396694214876033,0.9097744360902256,0.18151755215386928,0.6646882900817219
25,85,23,133,0.22727272727272727,0.8270676691729323,0.16329384038177044,0.7656758087121851
3,93,8,104,0.03125,0.9230769230769231,0.09788234969854061,0.8069035464916471
44,139,35,218,0.24043715846994534,0.8394495412844036,0.13223051519424708,0.8839677666751333
4,74,4,82,0.05128205128205128,0.9512195121951219,0.13491076177693268,0.8769991255601507
5,39,9,53,0.11363636363636363,0.8301886792452831,0.13166400853017943,0.8646451273570959
3,26,3,32,0.10344827586206896,0.90625,0.12732764552455952,0.8838609658664127
8,117,21,146,0.064,0.8561643835616438,0.11876093950330804,0.8762023869337582
10,77,42,129,0.11494252873563218,0.6744186046511628,0.10271376828372303,0.8543953777163624
32,54,48,134,0.37209302325581395,0.6417910447761194,0.15140562874883928,0.8142116808162478
39,52,6,97,0.42857142857142855,0.9381443298969072,0.17828195304905117,0.8283109363323196
7,23,36,66,0.23333333333333334,0.45454545454545453,0.2042892790563772,0.7573574995252244
12,87,21,120,0.12121212121212122,0.825,0.20537153013862827,0.7566162596330409
13,33,3,49,0.2826086956521739,0.9387755102040817,0.230965875822929,0.761262761090767
11,36,50,97,0.23404255319148937,0.4845360824742268,0.2552576691359989,0.7081730037925646
7,19,4,30,0.2692307692307692,0.8666666666666667,0.2772988463495899,0.7356370126519222
9,63,5,77,0.125,0.935064935064935,0.24199984302733077,0.7775332826931817
10,36,1,47,0.21739130434782608,0.9787234042553191,0.21183125385253043,0.7833302933158119
9,47,6,62,0.16071428571428573,0.9032258064516129,0.20145710419266646,0.8474274864452631
7,113,40,160,0.058333333333333334,0.75,0.19247442020998246,0.8367132007309773
9,81,115,205,0.1,0.43902439024390244,0.16638746368824336,0.7653201835938088
27,66,55,148,0.2903225806451613,0.6283783783783784,0.17442746761019648,0.7858690830086876
3,34,23,60,0.08108108108108109,0.6166666666666667,0.14754894073166963,0.750154797294402
21,155,27,203,0.11931818181818182,0.8669950738916257,0.1467372524199813,0.7404305314125006
7,43,7,57,0.14,0.8771929824561403,0.1356813517988633,0.7259261854411895
2,10,1,13,0.16666666666666666,0.9230769230769231,0.1365316919349177,0.7287620592448052
45,20,14,79,0.6923076923076923,0.8227848101265823,0.2270994575026833,0.7391598892628883
6,36,12,54,0.14285714285714285,0.7777777777777778,0.23322190648227512,0.7875532303391563
16,87,21,124,0.1553398058252427,0.8306451612903226,0.21393865293657247,0.8164484850408625
138,290,118,546,0.32242990654205606,0.7838827838827839,0.24841705657385457,0.8403365017860221
7,34,11,52,0.17073170731707318,0.7884615384615384,0.2557618459308391,0.8291174252960097
14,34,39,87,0.2916666666666667,0.5517241379310345,0.2774285125975057,0.7826218760781375
1,1,0,2,0.5,1.0,0.32504756021655334,0.7936108870671484
1,11,3,15,0.08333333333333333,0.8,0.23805122322021638,0.7903559141919223
17,60,19,96,0.22077922077922077,0.8020833333333334,0.24918294863765605,0.7938281364141445
7,101,30,138,0.06481481481481481,0.782608695652174,0.2362508070647378,0.7869657841801233
10,39,10,59,0.20408163265306123,0.8305084745762712,0.2193439107948814,0.7936265971363359
4,20,6,30,0.16666666666666666,0.8,0.21876319070196618,0.7952749487846874
2,7,15,24,0.2222222222222222,0.375,0.20371453942882511,0.7741869758220163
36,44,32,112,0.45,0.7142857142857143,0.19657168228596797,0.7333706492914042
22,48,19,89,0.3142857142857143,0.7865168539325843,0.22956487956487953,0.7314444855674874
26,38,44,108,0.40625,0.5925925925925926,0.2597712803069946,0.7015172368902388
107,226,59,392,0.3213213213213213,0.8494897959183674,0.29615051668623094,0.714177269847521
7,71,20,98,0.08974358974358974,0.7959183673469388,0.2814985020342163,0.7019719034394567
0,6,25,31,0.0,0.1935483870967742,0.25768897822469244,0.6153359587389957
0,12,1,13,0.0,0.9230769230769231,0.2259429464786607,0.6936326620356992
1,8,3,12,0.1111111111111111,0.75,0.17753024806596232,0.6987347028520257
11,20,227,258,0.3548387096774194,0.12015503875968993,0.1833235331219202,0.6035401578273266
45,47,53,145,0.4891304347826087,0.6344827586206897,0.19516359523372143,0.6095244672599118
0,10,20,30,0.0,0.3333333333333333,0.14926054933067553,0.5357878297477641
5,118,0,123,0.04065040650406504,1.0,0.14224723743931486,0.5649423486982014
6,38,4,48,0.13636363636363635,0.9166666666666666,0.16172775691983432,0.668244960065329
20,123,42,185,0.13986013986013987,0.772972972972973,0.18170777689985432,0.6468015386219074
16,105,12,133,0.1322314049586777,0.9097744360902256,0.18472496173522096,0.6696264580633683
25,85,23,133,0.22727272727272727,0.8270676691729323,0.16650124996312213,0.7706139766938314
3,94,8,105,0.030927835051546393,0.9238095238095239,0.10104373571582749,0.8119463717208077
44,139,36,219,0.24043715846994534,0.8356164383561644,0.13539190121153397,0.8837011010097836
5,73,4,82,0.0641025641025641,0.9512195121951219,0.13874220943989096,0.876732459894801
5,41,7,53,0.10869565217391304,0.8679245283018868,0.1347896402699305,0.8697692972712611
3,26,3,32,0.10344827586206896,0.90625,0.12958794541306323,0.8888088725608363
8,117,21,146,0.064,0.8561643835616438,0.11984060184753784,0.8811502936281819
10,75,44,129,0.11764705882352941,0.6589147286821705,0.10417979206908101,0.8571284449866444
31,56,48,135,0.3563218390804598,0.6444444444444445,0.1506646497874972,0.8172191479344901
39,52,6,97,0.42857142857142855,0.9381443298969072,0.1775409740877091,0.8318659895831677
7,23,36,66,0.23333333333333334,0.45454545454545453,0.20171679826353328,0.7609125527760723
12,91,18,121,0.11650485436893204,0.8512396694214877,0.20283239857710741,0.758529001507444
12,34,4,50,0.2608695652173913,0.92,0.2253211541992963,0.7604932872217297
10,37,50,97,0.2127659574468085,0.4845360824742268,0.24657343383455466,0.7074035299235273
7,19,4,30,0.2692307692307692,0.8666666666666667,0.26822824960701747,0.7370823782070267
9,63,5,77,0.125,0.935064935064935,0.23518227259552324,0.7785995911528111
10,36,1,47,0.21739130434782608,0.9787234042553191,0.20501368342072288,0.7843966017754412
7,49,6,62,0.125,0.9032258064516129,0.18953749294453243,0.8484937949048925
7,113,40,160,0.058333333333333334,0.75,0.1812272756537326,0.8340309849875371
8,82,116,206,0.08888888888888889,0.4368932038834951,0.15665860760680372,0.7650157283994651
31,72,44,147,0.30097087378640774,0.7006802721088435,0.16925930994103217,0.7958934697758389
5,33,23,61,0.13157894736842105,0.6229508196721312,0.1495947639606967,0.7610769202051909
21,154,28,203,0.12,0.8620689655172413,0.14888047824641099,0.7506489245555203
7,43,7,57,0.14,0.8771929824561403,0.13782457762529296,0.7361445785842091
1,11,1,13,0.08333333333333333,0.9230769230769231,0.13187219667291203,0.7389804523878248
45,20,14,79,0.6923076923076923,0.8227848101265823,0.2224399622406776,0.749378282405908
6,36,12,54,0.14285714285714285,0.7777777777777778,0.230149712807571,0.7980760786765198
17,87,20,124,0.16346153846153846,0.8387096774193549,0.2105055220468754,0.81779456514945
143,290,113,546,0.3302540415704388,0.793040293040293,0.23888767836144936,0.8420930613449017
7,35,11,53,0.16666666666666666,0.7924528301886793,0.24555434502811604,0.8321478991551071
13,40,39,92,0.24528301886792453,0.5760869565217391,0.2605947762949624,0.7891327525930498
1,1,0,2,0.5,1.0,0.32011858581877195,0.8001217635820608
1,11,3,15,0.08333333333333333,0.8,0.2331222488224349,0.7968667907068347
14,63,19,96,0.18181818181818182,0.8020833333333334,0.23868811153115477,0.800339012929057
7,99,32,138,0.0660377358490566,0.7681159420289855,0.22477042544365738,0.7902541935875755
10,42,7,59,0.19230769230769232,0.8813559322033898,0.20506380412040787,0.8028707134680181
4,20,6,30,0.16666666666666666,0.8,0.20506380412040784,0.8039488805839209
1,6,19,26,0.14285714285714285,0.2692307692307692,0.21197403446504454,0.6314152142618183
38,49,25,112,0.4367816091954023,0.7767857142857143,0.20294283577867347,0.5995274591597776
26,44,19,89,0.37142857142857144,0.7865168539325843,0.2440992983637075,0.5976012954358609
26,38,44,108,0.40625,0.5925925925925926,0.27205982467949696,0.5691621419967074
105,205,82,392,0.3387096774193548,0.7908163265306123,0.30854215954892855,0.5834719769275967
7,71,20,98,0.08974358974358974,0.7959183673469388,0.2737436247503938,0.6826467557979825
0,6,25,31,0.0,0.1935483870967742,0.25511008437772303,0.6007727158594266
0,12,1,13,0.0,0.9230769230769231,0.2347019211124169,0.6941793092660199
1,8,3,12,0.1111111111111111,0.75,0.1881775642432324,0.690352778653775
11,21,227,259,0.34375,0.12355212355212356,0.18422348261057936,0.5956435314565663
45,47,53,145,0.4891304347826087,0.6344827586206897,0.1960635447223806,0.6016278408891517
2,11,17,30,0.15384615384615385,0.43333333333333335,0.16965446992620903,0.5505588418609689
6,117,0,123,0.04878048780487805,1.0,0.16380259822067877,0.5797133608114062
6,38,4,48,0.13636363636363635,0.9166666666666666,0.18328311770119823,0.6830159721785337
20,123,42,185,0.13986013986013987,0.772972972972973,0.20326313768121823,0.6615725507351122
17,104,12,133,0.14049586776859505,0.9097744360902256,0.20746096006085882,0.684397470176573
25,84,24,133,0.22935779816513763,0.8195488721804511,0.19111921694159276,0.783825577123477
3,95,7,105,0.030612244897959183,0.9333333333333333,0.12561661838664281,0.8265185163681403
44,139,36,219,0.24043715846994534,0.8356164383561644,0.13798676190432732,0.8839875313714021
6,72,4,82,0.07692307692307693,0.9512195121951219,0.14200713177835572,0.8770188902564193
6,40,7,53,0.13043478260869565,0.8679245283018868,0.14116015267050705,0.8700557276328793
3,26,3,32,0.10344827586206896,0.90625,0.13595845781363977,0.8890953029224546
7,120,21,148,0.05511811023622047,0.8581081081081081,0.12376163530901485,0.8817143989250094
10,77,42,129,0.11494252873563218,0.6744186046511628,0.10741659681908548,0.8609815035636823
31,56,48,135,0.3563218390804598,0.6444444444444445,0.15394653884515702,0.8197116622938411
39,52,6,97,0.42857142857142855,0.9381443298969072,0.1808228631453689,0.8343585039425188
6,24,36,66,0.2,0.45454545454545453,0.1984052807277865,0.7634050671354233
11,92,18,121,0.10679611650485436,0.8512396694214877,0.19502832842723775,0.7610215158667949
12,34,4,50,0.2608695652173913,0.92,0.21751708404942663,0.7629858015810805
10,37,50,97,0.2127659574468085,0.4845360824742268,0.24003820507951065,0.709618369347669
7,19,4,30,0.2692307692307692,0.8666666666666667,0.2620793822931016,0.7370823782070267
10,61,7,78,0.14084507042253522,0.9102564102564102,0.231296986770541,0.7750555161801647
10,34,1,45,0.22727272727272727,0.9777777777777777,0.2025400294421551,0.7807174373060033
7,52,3,62,0.11864406779661017,0.9516129032258065,0.1909177534130994,0.8517270728317679
7,114,40,161,0.05785123966942149,0.7515527950310559,0.18392562815089472,0.8374860907759919
8,88,110,206,0.08333333333333333,0.46601941747572817,0.15856330931031498,0.772631721843953
33,69,45,147,0.3235294117647059,0.6938775510204082,0.1743866599271575,0.802537645921979
5,33,23,61,0.13157894736842105,0.6229508196721312,0.15472211394682203,0.7677210963513311
21,154,28,203,0.12,0.8620689655172413,0.1517442467436027,0.7608371756743069
6,42,9,57,0.125,0.8421052631578947,0.13713385713321308,0.7414553878714665
1,10,2,13,0.09090909090909091,0.8461538461538461,0.1331717175778532,0.7263898082897579
45,20,14,79,0.6923076923076923,0.8227848101265823,0.22380835366903476,0.7365658104462616
6,36,12,54,0.14285714285714285,0.7777777777777778,0.232311755029579,0.7811027190608402
18,85,21,124,0.17475728155339806,0.8306451612903226,0.2110585935708207,0.8006409490993993
141,290,116,547,0.3271461716937355,0.7879341864716636,0.23899676847443704,0.8242100014993327
7,35,11,53,0.16666666666666666,0.7924528301886793,0.24566343514110373,0.814264839309538
14,39,39,92,0.2641509433962264,0.5760869565217391,0.26554214134056464,0.7762622240758014
1,1,0,2,0.5,1.0,0.3239836997821231,0.7982402460538235
1,11,3,15,0.08333333333333333,0.8,0.23698736278578608,0.7949852731785975
15,62,19,96,0.19480519480519481,0.8020833333333334,0.2444085130640792,0.7984574954008197
7,98,33,138,0.06666666666666667,0.7608695652173914,0.22896699665168901,0.7884895531046866
10,42,7,59,0.19230769230769232,0.8813559322033898,0.2097043567393971,0.8018355167806475
4,20,6,30,0.16666666666666666,0.8,0.20970435673939716,0.8029136838965505
2,6,18,26,0.25,0.3076923076923077,0.22226553320892942,0.6965780880309917
34,45,33,112,0.43037974683544306,0.7053571428571429,0.21231978275684987,0.6544862512962978
26,44,19,89,0.37142857142857144,0.7865168539325843,0.2534762453418839,0.6525600875723814
28,37,43,108,0.4307692307692308,0.6018518518518519,0.28453851640415495,0.6257569686639991
108,222,62,392,0.32727272727272727,0.8418367346938775,0.3093137411793797,0.705937139396218
7,71,19,97,0.08974358974358974,0.8041237113402062,0.2951800761023184,0.6924826574811387
0,6,25,31,0.0,0.1935483870967742,0.2713705522927946,0.6058467127806777
0,12,1,13,0.0,0.9230769230769231,0.23565626657850888,0.6937588006927656
1,8,3,12,0.1111111111111111,0.75,0.19004646147503285,0.7001363517131738
9,19,231,259,0.32142857142857145,0.10810810810810811,0.18290360433217573,0.6032208165953915
45,46,54,145,0.4945054945054945,0.6275862068965518,0.1920087848659277,0.6068971530303486
2,12,16,30,0.14285714285714285,0.4666666666666667,0.16566370137798708,0.5533014290264615
7,116,0,123,0.056910569105691054,1.0,0.16097326985828728,0.5812837559778605
6,38,4,48,0.13636363636363635,0.9166666666666666,0.18045378933880674,0.684586367344988
19,125,40,184,0.13194444444444445,0.782608695652174,0.19930299568801307,0.664519477712881
16,106,11,133,0.13114754098360656,0.9172932330827067,0.2021653428126553,0.6884185110104105
24,84,24,132,0.2222222222222222,0.8181818181818182,0.18799300721174825,0.789857612449512
4,94,7,105,0.04081632653061224,0.9333333333333333,0.12318026892962222,0.833535773369052
44,139,36,219,0.24043715846994534,0.8356164383561644,0.1371202711600226,0.8862428836104089
6,72,4,82,0.07692307692307693,0.9512195121951219,0.13997920084822055,0.8792742424954264
3,41,9,53,0.06818181818181818,0.8301886792452831,0.1302389411079608,0.8669202442923716
3,26,3,32,0.10344827586206896,0.90625,0.12616805988190719,0.8845832877706324
7,118,23,148,0.056,0.8445945945945946,0.11543269688424909,0.8741977679866164
11,76,42,129,0.12643678160919541,0.6744186046511628,0.10174906251095954,0.8536601660536657
29,57,49,135,0.3372093023255814,0.6370370370370371,0.14409091619595515,0.8113321237256234
40,51,6,97,0.43956043956043955,0.9381443298969072,0.17253709920888288,0.8259789653743008
4,22,40,66,0.15384615384615385,0.3939393939393939,0.18352611019789386,0.7463675199091968
13,88,20,121,0.12871287128712872,0.8347107438016529,0.19217340349865256,0.7470135291315355
14,32,4,50,0.30434782608695654,0.92,0.22087333924506505,0.7489778148458212
4,3,90,97,0.5714285714285714,0.07216494845360824,0.29450599230628954,0.6386307225399659
7,19,4,30,0.2692307692307692,0.8666666666666667,0.31490513339508575,0.6660947313993237
9,62,8,79,0.1267605633802817,0.8987341772151899,0.2848410278314715,0.7034800371390598
9,30,1,40,0.23076923076923078,0.975,0.2550137122898703,0.7087451328680732
7,51,4,62,0.1206896551724138,0.9354838709677419,0.25027706962219315,0.7861086295864084
7,113,39,159,0.058333333333333334,0.7547169811320755,0.24022284991450807,0.7746809492050403
8,87,111,206,0.08421052631578947,0.46116504854368934,0.20877466423291277,0.709133098996996
24,39,84,147,0.38095238095238093,0.42857142857142855,0.1815637798791713,0.7600483104423988
4,34,22,60,0.10526315789473684,0.6333333333333333,0.1581398354025952,0.7267149771090654
21,154,28,203,0.12,0.8620689655172413,0.15717404063398357,0.7214770897236441
6,36,15,57,0.14285714285714285,0.7368421052631579,0.1446151709322567,0.6874545333326668
2,10,1,13,0.16666666666666666,0.9230769230769231,0.1511833154314357,0.6856821122054069
45,20,14,79,0.6923076923076923,0.8227848101265823,0.24175108099920126,0.6954060877760507
6,36,11,53,0.14285714285714285,0.7924528301886793,0.2501291690765374,0.742732913725335
18,87,18,123,0.17142857142857143,0.8536585365853658,0.22019719628742182,0.8034596434416118
143,293,114,550,0.32798165137614677,0.7927272727272727,0.25201412392762323,0.8262302062121746
6,36,11,53,0.14285714285714285,0.7924528301886793,0.2552794300500722,0.81628504402238
14,38,39,91,0.2692307692307692,0.5714285714285714,0.27333280524630454,0.7926545391888676
1,1,0,2,0.5,1.0,0.32095185286535216,0.8036435501778786
1,11,3,15,0.08333333333333333,0.8,0.23395551586901517,0.8003885773026526
16,60,20,96,0.21052631578947367,0.7916666666666666,0.24362254057363386,0.8002762682280793
8,88,43,139,0.08333333333333333,0.6906474820143885,0.23103750656002844,0.7769889747179397
2,4,53,59,0.3333333333333333,0.1016949152542373,0.23180203255391224,0.6782700665075062
3,20,7,30,0.13043478260869565,0.7666666666666667,0.23002740966127688,0.6745863288615043
2,6,18,26,0.25,0.3076923076923077,0.211800973713748,0.6831732416264791
27,75,10,112,0.2647058823529412,0.9107142857142857,0.17818752833559673,0.6704181395856628
24,46,19,89,0.34285714285714286,0.7865168539325843,0.2152623582675695,0.6684919758617462
28,34,46,108,0.45161290322580644,0.5740740740740741,0.24782360008178245,0.6374073197770901
108,214,70,392,0.33540372670807456,0.8214285714285714,0.2725723950169128,0.7167275370726414
7,71,19,97,0.08974358974358974,0.8041237113402062,0.26018282380381214,0.7101737815498137
0,6,25,31,0.0,0.1935483870967742,0.24776046355536496,0.6282997416112577
0,12,1,13,0.0,0.9230769230769231,0.2120461778410792,0.7162118295233455
1,8,3,12,0.1111111111111111,0.75,0.19010406766367494,0.6932526458498761
11,21,227,259,0.34375,0.12355212355212356,0.19023161868408311,0.5985433986526675
45,46,54,145,0.4945054945054945,0.6275862068965518,0.19635913172403854,0.6061879890558786
2,11,17,30,0.15384615384615385,0.43333333333333335,0.17042233560090705,0.5507458121851303
6,117,0,123,0.04878048780487805,1.0,0.1645704638953768,0.5787281391365294
7,37,4,48,0.1590909090909091,0.9166666666666666,0.1872977366226495,0.6820307505036569
19,123,41,183,0.13380281690140844,0.7759562841530054,0.20641242475142213,0.6610135163716687
16,104,12,132,0.13333333333333333,0.9090909090909091,0.20958702792602532,0.6837407890989413
26,77,25,128,0.2524271844660194,0.8046875,0.19654091142117094,0.7810458428772095
3,95,7,105,0.030612244897959183,0.9333333333333333,0.13027044719152306,0.8247240037967496
45,137,37,219,0.24725274725274726,0.8310502283105022,0.1436142462496078,0.8815407030792024
6,72,4,82,0.07692307692307693,0.9512195121951219,0.1476346161236362,0.8745720619642198
4,40,9,53,0.09090909090909091,0.8301886792452831,0.1378943563833765,0.8622180637611649
3,25,3,31,0.10714285714285714,0.9032258064516129,0.13408579070358342,0.8803994240895374
7,117,23,147,0.056451612903225805,0.8435374149659864,0.12310268778499665,0.8710346392145486
12,76,40,128,0.13636363636363635,0.6875,0.10652218091322764,0.8542935677859772
28,59,48,135,0.3218390804597701,0.6444444444444445,0.1481260145649149,0.8130237265161359
40,48,8,96,0.45454545454545453,0.9166666666666666,0.1777392584638731,0.8252546462813022
8,22,36,66,0.26666666666666666,0.45454545454545453,0.2048454855701002,0.7543012094742069
17,86,18,121,0.1650485436893204,0.8512396694214877,0.2154368359672758,0.7573084937850932
14,30,4,48,0.3181818181818182,0.9166666666666666,0.2455852589728417,0.759228616672958
5,2,90,97,0.7142857142857143,0.07216494845360824,0.33956155917034003,0.6490325500283326
6,20,4,30,0.23076923076923078,0.8666666666666667,0.35304807265685356,0.6746277881235707
9,64,6,79,0.1232876712328767,0.9240506329113924,0.3246835856244402,0.7145715293331347
7,23,2,32,0.23333333333333334,0.9375,0.2930818540227086,0.7175477198093253
7,52,3,62,0.11864406779661017,0.9516129032258065,0.2719357684698434,0.7885573553350896
7,111,39,157,0.059322033898305086,0.7515923566878981,0.2568319813568412,0.7743220249445769
10,79,111,200,0.11235955056179775,0.445,0.22742880026826687,0.7069410725636246
32,40,74,146,0.4444444444444444,0.4931506849315068,0.1888800474337997,0.7670818920604672
4,34,22,60,0.10526315789473684,0.6333333333333333,0.17095060845172916,0.733748558727134
20,152,28,200,0.11627906976744186,0.86,0.16994937967095278,0.7245984683112205
8,40,10,58,0.16666666666666666,0.8275862068965517,0.16042557014714326,0.7088964978678709
2,9,1,12,0.18181818181818182,0.9166666666666666,0.1694504435787963,0.7039041783594223
45,20,14,79,0.6923076923076923,0.8227848101265823,0.2598769662087088,0.7140745288506629
6,36,10,52,0.14285714285714285,0.8076923076923077,0.2642337651080438,0.7658877156638498
18,86,19,123,0.17307692307692307,0.8455284552845529,0.22546697634125504,0.8162273971428562
145,291,114,550,0.33256880733944955,0.7927272727272727,0.257939211976214,0.8389979599134191
6,34,11,51,0.15,0.7843137254901961,0.2627564877237223,0.828185634983447
14,38,39,91,0.2692307692307692,0.5714285714285714,0.27740850237573694,0.7915916870594499
1,1,0,2,0.5,1.0,0.3228630478302824,0.8034964489642119
1,11,3,15,0.08333333333333333,0.8,0.23586671083394542,0.8002414760889858
16,59,20,95,0.21333333333333335,0.7894736842105263,0.2459347380448298,0.7976388155915883
6,33,100,139,0.15384615384615385,0.2805755395683453,0.24318748529757703,0.7169312562035587
10,43,6,59,0.18867924528301888,0.8983050847457628,0.22263183357522978,0.7320138007776288
4,20,6,30,0.16666666666666666,0.8,0.22501278595618215,0.7342546971361722
2,6,18,26,0.25,0.3076923076923077,0.21509973444957967,0.682299372291876
31,67,14,112,0.3163265306122449,0.875,0.18886066739418608,0.6644422294347331
29,41,18,88,0.4142857142857143,0.7954545454545454,0.23613957895881194,0.6637928787853825
28,32,39,99,0.4666666666666667,0.6060606060606061,0.2746107569036741,0.637277727270231
104,207,80,391,0.33440514469453375,0.7953964194373402,0.2992168972654415,0.7126035097571389
6,72,19,97,0.07692307692307693,0.8041237113402062,0.284995824220839,0.706049754234311
0,6,25,31,0.0,0.1935483870967742,0.2655153047403195,0.6253251395831114
0,10,1,11,0.0,0.9090909090909091,0.22980101902603378,0.7112392254971972
1,8,3,12,0.1111111111111111,0.75,0.2004845305258718,0.6933820826400545
10,22,227,259,0.3125,0.12355212355212356,0.1859437141993412,0.5973960223682798
45,44,53,142,0.5056179775280899,0.6267605633802817,0.19150818717954454,0.6003531591282335
1,14,15,30,0.06666666666666667,0.5,0.15325983317556352,0.558153670637185
5,118,0,123,0.04065040650406504,1.0,0.14807802311570467,0.586135997588584
7,36,5,48,0.16279069767441862,0.8958333333333334,0.17133383706919306,0.686462418479521
18,123,42,183,0.1276595744680851,0.7704918032786885,0.18957091913606236,0.6666625462206325
16,103,13,132,0.13445378151260504,0.9015151515151515,0.19290558633627578,0.6883075678656541
27,73,24,124,0.27,0.8064516129032258,0.1868341577648472,0.7858646377729545
3,89,13,105,0.03260869565217391,0.8761904761904762,0.11926140321114494,0.821497482460125
46,136,37,219,0.25274725274725274,0.8310502283105022,0.14584434407980007,0.8687903722187682
6,72,4,82,0.07692307692307693,0.9512195121951219,0.15102615413965892,0.8618217311037856
3,41,9,53,0.06818181818181818,0.8301886792452831,0.13751059992643028,0.8524439233769214
4,24,4,32,0.14285714285714285,0.875,0.1396816811248671,0.8673736657656802
6,117,24,147,0.04878048780487805,0.8367346938775511,0.1274426391666204,0.8581193146745943
12,74,42,128,0.13953488372093023,0.671875,0.10880476541246756,0.8388940842598478
29,58,48,135,0.3333333333333333,0.6444444444444445,0.1517654279383475,0.805787508296129
40,48,8,96,0.45454545454545453,0.9166666666666666,0.18059374248094776,0.8180184280612953
7,19,40,66,0.2692307692307692,0.3939393939393939,0.2080662699534752,0.7384069825961913
11,90,19,120,0.10891089108910891,0.8416666666666667,0.21388470894023107,0.7400466950849603
12,29,5,46,0.2926829268292683,0.8913043478260869,0.23528839236482035,0.7423758876315442
4,3,90,97,0.5714285714285714,0.07216494845360824,0.3099524043110623,0.6331516382852668
6,20,4,30,0.23076923076923078,0.8666666666666667,0.3229858824608195,0.6609790192376476
9,60,11,80,0.13043478260869565,0.8625,0.2940003752144427,0.6921298128884413
5,16,2,23,0.23809523809523808,0.9130434782608695,0.2630789157215546,0.6916122145447561
7,52,2,61,0.11864406779661017,0.9672131147540983,0.24156652980238902,0.773508460375428
7,105,45,157,0.0625,0.7133757961783439,0.2349364025039449,0.7551811931628105
10,82,108,200,0.10869565217391304,0.46,0.20865250612460845,0.6935662863305124
36,46,64,146,0.43902439024390244,0.5616438356164384,0.18973762309822714,0.7634918416394881
4,34,22,60,0.10526315789473684,0.6333333333333333,0.1718081841161566,0.7301585083061548
20,149,29,198,0.11834319526627218,0.8535353535353535,0.1700808144958104,0.7288778445254911
8,38,20,66,0.17391304347826086,0.696969696969697,0.16091192955052794,0.6980101614838948
2,9,1,12,0.18181818181818182,0.9166666666666666,0.16993680298218106,0.6907892403285476
44,21,14,79,0.676923076923077,0.8227848101265823,0.2577115282569063,0.7064190994640102
6,36,10,52,0.14285714285714285,0.8076923076923077,0.26259174121165346,0.7560894291343399
20,84,19,123,0.19230769230769232,0.8455284552845529,0.22734649864933767,0.7966443748012134
141,297,112,550,0.3219178082191781,0.7963636363636364,0.2582971629814007,0.8199344180912567
7,34,11,52,0.17073170731707318,0.7884615384615384,0.26578123613151516,0.8106381587949973
13,38,40,91,0.2549019607843137,0.5604395604395604,0.2773510814609513,0.7911338535764064
1,1,0,2,0.5,1.0,0.32280562691549675,0.8030386154811683
1,11,3,15,0.08333333333333333,0.8,0.23800709211696192,0.7997836426059423
17,59,20,96,0.2236842105263158,0.7916666666666666,0.2495538160697009,0.797494265316565
6,31,102,139,0.16216216216216217,0.26618705035971224,0.2452473117631966,0.7147312074701592
9,42,9,60,0.17647058823529413,0.85,0.22446913747978464,0.7223935451324968
2,21,7,30,0.08695652173913043,0.7666666666666667,0.21250125382579282,0.7192799920189437
2,6,18,26,0.25,0.3076923076923077,0.1990352504638219,0.6764213067298366
29,70,13,112,0.29292929292929293,0.8839285714285714,0.16945372088229232,0.6598396740767755
29,41,19,89,0.4142857142857143,0.7865168539325843,0.21673263244691818,0.657913510352859
28,32,38,98,0.4666666666666667,0.6122448979591837,0.2574252731395589,0.6295875935199603
109,215,67,391,0.33641975308641975,0.8286445012787724,0.2850770746008841,0.7109283423798908
5,70,19,94,0.06666666666666667,0.7978723404255319,0.27460088412469363,0.7058624862502049
0,6,25,31,0.0,0.1935483870967742,0.2609954419478229,0.6300639799733894
0,10,1,11,0.0,0.9090909090909091,0.2252811562335372,0.7159780658874754
0,8,3,11,0.0,0.7272727272727273,0.18343411438649532,0.6935986595794975
9,23,227,259,0.28125,0.12355212355212356,0.16442901234567903,0.598889412382289
47,41,53,141,0.5340909090909091,0.624113475177305,0.1740610469777136,0.6005849234134492
0,15,15,30,0.0,0.5,0.12600108225108225,0.553635708945053
4,119,0,123,0.032520325203252036,1.0,0.12112303347059442,0.5825110888842627
14,29,5,48,0.32558139534883723,0.8958333333333334,0.1676346613775712,0.6828375097751997
18,120,42,180,0.13043478260869565,0.7666666666666667,0.18626820175024197,0.6624911894288795
15,102,13,130,0.1282051282051282,0.9,0.20458322006526028,0.687166514104204
27,74,25,126,0.26732673267326734,0.8015873015873016,0.20259418187572706,0.7840286823949437
1,91,13,105,0.010869565217391304,0.8761904761904762,0.12784827560808168,0.8200396825396826
46,136,37,219,0.25274725274725274,0.8310502283105022,0.16395502600054637,0.8673325722983257
5,72,5,82,0.06493506493506493,0.9390243902439024,0.16858570310509105,0.8586217709045975
3,41,9,53,0.06818181818181818,0.8301886792452831,0.13181433493837405,0.8492439631777332
3,25,4,32,0.10714285714285714,0.875,0.12848691701468282,0.8647201536539235
7,82,52,141,0.07865168539325842,0.6312056737588653,0.12140785375584429,0.8263209641909045
11,73,43,127,0.13095238095238096,0.6614173228346457,0.10192580351000337,0.8062966815119536
28,58,48,134,0.32558139534883723,0.6417910447761194,0.14688463638592422,0.7728110484527597
37,50,8,95,0.42528735632183906,0.9157894736842105,0.17153322261086515,0.784916654934718
10,26,30,66,0.2777777777777778,0.5454545454545454,0.2019393244455384,0.7286923913933814
12,89,19,120,0.1188118811881188,0.8416666666666667,0.20917219058929565,0.7303321038821505
13,30,4,47,0.3023255813953488,0.9148936170212766,0.23705543691108016,0.7360311920280471
4,5,93,102,0.4444444444444444,0.08823529411764706,0.28931154534696385,0.6584639949364445
7,19,4,30,0.2692307692307692,0.8666666666666667,0.30906560081530504,0.6877853297695903
9,53,15,77,0.14516129032258066,0.8051948051948052,0.2832913000972684,0.7111287241151169
5,15,2,22,0.25,0.9090909090909091,0.2582502491941486,0.7101717863160738
9,52,1,62,0.14754098360655737,0.9838709677419355,0.23964499288397417,0.772802703785701
7,106,45,158,0.061946902654867256,0.7151898734177216,0.23152142452208113,0.754734590464423
10,79,109,198,0.11235955056179775,0.4494949494949495,0.20438342011728808,0.6882490665320907
30,47,68,145,0.38961038961038963,0.5310344827586206,0.19654998371242313,0.7515060934808011
3,35,22,60,0.07894736842105263,0.6333333333333333,0.16936664073960647,0.7181727601474679
23,149,28,200,0.13372093023255813,0.86,0.16773230358388896,0.7260020736910671
7,39,20,66,0.15217391304347827,0.696969696969697,0.15375714830438586,0.6956990433880368
2,9,1,12,0.18181818181818182,0.9166666666666666,0.15865389090604648,0.6860984289487126
44,21,14,79,0.676923076923077,0.8227848101265823,0.2465076300872193,0.7014691341928356
6,36,10,52,0.14285714285714285,0.8076923076923077,0.25086442898655437,0.7526401853638867
18,85,20,123,0.17475728155339806,0.8373983739837398,0.22017112783555554,0.7964064555389039
138,297,118,553,0.31724137931034485,0.786618444846293,0.25421312939116875,0.8183043286121838
7,34,11,52,0.17073170731707318,0.7884615384615384,0.25950038326038516,0.8080845483924035
13,39,40,92,0.25,0.5652173913043478,0.27347553853988826,0.7892627904402109
1,1,0,2,0.5,1.0,0.3189300839944337,0.8011675523449727
1,11,3,15,0.08333333333333333,0.8,0.2341315491958989,0.7979125794697467
15,61,20,96,0.19736842105263158,0.7916666666666666,0.24191887465239728,0.7956232021803694
6,31,101,138,0.16216216216216217,0.26811594202898553,0.24011957188222072,0.7142971404725473
9,42,9,60,0.17647058823529413,0.85,0.22000945887149917,0.7233516483516483
3,19,7,29,0.13636363636363635,0.7586206896551724,0.21509973444957967,0.7190886699507388
2,6,16,24,0.25,0.3333333333333333,0.20716188573331426,0.6864772769361828
27,71,12,110,0.2755102040816326,0.8909090909090909,0.17509191488783324,0.6708928613517673
27,43,19,89,0.38571428571428573,0.7865168539325843,0.21828919379939787,0.6689666976278507
27,28,43,98,0.4909090909090909,0.5612244897959183,0.26244503795524204,0.6333521510573428
89,196,105,390,0.312280701754386,0.7307692307692307,0.28324704296777337,0.6990796566344724
5,70,18,93,0.06666666666666667,0.8064516129032258,0.26804557776630816,0.690477506096838
0,6,25,31,0.0,0.1935483870967742,0.2544401355894374,0.6146789998200225
0,10,1,11,0.0,0.9090909090909091,0.2187258498751517,0.6969300820711047
1,8,3,12,0.1111111111111111,0.75,0.19524026516507723,0.6768002119412346
8,21,229,258,0.27586206896551724,0.1124031007751938,0.17954709134382457,0.5804982472044645
43,46,52,141,0.48314606741573035,0.6312056737588653,0.1784380879876302,0.5904955591991713
0,9,21,30,0.0,0.3,0.13382655916557504,0.5289570976607098
3,120,0,123,0.024390243902439025,1.0,0.1277870701992568,0.5566068672459632
13,29,5,47,0.30952380952380953,0.8936170212765957,0.17200475727408676,0.6566166721287948
18,117,47,182,0.13333333333333333,0.7417582417582418,0.1910523763217058,0.6327120053669851
17,103,12,132,0.14166666666666666,0.9090909090909091,0.19541745568678515,0.655439278094258
26,74,24,124,0.26,0.8064516129032258,0.19315144583456842,0.7545890655411196
4,86,15,105,0.044444444444444446,0.8571428571428571,0.130479785410099,0.786865806024547
44,137,38,219,0.2430939226519337,0.8264840182648402,0.16520748864608953,0.8620778086338099
5,72,5,82,0.06493506493506493,0.9390243902439024,0.17099960593646465,0.8533670072400817
3,41,9,53,0.06818181818181818,0.8301886792452831,0.13652217860189447,0.8443058155213228
3,25,4,32,0.10714285714285714,0.875,0.13278068200325502,0.8633403524130026
6,83,51,140,0.06741573033707865,0.6357142857142857,0.12217340538474243,0.8242865490734849
11,74,43,128,0.12941176470588237,0.6640625,0.10351794319986848,0.8039452472301668
28,57,48,133,0.32941176470588235,0.6390977443609023,0.14422756038007392,0.7727959454041733
38,49,9,96,0.4367816091954023,0.90625,0.1718972298862837,0.7841910856520533
9,20,37,66,0.3103448275862069,0.4393939393939394,0.20695576740787544,0.7128153069592014
15,84,19,118,0.15151515151515152,0.8389830508474576,0.2188605293126373,0.7140716457595121
12,32,4,48,0.2727272727272727,0.9166666666666666,0.2425154458246967,0.720024026711893
4,4,94,102,0.5,0.0784313725490196,0.30431319863368544,0.640412181973998
6,20,4,30,0.23076923076923078,0.8666666666666667,0.3187928366427352,0.6693556343549503
10,53,14,77,0.15873015873015872,0.8181818181818182,0.2944097500747747,0.694939073472224
6,15,2,23,0.2857142857142857,0.9130434782608695,0.2728287038631866,0.695909570366634
8,51,3,62,0.13559322033898305,0.9516129032258065,0.24786418854215464,0.7690837080569006
7,105,46,158,0.0625,0.7088607594936709,0.23514773832570443,0.750494809292074
10,78,108,196,0.11363636363636363,0.4489795918367347,0.21242046559843167,0.6836823700306552
28,33,83,144,0.45901639344262296,0.4236111111111111,0.20656566466166357,0.732993761253811
2,33,23,58,0.05714285714285714,0.603448275862069,0.18176189700075301,0.6953911339960115
25,141,30,196,0.15060240963855423,0.8469387755102041,0.18060078998766668,0.6994992707572093
7,33,26,66,0.175,0.6060606060606061,0.16478446345705441,0.6556445747286004
2,10,0,12,0.16666666666666666,1.0,0.1692235272181521,0.6625570171249137
44,20,14,78,0.6875,0.8205128205128205,0.2585092415038664,0.6785073115562207
6,36,10,52,0.14285714285714285,0.8076923076923077,0.26268363853540627,0.7297519852498741
15,87,21,123,0.14705882352941177,0.8292682926829268,0.2181182714049475,0.7877030111887049
143,289,98,530,0.33101851851851855,0.8150943396226416,0.2572433658871849,0.817938163154501
7,34,11,52,0.17073170731707318,0.7884615384615384,0.260118979841259,0.8095842721475487
12,39,41,92,0.23529411764705882,0.5543478260869565,0.26873242521941026,0.8021967321513132
1,1,0,2,0.5,1.0,0.3163514728384579,0.8021967321513132
1,11,3,15,0.08333333333333333,0.8,0.23004194902893407,0.7992663292209102
14,63,18,95,0.18181818181818182,0.8105263157894737,0.2356078117376539,0.7996711875205053
5,30,100,135,0.14285714285714285,0.25925925925925924,0.2350075716416155,0.7182413256028385
7,43,10,60,0.14,0.8333333333333334,0.20771921185325573,0.7208468961329374
2,19,8,29,0.09523809523809523,0.7241379310344828,0.19693441012768745,0.7116578093576437
2,5,17,24,0.2857142857142857,0.2916666666666667,,
25,75,10,110,0.25,0.9090909090909091,,
29,42,19,90,0.4084507042253521,0.7888888888888889,,
30,31,38,99,0.4918032786885246,0.6161616161616161,,
107,218,65,390,0.3292307692307692,0.8333333333333334,,
5,72,18,95,0.06493506493506493,0.8105263157894737,,
0,6,25,31,0.0,0.1935483870967742,0.26144772897057095,0.6347451595753802
0,10,1,11,0.0,0.9090909090909091,0.2206314024399587,0.7229486227788434
1,8,3,12,0.1111111111111111,0.75,0.2007901325986889,0.7002213500515708
8,21,230,259,0.27586206896551724,0.11196911196911197,0.181848898990141,0.6035185247773168
43,47,52,142,0.4777777777777778,0.6338028169014085,0.17984525600289145,0.6060386963115729
0,11,19,30,0.0,0.36666666666666664,0.13281228896992442,0.5393720296449064
3,119,0,122,0.02459016393442623,1.0,0.1270487316841189,0.5664396988178386
13,29,5,47,0.30952380952380953,0.8936170212765957,0.17126641875894882,0.6664495037006704
18,118,47,183,0.1323529411764706,0.7431693989071039,0.19017398178415892,0.6427464308172696
17,103,13,133,0.14166666666666666,0.9022556390977443,0.19453906114923827,0.6644972364026616
26,75,25,126,0.25742574257425743,0.8015873015873016,0.1919053002362012,0.7630141206338317
4,90,14,108,0.0425531914893617,0.8703703703703703,0.129730359337856,0.7968094854151119
44,137,38,219,0.2430939226519337,0.8264840182648402,0.16445806257384654,0.8624976785005652
5,73,5,83,0.0641025641025641,0.9397590361445783,0.17010269116929483,0.8538918265212192
3,41,9,53,0.06818181818181818,0.8301886792452831,0.13562526383472462,0.8448306348024602
3,26,4,33,0.10344827586206896,0.8787878787878788,0.13149602593266727,0.8642047033568566
7,82,51,140,0.07865168539325842,0.6357142857142857,0.12249388575075179,0.8261273671592197
8,74,44,126,0.0975609756097561,0.6507936507936508,0.09965606189868016,0.804585417045841
27,58,48,133,0.3176470588235294,0.6390977443609023,0.13895518580356128,0.7715464704730598
39,49,9,97,0.4431818181818182,0.9072164948453608,0.16753917087925904,0.7830796814131343
9,20,37,66,0.3103448275862069,0.4393939393939394,0.20271663709120805,0.7115989533059002
14,87,19,120,0.13861386138613863,0.8416666666666667,0.2127783575489681,0.7132386657946691
12,33,4,49,0.26666666666666666,0.9183673469387755,0.23609527052105347,0.7188928755305116
4,4,94,102,0.5,0.0784313725490196,0.29628788689344515,0.6392810307926166
6,20,4,30,0.23076923076923078,0.8666666666666667,0.31531763763051296,0.6701200330601902
10,53,15,78,0.15873015873015872,0.8076923076923077,0.29261522333146,0.6942049706789624
6,15,2,23,0.2857142857142857,0.9130434782608695,0.2701198615503839,0.6950373968811779
9,52,1,62,0.14754098360655737,0.9838709677419355,0.2468621695532911,0.7728198295023202
7,106,46,159,0.061946902654867256,0.710691823899371,0.23590974687739522,0.7541091376784207
11,82,107,200,0.11827956989247312,0.465,0.21471159019536756,0.6893423738300244
33,38,74,145,0.4647887323943662,0.4896551724137931,0.20968140910884844,0.7480886309535634
2,36,21,59,0.05263157894736842,0.6440677966101694,0.18423317313429668,0.7162887923740637
25,144,27,196,0.14792899408284024,0.8622448979591837,0.1826901496132512,0.724082019555046
7,35,24,66,0.16666666666666666,0.6363636363636364,0.16568334689216274,0.6845563278554413
2,10,0,12,0.16666666666666666,1.0,0.16841558732932121,0.6868604753208791
44,21,14,79,0.676923076923077,0.8227848101265823,0.256269326510494,0.7028737590676236
6,36,11,53,0.14285714285714285,0.7924528301886793,0.2597804083625897,0.7496527348088635
17,85,22,124,0.16666666666666666,0.8225806451612904,0.2171915418300612,0.7972135166299346
141,292,99,532,0.325635103926097,0.8139097744360902,0.25619204539845103,0.8214766563193517
7,33,12,52,0.175,0.7692307692307693,0.26005933195804526,0.808188923643864
12,39,41,92,0.23529411764705882,0.5543478260869565,0.2698632535266727,0.796472379318624
1,1,0,2,0.5,1.0,0.31748230114572035,0.796472379318624
1,11,3,15,0.08333333333333333,0.8,0.23268376634718552,0.793217406443398
14,63,18,95,0.18181818181818182,0.8105263157894737,0.23824962905590535,0.7957993329577973
6,30,97,133,0.16666666666666666,0.2706766917293233,0.23824962905590535,0.7169559110389446
9,43,8,60,0.17307692307692307,0.8666666666666667,0.2164556032203091,0.7244926099290271
2,19,8,29,0.09523809523809523,0.7241379310344828,0.20506104539717981,0.7180507759009861
